公投案編號,縣市,行政區,村里,投開票所,投票權人數,同意票數,不同意票數,有效票數,無效票數,投票人數
公投第１６案,連江縣,,,,11205,3764,1663,5427,323,5750
公投第１６案,金門縣,,,,122695,26851,13274,40125,3668,43793
公投第１６案,宜蘭縣,,,,386089,111743,77082,188825,23921,212746
公投第１６案,新竹縣,,,,445051,139470,93309,232779,17674,250453
公投第１６案,苗栗縣,,,,461580,143501,95723,239224,22419,261643
公投第１６案,彰化縣,,,,1066994,328349,223084,551433,58500,609933
公投第１６案,南投縣,,,,427089,138860,85227,224087,21345,245432
公投第１６案,雲林縣,,,,584480,158850,106155,265005,33678,298683
公投第１６案,嘉義縣,,,,442775,114627,81395,196022,24668,220690
公投第１６案,屏東縣,,,,711720,192218,136052,328270,37207,365477
公投第１６案,臺東縣,,,,185996,51032,33932,84964,9433,94397
公投第１６案,花蓮縣,,,,278059,80187,50311,130498,14411,144909
公投第１６案,澎湖縣,,,,90405,22697,13207,35904,4253,40157
公投第１６案,基隆市,,,,320030,90311,61447,151758,11852,163610
公投第１６案,新竹市,,,,351775,110083,73690,183773,13635,197408
公投第１６案,嘉義市,,,,221553,64519,45975,110494,9064,119558
公投第１６案,臺北市,,,,2228430,698579,494516,1193095,91528,1284623
公投第１６案,高雄市,,,,2353342,752932,509854,1262786,103906,1366692
公投第１６案,新北市,,,,3375513,1000493,691936,1692429,162420,1854849
公投第１６案,臺中市,,,,2295642,725778,478271,1204049,118994,1323043
公投第１６案,臺南市,,,,1594821,422398,310812,733210,72547,805757
公投第１６案,桃園市,,,,1801823,518318,337300,855618,67514,923132
公投第１６案,連江縣,南竿鄉,,,6461,2201,903,3104,173,3277
公投第１６案,連江縣,北竿鄉,,,2125,707,336,1043,67,1110
公投第１６案,連江縣,莒光鄉,,,1481,502,224,726,57,783
公投第１６案,連江縣,東引鄉,,,1138,354,200,554,26,580
公投第１６案,金門縣,烈嶼鄉,,,11676,2806,1171,3977,276,4253
公投第１６案,金門縣,烏坵鄉,,,567,95,62,157,8,165
公投第１６案,金門縣,金城鎮,,,37815,8057,3974,12031,1131,13162
公投第１６案,金門縣,金沙鎮,,,18560,3999,1972,5971,591,6562
公投第１６案,金門縣,金寧鄉,,,28162,6132,3276,9408,760,10168
公投第１６案,金門縣,金湖鎮,,,25915,5762,2819,8581,902,9483
公投第１６案,宜蘭縣,五結鄉,,,34892,9815,6809,16624,1991,18615
公投第１６案,宜蘭縣,蘇澳鎮,,,34512,10050,6665,16715,2561,19276
公投第１６案,宜蘭縣,頭城鎮,,,25135,6953,5011,11964,1829,13793
公投第１６案,宜蘭縣,三星鄉,,,19051,5091,3657,8748,1215,9963
公投第１６案,宜蘭縣,羅東鎮,,,57686,17459,12335,29794,3348,33142
公投第１６案,宜蘭縣,礁溪鄉,,,31084,8806,6001,14807,1847,16654
公投第１６案,宜蘭縣,員山鄉,,,28131,7442,5549,12991,2074,15065
公投第１６案,宜蘭縣,壯圍鄉,,,21447,6234,4316,10550,1720,12270
公投第１６案,宜蘭縣,宜蘭市,,,79167,23936,16264,40200,4447,44647
公投第１６案,宜蘭縣,南澳鄉,,,4644,1491,847,2338,329,2667
公投第１６案,宜蘭縣,冬山鄉,,,45405,13244,8821,22065,2198,24263
公投第１６案,宜蘭縣,大同鄉,,,4935,1222,807,2029,362,2391
公投第１６案,新竹縣,五峰鄉,,,3997,946,601,1547,141,1688
公投第１６案,新竹縣,寶山鄉,,,12973,4244,2763,7007,592,7599
公投第１６案,新竹縣,北埔鄉,,,8180,2513,1706,4219,356,4575
公投第１６案,新竹縣,新埔鎮,,,28894,9280,5735,15015,1214,16229
公投第１６案,新竹縣,芎林鄉,,,17293,5368,3877,9245,904,10149
公投第１６案,新竹縣,新豐鄉,,,45790,14072,9655,23727,1846,25573
公投第１６案,新竹縣,尖石鄉,,,7364,1697,1279,2976,258,3234
公投第１６案,新竹縣,湖口鄉,,,63511,19891,13229,33120,2434,35554
公投第１６案,新竹縣,竹北市,,,137129,44987,30205,75192,4581,79773
公投第１６案,新竹縣,峨眉鄉,,,5068,1579,1102,2681,378,3059
公投第１６案,新竹縣,橫山鄉,,,11346,3613,2444,6057,633,6690
公投第１６案,新竹縣,竹東鎮,,,78794,23823,15411,39234,3114,42348
公投第１６案,新竹縣,關西鎮,,,24712,7457,5302,12759,1223,13982
公投第１６案,苗栗縣,三灣鄉,,,5852,1768,1224,2992,381,3373
公投第１６案,苗栗縣,苑裡鎮,,,38890,11583,8373,19956,2201,22157
公投第１６案,苗栗縣,銅鑼鄉,,,15424,4875,3100,7975,668,8643
公投第１６案,苗栗縣,後龍鎮,,,30948,8788,6427,15215,1800,17015
公投第１６案,苗栗縣,卓蘭鎮,,,14772,4776,3004,7780,816,8596
公投第１６案,苗栗縣,獅潭鄉,,,3968,1151,684,1835,192,2027
公投第１６案,苗栗縣,頭屋鄉,,,9390,3430,2160,5590,511,6101
公投第１６案,苗栗縣,三義鄉,,,13889,4396,3171,7567,578,8145
公投第１６案,苗栗縣,造橋鄉,,,11027,3386,2359,5745,676,6421
公投第１６案,苗栗縣,頭份市,,,83617,26103,17535,43638,3569,47207
公投第１６案,苗栗縣,公館鄉,,,28318,9169,5871,15040,1693,16733
公投第１６案,苗栗縣,西湖鄉,,,6382,1889,1305,3194,329,3523
公投第１６案,苗栗縣,泰安鄉,,,5180,1747,1319,3066,300,3366
公投第１６案,苗栗縣,苗栗市,,,74249,25170,14843,40013,2874,42887
公投第１６案,苗栗縣,大湖鄉,,,12653,3651,2420,6071,668,6739
公投第１６案,苗栗縣,南庄鄉,,,8784,2287,1614,3901,420,4321
公投第１６案,苗栗縣,通霄鎮,,,29709,8260,5890,14150,1836,15986
公投第１６案,苗栗縣,竹南鎮,,,68528,21072,14424,35496,2907,38403
公投第１６案,彰化縣,芳苑鄉,,,29291,7397,4898,12295,1925,14220
公投第１６案,彰化縣,福興鄉,,,39745,11401,7659,19060,2364,21424
公投第１６案,彰化縣,社頭鄉,,,36306,11509,7432,18941,1840,20781
公投第１６案,彰化縣,彰化市,,,190995,61812,43718,105530,9670,115200
公投第１６案,彰化縣,伸港鄉,,,30407,9449,6096,15545,1686,17231
公投第１６案,彰化縣,線西鄉,,,14065,4647,2949,7596,799,8395
公投第１６案,彰化縣,大城鄉,,,14713,2976,1899,4875,748,5623
公投第１６案,彰化縣,埔心鄉,,,29642,9909,6543,16452,1732,18184
公投第１６案,彰化縣,大村鄉,,,31492,10080,6700,16780,1719,18499
公投第１６案,彰化縣,員林市,,,102028,32021,21152,53173,4579,57752
公投第１６案,彰化縣,溪湖鎮,,,45147,14324,9370,23694,2462,26156
公投第１６案,彰化縣,芬園鄉,,,20408,6153,4024,10177,1147,11324
公投第１６案,彰化縣,二水鄉,,,13339,4055,2953,7008,935,7943
公投第１６案,彰化縣,田尾鄉,,,23179,7479,4855,12334,1343,13677
公投第１６案,彰化縣,花壇鄉,,,38924,12086,8503,20589,2152,22741
公投第１６案,彰化縣,北斗鎮,,,27593,8622,5815,14437,1661,16098
公投第１６案,彰化縣,田中鎮,,,35391,10701,7580,18281,2128,20409
公投第１６案,彰化縣,秀水鄉,,,32394,10186,7197,17383,1823,19206
公投第１６案,彰化縣,和美鎮,,,75286,23210,15941,39151,3495,42646
公投第１６案,彰化縣,埤頭鄉,,,25677,7504,4793,12297,1683,13980
公投第１６案,彰化縣,竹塘鄉,,,12821,3597,2360,5957,870,6827
公投第１６案,彰化縣,永靖鄉,,,31239,9888,6806,16694,1882,18576
公投第１６案,彰化縣,溪州鄉,,,25405,6641,4852,11493,1452,12945
公投第１６案,彰化縣,二林鎮,,,42976,11880,8187,20067,2470,22537
公投第１６案,彰化縣,埔鹽鄉,,,28026,9245,5822,15067,1792,16859
公投第１６案,彰化縣,鹿港鎮,,,70505,21577,14980,36557,4143,40700
公投第１６案,南投縣,埔里鎮,,,68763,22085,13740,35825,3508,39333
公投第１６案,南投縣,國姓鄉,,,16597,5164,3258,8422,888,9310
公投第１６案,南投縣,草屯鎮,,,82922,27449,17070,44519,3385,47904
公投第１６案,南投縣,魚池鄉,,,13958,4192,2636,6828,753,7581
公投第１６案,南投縣,鹿谷鄉,,,15941,4793,2872,7665,871,8536
公投第１６案,南投縣,中寮鄉,,,13181,4091,2681,6772,843,7615
公投第１６案,南投縣,水里鄉,,,15458,4806,2957,7763,805,8568
公投第１６案,南投縣,名間鄉,,,33408,11108,6888,17996,2013,20009
公投第１６案,南投縣,南投市,,,84328,29595,17785,47380,3612,50992
公投第１６案,南投縣,仁愛鄉,,,12589,3866,2240,6106,572,6678
公投第１６案,南投縣,集集鎮,,,9611,3091,1875,4966,575,5541
公投第１６案,南投縣,竹山鎮,,,47034,14566,8897,23463,2384,25847
公投第１６案,南投縣,信義鄉,,,13299,4054,2328,6382,1136,7518
公投第１６案,雲林縣,大埤鄉,,,16509,4411,3055,7466,964,8430
公投第１６案,雲林縣,崙背鄉,,,21050,5216,3642,8858,1205,10063
公投第１６案,雲林縣,元長鄉,,,22830,4869,3423,8292,1334,9626
公投第１６案,雲林縣,斗六市,,,89761,28906,18421,47327,3746,51073
公投第１６案,雲林縣,水林鄉,,,22508,4908,3285,8193,1346,9539
公投第１６案,雲林縣,林內鄉,,,15551,4482,3064,7546,1172,8718
公投第１６案,雲林縣,古坑鄉,,,27477,7747,4974,12721,1572,14293
公投第１６案,雲林縣,虎尾鎮,,,58167,16809,11246,28055,2608,30663
公投第１６案,雲林縣,土庫鎮,,,24412,6582,4488,11070,1639,12709
公投第１６案,雲林縣,北港鎮,,,33958,9640,6339,15979,2471,18450
公投第１６案,雲林縣,東勢鄉,,,13239,3325,2250,5575,921,6496
公投第１６案,雲林縣,麥寮鄉,,,37119,9483,6353,15836,2130,17966
公投第１６案,雲林縣,四湖鄉,,,20983,4108,2841,6949,1160,8109
公投第１６案,雲林縣,褒忠鄉,,,11381,3057,2066,5123,634,5757
公投第１６案,雲林縣,臺西鄉,,,21125,5070,3141,8211,1334,9545
公投第１６案,雲林縣,斗南鎮,,,38138,11322,8111,19433,2068,21501
公投第１６案,雲林縣,口湖鄉,,,24193,5828,3728,9556,1668,11224
公投第１６案,雲林縣,二崙鄉,,,23367,5577,3875,9452,1550,11002
公投第１６案,雲林縣,西螺鎮,,,38142,10492,7068,17560,2385,19945
公投第１６案,雲林縣,莿桐鄉,,,24570,7018,4785,11803,1771,13574
公投第１６案,嘉義縣,大林鎮,,,26922,7123,5269,12392,1275,13667
公投第１６案,嘉義縣,六腳鄉,,,20821,4311,3010,7321,1086,8407
公投第１６案,嘉義縣,溪口鄉,,,13105,3260,2464,5724,785,6509
公投第１６案,嘉義縣,水上鄉,,,43857,12155,8383,20538,2377,22915
公投第１６案,嘉義縣,東石鄉,,,21915,4402,2914,7316,1232,8548
公投第１６案,嘉義縣,義竹鄉,,,16647,4391,2845,7236,1060,8296
公投第１６案,嘉義縣,朴子市,,,35191,9407,6717,16124,1863,17987
公投第１６案,嘉義縣,番路鄉,,,10156,2849,2154,5003,594,5597
公投第１６案,嘉義縣,竹崎鄉,,,31228,8088,6112,14200,1512,15712
公投第１６案,嘉義縣,鹿草鄉,,,13937,3282,2280,5562,984,6546
公投第１６案,嘉義縣,太保市,,,31568,8778,6106,14884,1610,16494
公投第１６案,嘉義縣,阿里山鄉,,,4691,1137,809,1946,113,2059
公投第１６案,嘉義縣,中埔鄉,,,39139,9376,6797,16173,1836,18009
公投第１６案,嘉義縣,新港鄉,,,27342,7286,5235,12521,1950,14471
公投第１６案,嘉義縣,民雄鄉,,,61209,16658,12239,28897,3683,32580
公投第１６案,嘉義縣,大埔鄉,,,3999,1165,789,1954,171,2125
公投第１６案,嘉義縣,布袋鎮,,,23965,6202,3859,10061,1433,11494
公投第１６案,嘉義縣,梅山鄉,,,17083,4757,3413,8170,1104,9274
公投第１６案,屏東縣,春日鄉,,,3923,546,409,955,81,1036
公投第１６案,屏東縣,高樹鄉,,,21697,5343,3843,9186,1330,10516
公投第１６案,屏東縣,三地門鄉,,,6373,1712,1155,2867,370,3237
公投第１６案,屏東縣,車城鄉,,,7595,1562,1186,2748,315,3063
公投第１６案,屏東縣,萬丹鄉,,,43478,11618,8736,20354,2563,22917
公投第１６案,屏東縣,新園鄉,,,30706,8152,5749,13901,2109,16010
公投第１６案,屏東縣,霧臺鄉,,,2950,823,626,1449,134,1583
公投第１６案,屏東縣,佳冬鄉,,,17063,4194,3005,7199,1063,8262
公投第１６案,屏東縣,潮州鎮,,,46444,12945,9090,22035,2015,24050
公投第１６案,屏東縣,竹田鄉,,,15353,4466,3319,7785,1011,8796
公投第１６案,屏東縣,里港鄉,,,22128,5945,4656,10601,1515,12116
公投第１６案,屏東縣,牡丹鄉,,,4314,957,667,1624,117,1741
公投第１６案,屏東縣,琉球鄉,,,10706,2507,1521,4028,602,4630
公投第１６案,屏東縣,新埤鄉,,,9033,2253,1670,3923,570,4493
公投第１６案,屏東縣,瑪家鄉,,,5663,1873,1134,3007,276,3283
公投第１６案,屏東縣,恆春鎮,,,25661,6226,4698,10924,960,11884
公投第１６案,屏東縣,麟洛鄉,,,9970,2935,2239,5174,450,5624
公投第１６案,屏東縣,獅子鄉,,,4230,1027,676,1703,154,1857
公投第１６案,屏東縣,萬巒鄉,,,17945,4477,3300,7777,1161,8938
公投第１６案,屏東縣,鹽埔鄉,,,22402,6046,4102,10148,1231,11379
公投第１６案,屏東縣,南州鄉,,,9479,2503,1871,4374,595,4969
公投第１６案,屏東縣,枋山鄉,,,4856,1283,869,2152,282,2434
公投第１６案,屏東縣,屏東市,,,170148,49795,33508,83303,6333,89636
公投第１６案,屏東縣,林邊鄉,,,15691,4367,3224,7591,1044,8635
公投第１６案,屏東縣,泰武鄉,,,4344,1410,943,2353,350,2703
公投第１６案,屏東縣,內埔鄉,,,47558,11406,8400,19806,2085,21891
公投第１６案,屏東縣,東港鎮,,,39495,10468,7821,18289,2619,20908
公投第１６案,屏東縣,枋寮鄉,,,21394,5747,3997,9744,1532,11276
公投第１６案,屏東縣,九如鄉,,,19132,5096,3903,8999,1365,10364
公投第１６案,屏東縣,長治鄉,,,26256,7444,5185,12629,1651,14280
公投第１６案,屏東縣,來義鄉,,,6257,2124,1037,3161,425,3586
公投第１６案,屏東縣,滿州鄉,,,7206,1611,1165,2776,257,3033
公投第１６案,屏東縣,崁頂鄉,,,12270,3357,2348,5705,642,6347
公投第１６案,臺東縣,卑南鄉,,,14976,4065,2819,6884,921,7805
公投第１６案,臺東縣,關山鎮,,,7509,2106,1315,3421,279,3700
公投第１６案,臺東縣,臺東市,,,87803,27095,16947,44042,3485,47527
公投第１６案,臺東縣,蘭嶼鄉,,,4181,634,817,1451,130,1581
公投第１６案,臺東縣,達仁鄉,,,3137,752,805,1557,220,1777
公投第１６案,臺東縣,大武鄉,,,5266,1216,902,2118,559,2677
公投第１６案,臺東縣,延平鄉,,,2930,736,598,1334,193,1527
公投第１６案,臺東縣,綠島鄉,,,3579,902,553,1455,98,1553
公投第１６案,臺東縣,海端鄉,,,3278,855,685,1540,194,1734
公投第１６案,臺東縣,池上鄉,,,7162,1706,1169,2875,380,3255
公投第１６案,臺東縣,長濱鄉,,,6484,1269,840,2109,489,2598
公投第１６案,臺東縣,東河鄉,,,7635,1629,1177,2806,442,3248
公投第１６案,臺東縣,太麻里鄉,,,9666,2359,1612,3971,614,4585
公投第１６案,臺東縣,鹿野鄉,,,6936,1629,1129,2758,339,3097
公投第１６案,臺東縣,金峰鄉,,,3028,847,563,1410,235,1645
公投第１６案,臺東縣,成功鎮,,,12426,3232,2001,5233,855,6088
公投第１６案,花蓮縣,萬榮鄉,,,5269,1438,1013,2451,417,2868
公投第１６案,花蓮縣,豐濱鄉,,,4395,940,657,1597,337,1934
公投第１６案,花蓮縣,吉安鄉,,,72116,21528,13261,34789,3172,37961
公投第１６案,花蓮縣,富里鄉,,,9065,2133,1402,3535,595,4130
公投第１６案,花蓮縣,玉里鎮,,,20650,5053,3251,8304,1398,9702
公投第１６案,花蓮縣,花蓮市,,,84807,26165,15949,42114,3409,45523
公投第１６案,花蓮縣,卓溪鄉,,,4947,1380,927,2307,389,2696
公投第１６案,花蓮縣,鳳林鎮,,,9676,2844,1790,4634,664,5298
公投第１６案,花蓮縣,壽豐鄉,,,15847,4465,3251,7716,1037,8753
公投第１６案,花蓮縣,瑞穗鄉,,,10279,2656,1672,4328,702,5030
公投第１６案,花蓮縣,新城鄉,,,17029,5139,3191,8330,859,9189
公投第１６案,花蓮縣,秀林鄉,,,12562,3423,2036,5459,557,6016
公投第１６案,花蓮縣,光復鄉,,,11417,3023,1911,4934,875,5809
公投第１６案,澎湖縣,湖西鄉,,,12741,3078,1727,4805,585,5390
公投第１６案,澎湖縣,西嶼鄉,,,7382,1266,768,2034,410,2444
公投第１６案,澎湖縣,白沙鄉,,,8625,2003,1180,3183,432,3615
公投第１６案,澎湖縣,望安鄉,,,4628,945,573,1518,259,1777
公投第１６案,澎湖縣,七美鄉,,,3374,535,340,875,124,999
公投第１６案,澎湖縣,馬公市,,,53655,14870,8619,23489,2443,25932
公投第１６案,基隆市,中正區,,,45545,11413,8035,19448,1862,21310
公投第１６案,基隆市,暖暖區,,,33225,9712,6477,16189,1036,17225
公投第１６案,基隆市,安樂區,,,70396,20635,13539,34174,2201,36375
公投第１６案,基隆市,中山區,,,41856,11495,8015,19510,1513,21023
公投第１６案,基隆市,仁愛區,,,36738,10277,7453,17730,1847,19577
公投第１６案,基隆市,信義區,,,46014,13576,8744,22320,1486,23806
公投第１６案,基隆市,七堵區,,,46256,13203,9184,22387,1907,24294
公投第１６案,新竹市,北區,,,123122,37623,25982,63605,4918,68523
公投第１６案,新竹市,香山區,,,64896,20032,13220,33252,2882,36134
公投第１６案,新竹市,東區,,,163757,52428,34488,86916,5835,92751
公投第１６案,嘉義市,東區,,,100647,29288,21014,50302,4070,54372
公投第１６案,嘉義市,西區,,,120906,35231,24961,60192,4994,65186
公投第１６案,臺北市,萬華區,,,164020,47801,35213,83014,7953,90967
公投第１６案,臺北市,大同區,,,107557,31347,25374,56721,5467,62188
公投第１６案,臺北市,文山區,,,227211,77470,49080,126550,9286,135836
公投第１６案,臺北市,中山區,,,195148,58611,44414,103025,8153,111178
公投第１６案,臺北市,南港區,,,101907,31894,23041,54935,3919,58854
公投第１６案,臺北市,北投區,,,213250,64303,46598,110901,8756,119657
公投第１６案,臺北市,松山區,,,169278,55200,38025,93225,6808,100033
公投第１６案,臺北市,士林區,,,241854,71992,54662,126654,11331,137985
公投第１６案,臺北市,中正區,,,128292,41549,28544,70093,4712,74805
公投第１６案,臺北市,大安區,,,252645,80894,55473,136367,8792,145159
公投第１６案,臺北市,內湖區,,,236824,76531,52585,129116,8726,137842
公投第１６案,臺北市,信義區,,,190444,60987,41507,102494,7625,110119
公投第１６案,高雄市,那瑪夏區,,,2424,745,447,1192,201,1393
公投第１６案,高雄市,燕巢區,,,26012,8029,5213,13242,1485,14727
公投第１６案,高雄市,旗山區,,,31996,9653,6402,16055,1698,17753
公投第１６案,高雄市,田寮區,,,6671,1690,1101,2791,354,3145
公投第１６案,高雄市,美濃區,,,35311,10310,6967,17277,1946,19223
公投第１６案,高雄市,大寮區,,,97309,29648,20901,50549,4348,54897
公投第１６案,高雄市,茂林區,,,1615,637,352,989,80,1069
公投第１６案,高雄市,永安區,,,12001,4103,2707,6810,699,7509
公投第１６案,高雄市,內門區,,,13002,3171,2190,5361,778,6139
公投第１６案,高雄市,彌陀區,,,16487,5293,3704,8997,1094,10091
公投第１６案,高雄市,前金區,,,23928,7735,5642,13377,975,14352
公投第１６案,高雄市,鹽埕區,,,21617,6495,4957,11452,718,12170
公投第１６案,高雄市,路竹區,,,43850,13627,9698,23325,2365,25690
公投第１６案,高雄市,杉林區,,,10607,2510,1736,4246,521,4767
公投第１６案,高雄市,大社區,,,30046,9014,6640,15654,1434,17088
公投第１６案,高雄市,楠梓區,,,153132,50610,33271,83881,7400,91281
公投第１６案,高雄市,阿蓮區,,,24534,6890,5125,12015,1066,13081
公投第１６案,高雄市,六龜區,,,11501,2805,1890,4695,727,5422
公投第１６案,高雄市,旗津區,,,24860,6331,4756,11087,1394,12481
公投第１６案,高雄市,茄萣區,,,26212,6925,5453,12378,1454,13832
公投第１６案,高雄市,三民區,,,289519,92896,64587,157483,11740,169223
公投第１６案,高雄市,橋頭區,,,32565,10396,7679,18075,1959,20034
公投第１６案,高雄市,鼓山區,,,114979,38075,24959,63034,4429,67463
公投第１６案,高雄市,湖內區,,,25729,7579,5375,12954,1129,14083
公投第１６案,高雄市,甲仙區,,,5417,1329,934,2263,350,2613
公投第１６案,高雄市,苓雅區,,,146786,48433,34428,82861,5536,88397
公投第１６案,高雄市,鳥松區,,,39191,12625,9306,21931,1688,23619
公投第１６案,高雄市,左營區,,,161367,56269,34699,90968,5957,96925
公投第１６案,高雄市,小港區,,,132733,42230,28891,71121,5726,76847
公投第１６案,高雄市,林園區,,,59129,17898,11604,29502,2976,32478
公投第１６案,高雄市,鳳山區,,,300510,99747,64662,164409,12511,176920
公投第１６案,高雄市,梓官區,,,31025,9540,6643,16183,1625,17808
公投第１６案,高雄市,仁武區,,,73611,24041,15653,39694,2777,42471
公投第１６案,高雄市,岡山區,,,81244,28342,17486,45828,3632,49460
公投第１６案,高雄市,新興區,,,44355,14213,10807,25020,1773,26793
公投第１６案,高雄市,大樹區,,,36772,10960,7332,18292,1821,20113
公投第１６案,高雄市,桃源區,,,3498,1024,632,1656,122,1778
公投第１６案,高雄市,前鎮區,,,161797,51114,35025,86139,7418,93557
公投第１６案,新北市,三峽區,,,94291,26544,18649,45193,4162,49355
公投第１６案,新北市,平溪區,,,4321,1034,710,1744,293,2037
公投第１６案,新北市,雙溪區,,,7999,2067,1357,3424,450,3874
公投第１６案,新北市,新店區,,,264053,86688,52198,138886,10349,149235
公投第１６案,新北市,樹林區,,,152102,43905,32015,75920,7616,83536
公投第１６案,新北市,蘆洲區,,,167457,46599,34317,80916,8598,89514
公投第１６案,新北市,石碇區,,,6861,1680,1329,3009,407,3416
公投第１６案,新北市,八里區,,,32970,9280,6562,15842,1614,17456
公投第１６案,新北市,三芝區,,,20119,5087,3686,8773,909,9682
公投第１６案,新北市,金山區,,,18978,4900,3746,8646,960,9606
公投第１６案,新北市,坪林區,,,5891,1535,1030,2565,390,2955
公投第１６案,新北市,土城區,,,200783,59061,40462,99523,10321,109844
公投第１６案,新北市,貢寮區,,,11279,2347,2384,4731,454,5185
公投第１６案,新北市,板橋區,,,463411,136267,98719,234986,23859,258845
公投第１６案,新北市,新莊區,,,344981,103947,73997,177944,17707,195651
公投第１６案,新北市,泰山區,,,64252,19053,13363,32416,2930,35346
公投第１６案,新北市,淡水區,,,147272,42612,29215,71827,5493,77320
公投第１６案,新北市,汐止區,,,173831,50587,33825,84412,7281,91693
公投第１６案,新北市,林口區,,,86203,26917,18029,44946,3331,48277
公投第１６案,新北市,中和區,,,355978,110005,70784,180789,15683,196472
公投第１６案,新北市,石門區,,,10528,2776,2005,4781,667,5448
公投第１６案,新北市,瑞芳區,,,35036,8893,6104,14997,1750,16747
公投第１６案,新北市,萬里區,,,19297,4941,3578,8519,1076,9595
公投第１６案,新北市,鶯歌區,,,71645,19947,14231,34178,3399,37577
公投第１６案,新北市,五股區,,,72443,20000,14792,34792,3684,38476
公投第１６案,新北市,三重區,,,329846,93399,70120,163519,19753,183272
公投第１６案,新北市,烏來區,,,5264,1540,958,2498,244,2742
公投第１６案,新北市,深坑區,,,20624,6116,4199,10315,931,11246
公投第１６案,新北市,永和區,,,187798,62766,39572,102338,8109,110447
公投第１６案,臺中市,神岡區,,,54565,16779,12035,28814,3200,32014
公投第１６案,臺中市,東勢區,,,43181,13214,9096,22310,2803,25113
公投第１６案,臺中市,后里區,,,44962,14056,9112,23168,2852,26020
公投第１６案,臺中市,烏日區,,,61705,19358,13048,32406,3521,35927
公投第１６案,臺中市,大甲區,,,63069,19426,13302,32728,3469,36197
公投第１６案,臺中市,石岡區,,,12880,4113,2674,6787,810,7597
公投第１６案,臺中市,梧棲區,,,47040,14523,9551,24074,2745,26819
公投第１６案,臺中市,新社區,,,20860,5903,3924,9827,1113,10940
公投第１６案,臺中市,東區,,,64291,20239,13985,34224,3437,37661
公投第１６案,臺中市,潭子區,,,89487,28569,18357,46926,4041,50967
公投第１６案,臺中市,龍井區,,,63584,19422,12882,32304,3304,35608
公投第１６案,臺中市,大雅區,,,77189,24116,15958,40074,3990,44064
公投第１６案,臺中市,大肚區,,,47457,14878,9711,24589,2880,27469
公投第１６案,臺中市,太平區,,,157926,47742,30518,78260,7597,85857
公投第１６案,臺中市,外埔區,,,27059,8609,5582,14191,1562,15753
公投第１６案,臺中市,北區,,,124621,38821,25381,64202,5539,69741
公投第１６案,臺中市,和平區,,,9498,3117,2061,5178,529,5707
公投第１６案,臺中市,清水區,,,71528,23167,14645,37812,4073,41885
公投第１６案,臺中市,霧峰區,,,55225,17744,11582,29326,3938,33264
公投第１６案,臺中市,北屯區,,,227720,73413,46183,119596,10227,129823
公投第１６案,臺中市,沙鹿區,,,74207,22892,15188,38080,4003,42083
公投第１６案,臺中市,豐原區,,,136658,45002,29882,74884,7011,81895
公投第１６案,臺中市,西屯區,,,183814,59399,38045,97444,8825,106269
公投第１６案,臺中市,南區,,,103643,34386,23722,58108,5432,63540
公投第１６案,臺中市,大安區,,,16520,4964,3443,8407,1312,9719
公投第１６案,臺中市,中區,,,14696,4199,3157,7356,859,8215
公投第１６案,臺中市,南屯區,,,135448,45026,29930,74956,6711,81667
公投第１６案,臺中市,大里區,,,171769,52609,34361,86970,8899,95869
公投第１６案,臺中市,西區,,,95040,30092,20956,51048,4312,55360
公投第１６案,臺南市,安平區,,,55379,14746,10955,25701,2036,27737
公投第１６案,臺南市,玉井區,,,12357,3185,2093,5278,583,5861
公投第１６案,臺南市,柳營區,,,18804,4734,3219,7953,1140,9093
公投第１６案,臺南市,佳里區,,,50407,13974,9415,23389,2567,25956
公投第１６案,臺南市,新市區,,,30386,8362,6149,14511,1595,16106
公投第１６案,臺南市,安南區,,,159654,42902,32042,74944,7652,82596
公投第１６案,臺南市,楠西區,,,8528,1991,1346,3337,367,3704
公投第１６案,臺南市,北區,,,110906,31092,23203,54295,4520,58815
公投第１６案,臺南市,鹽水區,,,22121,5279,3921,9200,1163,10363
公投第１６案,臺南市,官田區,,,18675,4618,3440,8058,770,8828
公投第１６案,臺南市,將軍區,,,17754,3964,2778,6742,794,7536
公投第１６案,臺南市,麻豆區,,,37963,9408,7250,16658,1473,18131
公投第１６案,臺南市,六甲區,,,19144,4574,3591,8165,997,9162
公投第１６案,臺南市,山上區,,,6511,1457,1016,2473,323,2796
公投第１６案,臺南市,七股區,,,19950,4511,3087,7598,947,8545
公投第１６案,臺南市,東山區,,,18471,3372,2451,5823,965,6788
公投第１６案,臺南市,西港區,,,21564,5130,3712,8842,880,9722
公投第１６案,臺南市,後壁區,,,20841,4616,3468,8084,1305,9389
公投第１６案,臺南市,永康區,,,195001,53835,38433,92268,7852,100120
公投第１６案,臺南市,關廟區,,,29913,8203,5835,14038,1425,15463
公投第１６案,臺南市,新營區,,,64949,17689,11710,29399,2570,31969
公投第１６案,臺南市,南化區,,,7786,1883,1368,3251,395,3646
公投第１６案,臺南市,仁德區,,,64632,17804,13064,30868,3028,33896
公投第１６案,臺南市,白河區,,,24894,5294,3848,9142,1238,10380
公投第１６案,臺南市,大內區,,,8654,2110,1454,3564,498,4062
公投第１６案,臺南市,新化區,,,37296,10063,7660,17723,2041,19764
公投第１６案,臺南市,南區,,,108650,27903,21566,49469,5463,54932
公投第１６案,臺南市,左鎮區,,,4418,945,707,1652,252,1904
公投第１６案,臺南市,北門區,,,9925,2089,1422,3511,347,3858
公投第１６案,臺南市,中西區,,,65261,17852,14831,32683,3216,35899
公投第１６案,臺南市,龍崎區,,,3713,903,638,1541,178,1719
公投第１６案,臺南市,下營區,,,20947,5003,3481,8484,1071,9555
公投第１６案,臺南市,學甲區,,,22567,5511,4003,9514,1024,10538
公投第１６案,臺南市,歸仁區,,,57387,15594,11711,27305,2577,29882
公投第１６案,臺南市,安定區,,,26104,7000,5286,12286,1492,13778
公投第１６案,臺南市,善化區,,,39950,10307,7882,18189,1998,20187
公投第１６案,臺南市,東區,,,153359,44495,32777,77272,5805,83077
公投第１６案,桃園市,復興區,,,9766,2604,1932,4536,471,5007
公投第１６案,桃園市,大溪區,,,78285,21913,15074,36987,4116,41103
公投第１６案,桃園市,大園區,,,73900,19806,13867,33673,2724,36397
公投第１６案,桃園市,蘆竹區,,,129252,35742,24763,60505,4898,65403
公投第１６案,桃園市,龍潭區,,,101574,31654,18551,50205,3856,54061
公投第１６案,桃園市,桃園區,,,359790,101918,67207,169125,12153,181278
公投第１６案,桃園市,平鎮區,,,183560,55590,34675,90265,6517,96782
公投第１６案,桃園市,新屋區,,,41461,12387,8582,20969,1976,22945
公投第１６案,桃園市,八德區,,,165065,45937,30421,76358,6782,83140
公投第１６案,桃園市,觀音區,,,55149,14918,10234,25152,2399,27551
公投第１６案,桃園市,中壢區,,,334402,100616,62949,163565,12025,175590
公投第１６案,桃園市,楊梅區,,,137917,40318,24433,64751,4946,69697
公投第１６案,桃園市,龜山區,,,131702,34915,24612,59527,4651,64178
公投第１６案,連江縣,南竿鄉,介壽村,1,1967,658,310,968,46,1014
公投第１６案,連江縣,南竿鄉,福沃村、復興村,2,1837,580,250,830,50,880
公投第１６案,連江縣,南竿鄉,清水村、珠螺村,3,1114,375,179,554,34,588
公投第１６案,連江縣,南竿鄉,馬祖村、津沙村、四維村、仁愛村,4,1543,588,164,752,43,795
公投第１６案,連江縣,北竿鄉,后沃村、橋仔村、塘岐村,5,1515,522,240,762,55,817
公投第１６案,連江縣,北竿鄉,坂里村、白沙村、芹壁村,6,610,185,96,281,12,293
公投第１６案,連江縣,莒光鄉,田沃村、西坵村、青帆村,7,698,224,94,318,20,338
公投第１６案,連江縣,莒光鄉,大坪村、福正村,8,783,278,130,408,37,445
公投第１６案,連江縣,東引鄉,樂華村、中柳村,9,1138,354,200,554,26,580
公投第１６案,金門縣,金城鎮,東門里,1,1396,310,141,451,41,492
公投第１６案,金門縣,金城鎮,東門里,2,1831,409,248,657,35,692
公投第１６案,金門縣,金城鎮,東門里,3,1750,373,203,576,67,643
公投第１６案,金門縣,金城鎮,南門里,4,1889,381,244,625,93,718
公投第１６案,金門縣,金城鎮,南門里,5,1675,336,157,493,43,536
公投第１６案,金門縣,金城鎮,南門里,6,1901,473,241,714,66,780
公投第１６案,金門縣,金城鎮,西門里,7,1610,303,171,474,82,556
公投第１６案,金門縣,金城鎮,西門里,8,1687,364,196,560,41,601
公投第１６案,金門縣,金城鎮,西門里,9,1594,364,193,557,23,580
公投第１６案,金門縣,金城鎮,西門里,10,1726,361,219,580,23,603
公投第１６案,金門縣,金城鎮,西門里,11,1733,406,184,590,39,629
公投第１６案,金門縣,金城鎮,西門里,12,1532,361,222,583,41,624
公投第１６案,金門縣,金城鎮,北門里,13,2079,403,247,650,69,719
公投第１６案,金門縣,金城鎮,北門里,14,2033,515,88,603,49,652
公投第１６案,金門縣,金城鎮,賢庵里,15,2517,563,257,820,63,883
公投第１６案,金門縣,金城鎮,賢庵里,16,2083,464,210,674,54,728
公投第１６案,金門縣,金城鎮,金水里,17,2140,474,174,648,55,703
公投第１６案,金門縣,金城鎮,古城里,18,2435,391,220,611,94,705
公投第１６案,金門縣,金城鎮,古城里,19,1353,199,101,300,46,346
公投第１６案,金門縣,金城鎮,珠沙里,20,1574,343,123,466,28,494
公投第１６案,金門縣,金城鎮,珠沙里,21,1277,264,135,399,79,478
公投第１６案,金門縣,金寧鄉,古寧村,22,1735,314,152,466,75,541
公投第１６案,金門縣,金寧鄉,古寧村,23,1537,288,152,440,45,485
公投第１６案,金門縣,金寧鄉,安美村,24,1766,316,206,522,70,592
公投第１６案,金門縣,金寧鄉,安美村,25,1015,232,119,351,24,375
公投第１６案,金門縣,金寧鄉,安美村,26,1726,369,182,551,61,612
公投第１６案,金門縣,金寧鄉,湖埔村,27,1691,334,180,514,21,535
公投第１６案,金門縣,金寧鄉,湖埔村,28,2044,414,407,821,44,865
公投第１６案,金門縣,金寧鄉,湖埔村,29,1848,505,215,720,44,764
公投第１６案,金門縣,金寧鄉,湖埔村,30,1735,393,184,577,27,604
公投第１６案,金門縣,金寧鄉,榜林村,31,1795,371,190,561,66,627
公投第１６案,金門縣,金寧鄉,榜林村,32,1834,347,168,515,66,581
公投第１６案,金門縣,金寧鄉,榜林村,33,1528,310,170,480,35,515
公投第１６案,金門縣,金寧鄉,盤山村,34,1473,366,173,539,29,568
公投第１６案,金門縣,金寧鄉,盤山村,35,1679,379,180,559,42,601
公投第１６案,金門縣,金寧鄉,盤山村,36,1921,577,315,892,39,931
公投第１６案,金門縣,金寧鄉,盤山村,37,1298,301,139,440,27,467
公投第１６案,金門縣,金寧鄉,后盤村,38,1537,316,144,460,45,505
公投第１６案,金門縣,烈嶼鄉,林湖村,39,1647,513,169,682,40,722
公投第１６案,金門縣,烈嶼鄉,林湖村,40,1733,396,175,571,46,617
公投第１６案,金門縣,烈嶼鄉,黃埔村,41,1635,398,163,561,44,605
公投第１６案,金門縣,烈嶼鄉,西口村,42,1296,278,134,412,29,441
公投第１６案,金門縣,烈嶼鄉,西口村,43,1099,229,101,330,25,355
公投第１６案,金門縣,烈嶼鄉,上林村,44,1425,299,153,452,31,483
公投第１６案,金門縣,烈嶼鄉,上岐村,45,1412,332,169,501,24,525
公投第１６案,金門縣,烈嶼鄉,上岐村,46,1429,361,107,468,37,505
公投第１６案,金門縣,烏坵鄉,大坵村,47,275,47,27,74,4,78
公投第１６案,金門縣,烏坵鄉,小坵村,48,292,48,35,83,4,87
公投第１６案,金門縣,金湖鎮,新市里,49,1348,320,173,493,47,540
公投第１６案,金門縣,金湖鎮,新市里,50,1386,284,173,457,28,485
公投第１６案,金門縣,金湖鎮,新市里,51,1403,368,178,546,59,605
公投第１６案,金門縣,金湖鎮,山外里,52,1771,445,176,621,51,672
公投第１６案,金門縣,金湖鎮,山外里,53,1493,327,164,491,64,555
公投第１６案,金門縣,金湖鎮,溪湖里,54,1510,293,155,448,88,536
公投第１６案,金門縣,金湖鎮,蓮庵里,55,1607,389,165,554,59,613
公投第１６案,金門縣,金湖鎮,料羅里,56,2006,407,170,577,90,667
公投第１６案,金門縣,金湖鎮,新湖里,57,1780,388,204,592,49,641
公投第１６案,金門縣,金湖鎮,新湖里,58,1739,412,192,604,31,635
公投第１６案,金門縣,金湖鎮,新湖里,59,1384,291,144,435,43,478
公投第１６案,金門縣,金湖鎮,新湖里,60,1400,308,158,466,62,528
公投第１６案,金門縣,金湖鎮,新湖里,61,1325,367,189,556,31,587
公投第１６案,金門縣,金湖鎮,正義里,62,1236,259,109,368,45,413
公投第１６案,金門縣,金湖鎮,正義里,63,1382,262,158,420,54,474
公投第１６案,金門縣,金湖鎮,瓊林里,64,1631,348,170,518,42,560
公投第１６案,金門縣,金湖鎮,瓊林里,65,1514,294,141,435,59,494
公投第１６案,金門縣,金沙鎮,汶沙里,66,1909,390,212,602,55,657
公投第１６案,金門縣,金沙鎮,汶沙里,67,1524,395,166,561,64,625
公投第１６案,金門縣,金沙鎮,汶沙里,68,1673,328,148,476,67,543
公投第１６案,金門縣,金沙鎮,何斗里,69,2003,402,207,609,49,658
公投第１６案,金門縣,金沙鎮,浦山里,70,1212,282,168,450,43,493
公投第１６案,金門縣,金沙鎮,浦山里,71,1126,248,131,379,31,410
公投第１６案,金門縣,金沙鎮,西園里,72,1540,300,135,435,44,479
公投第１６案,金門縣,金沙鎮,官嶼里,73,1216,210,126,336,40,376
公投第１６案,金門縣,金沙鎮,官嶼里,74,950,156,80,236,22,258
公投第１６案,金門縣,金沙鎮,三山里,75,1895,453,196,649,52,701
公投第１６案,金門縣,金沙鎮,大洋里,76,1135,278,145,423,40,463
公投第１６案,金門縣,金沙鎮,光前里,77,1252,264,119,383,52,435
公投第１６案,金門縣,金沙鎮,光前里,78,1125,293,139,432,32,464
公投第１６案,宜蘭縣,宜蘭市,民族里,1,982,282,205,487,36,523
公投第１６案,宜蘭縣,宜蘭市,民族里,2,1270,400,221,621,80,701
公投第１６案,宜蘭縣,宜蘭市,建軍里,3,849,261,178,439,26,465
公投第１６案,宜蘭縣,宜蘭市,建軍里,4,756,247,168,415,25,440
公投第１６案,宜蘭縣,宜蘭市,泰山里,5,1107,320,186,506,51,557
公投第１６案,宜蘭縣,宜蘭市,泰山里,6,893,263,171,434,60,494
公投第１６案,宜蘭縣,宜蘭市,負郭里,7,912,273,194,467,42,509
公投第１６案,宜蘭縣,宜蘭市,負郭里,8,1335,429,250,679,73,752
公投第１６案,宜蘭縣,宜蘭市,負郭里,9,686,184,139,323,45,368
公投第１６案,宜蘭縣,宜蘭市,思源里,10,1366,471,315,786,74,860
公投第１６案,宜蘭縣,宜蘭市,思源里,11,1363,422,306,728,47,775
公投第１６案,宜蘭縣,宜蘭市,思源里,12,1540,498,315,813,72,885
公投第１６案,宜蘭縣,宜蘭市,七結里,13,1341,428,261,689,40,729
公投第１６案,宜蘭縣,宜蘭市,七結里,14,1209,389,234,623,64,687
公投第１６案,宜蘭縣,宜蘭市,文化里,15,900,258,177,435,75,510
公投第１６案,宜蘭縣,宜蘭市,文化里,16,980,272,184,456,54,510
公投第１６案,宜蘭縣,宜蘭市,文化里,17,1165,350,247,597,48,645
公投第１６案,宜蘭縣,宜蘭市,復興里,18,904,301,173,474,33,507
公投第１６案,宜蘭縣,宜蘭市,復興里,19,813,108,315,423,37,460
公投第１６案,宜蘭縣,宜蘭市,復興里,20,978,300,191,491,51,542
公投第１６案,宜蘭縣,宜蘭市,民權里,21,1282,320,215,535,47,582
公投第１６案,宜蘭縣,宜蘭市,民權里,22,465,152,102,254,19,273
公投第１６案,宜蘭縣,宜蘭市,神農里,23,669,190,124,314,79,393
公投第１６案,宜蘭縣,宜蘭市,神農里,24,923,310,169,479,49,528
公投第１６案,宜蘭縣,宜蘭市,神農里,25,1006,288,182,470,62,532
公投第１６案,宜蘭縣,宜蘭市,大新里,26,762,239,197,436,63,499
公投第１６案,宜蘭縣,宜蘭市,新民里,27,727,236,177,413,47,460
公投第１６案,宜蘭縣,宜蘭市,新民里,28,833,258,204,462,85,547
公投第１６案,宜蘭縣,宜蘭市,進士里,29,1143,422,187,609,41,650
公投第１６案,宜蘭縣,宜蘭市,進士里,30,979,308,196,504,32,536
公投第１６案,宜蘭縣,宜蘭市,南橋里,31,1214,366,231,597,77,674
公投第１６案,宜蘭縣,宜蘭市,凱旋里,32,1283,382,249,631,102,733
公投第１６案,宜蘭縣,宜蘭市,南津里,33,946,307,187,494,56,550
公投第１６案,宜蘭縣,宜蘭市,南津里,34,1090,335,185,520,66,586
公投第１６案,宜蘭縣,宜蘭市,建業里,35,943,303,200,503,36,539
公投第１６案,宜蘭縣,宜蘭市,建業里,36,774,230,220,450,43,493
公投第１６案,宜蘭縣,宜蘭市,擺厘里,37,968,331,216,547,44,591
公投第１６案,宜蘭縣,宜蘭市,擺厘里,38,926,312,211,523,47,570
公投第１６案,宜蘭縣,宜蘭市,擺厘里,39,1019,301,235,536,76,612
公投第１６案,宜蘭縣,宜蘭市,延平里,40,1084,340,208,548,64,612
公投第１６案,宜蘭縣,宜蘭市,延平里,41,1095,327,235,562,33,595
公投第１６案,宜蘭縣,宜蘭市,延平里,42,1083,370,215,585,39,624
公投第１６案,宜蘭縣,宜蘭市,成功里,43,1108,292,240,532,63,595
公投第１６案,宜蘭縣,宜蘭市,成功里,44,848,281,178,459,34,493
公投第１６案,宜蘭縣,宜蘭市,成功里,45,1095,335,218,553,54,607
公投第１６案,宜蘭縣,宜蘭市,東村里,46,1110,339,234,573,54,627
公投第１６案,宜蘭縣,宜蘭市,東村里,47,1104,352,228,580,63,643
公投第１６案,宜蘭縣,宜蘭市,新東里,48,1134,362,219,581,63,644
公投第１６案,宜蘭縣,宜蘭市,新東里,49,1146,361,240,601,59,660
公投第１６案,宜蘭縣,宜蘭市,新東里,50,876,275,187,462,65,527
公投第１６案,宜蘭縣,宜蘭市,黎明里,51,905,258,178,436,70,506
公投第１６案,宜蘭縣,宜蘭市,黎明里,52,910,297,168,465,69,534
公投第１６案,宜蘭縣,宜蘭市,七張里,53,1434,390,221,611,63,674
公投第１６案,宜蘭縣,宜蘭市,孝廉里,54,1152,396,151,547,90,637
公投第１６案,宜蘭縣,宜蘭市,東門里,55,966,294,226,520,59,579
公投第１６案,宜蘭縣,宜蘭市,小東里,56,711,206,157,363,52,415
公投第１６案,宜蘭縣,宜蘭市,小東里,57,884,280,196,476,60,536
公投第１６案,宜蘭縣,宜蘭市,菜園里,58,1326,380,304,684,81,765
公投第１６案,宜蘭縣,宜蘭市,慈安里,59,909,247,186,433,35,468
公投第１６案,宜蘭縣,宜蘭市,慈安里,60,894,248,182,430,60,490
公投第１６案,宜蘭縣,宜蘭市,中興里,61,1259,344,229,573,64,637
公投第１６案,宜蘭縣,宜蘭市,中興里,62,789,227,148,375,41,416
公投第１６案,宜蘭縣,宜蘭市,中興里,63,867,199,235,434,41,475
公投第１６案,宜蘭縣,宜蘭市,新生里,64,1454,418,283,701,104,805
公投第１６案,宜蘭縣,宜蘭市,新生里,65,1130,407,240,647,45,692
公投第１６案,宜蘭縣,宜蘭市,茭白里,66,1087,297,163,460,40,500
公投第１６案,宜蘭縣,宜蘭市,茭白里,67,938,326,187,513,67,580
公投第１６案,宜蘭縣,宜蘭市,北津里,68,1285,403,252,655,62,717
公投第１６案,宜蘭縣,宜蘭市,北津里,69,952,264,185,449,42,491
公投第１６案,宜蘭縣,宜蘭市,梅洲里,70,948,296,223,519,52,571
公投第１６案,宜蘭縣,宜蘭市,梅洲里,71,1160,305,227,532,76,608
公投第１６案,宜蘭縣,宜蘭市,梅洲里,72,1015,288,235,523,80,603
公投第１６案,宜蘭縣,宜蘭市,南門里,73,424,147,91,238,26,264
公投第１６案,宜蘭縣,宜蘭市,南門里,74,964,281,201,482,82,564
公投第１６案,宜蘭縣,宜蘭市,中山里,75,959,255,189,444,72,516
公投第１６案,宜蘭縣,宜蘭市,西門里,76,814,264,190,454,56,510
公投第１６案,宜蘭縣,宜蘭市,西門里,77,885,236,220,456,70,526
公投第１６案,宜蘭縣,宜蘭市,北門里,78,1162,303,278,581,93,674
公投第１６案,宜蘭縣,羅東鎮,開明里,79,689,202,157,359,47,406
公投第１６案,宜蘭縣,羅東鎮,開明里,80,718,215,142,357,40,397
公投第１６案,宜蘭縣,羅東鎮,大新里,81,1475,432,301,733,87,820
公投第１６案,宜蘭縣,羅東鎮,東安里,82,1466,417,285,702,95,797
公投第１６案,宜蘭縣,羅東鎮,東安里,83,1075,314,232,546,57,603
公投第１６案,宜蘭縣,羅東鎮,東安里,84,963,262,211,473,64,537
公投第１６案,宜蘭縣,羅東鎮,新群里,85,1511,406,308,714,99,813
公投第１６案,宜蘭縣,羅東鎮,新群里,86,1166,298,290,588,46,634
公投第１６案,宜蘭縣,羅東鎮,羅莊里,87,1273,400,247,647,87,734
公投第１６案,宜蘭縣,羅東鎮,羅莊里,88,1735,502,352,854,58,912
公投第１６案,宜蘭縣,羅東鎮,南昌里,89,1487,454,288,742,100,842
公投第１６案,宜蘭縣,羅東鎮,南昌里,90,837,257,196,453,52,505
公投第１６案,宜蘭縣,羅東鎮,南豪里,91,1312,374,340,714,74,788
公投第１６案,宜蘭縣,羅東鎮,成功里,92,1502,413,288,701,100,801
公投第１６案,宜蘭縣,羅東鎮,仁德里,93,1138,326,224,550,41,591
公投第１６案,宜蘭縣,羅東鎮,仁和里,94,1010,303,200,503,60,563
公投第１６案,宜蘭縣,羅東鎮,中山里,95,1373,370,296,666,125,791
公投第１６案,宜蘭縣,羅東鎮,漢民里,96,1089,318,228,546,59,605
公投第１６案,宜蘭縣,羅東鎮,漢民里,97,1304,363,277,640,72,712
公投第１６案,宜蘭縣,羅東鎮,漢民里,98,1288,339,258,597,97,694
公投第１６案,宜蘭縣,羅東鎮,維揚里,99,1036,337,239,576,65,641
公投第１６案,宜蘭縣,羅東鎮,維揚里,100,969,334,201,535,79,614
公投第１６案,宜蘭縣,羅東鎮,維揚里,101,985,309,222,531,63,594
公投第１６案,宜蘭縣,羅東鎮,西安里,102,1420,423,316,739,101,840
公投第１６案,宜蘭縣,羅東鎮,西安里,103,1430,453,307,760,61,821
公投第１６案,宜蘭縣,羅東鎮,北成里,104,1075,343,216,559,74,633
公投第１６案,宜蘭縣,羅東鎮,北成里,105,879,274,192,466,57,523
公投第１６案,宜蘭縣,羅東鎮,北成里,106,850,245,186,431,41,472
公投第１６案,宜蘭縣,羅東鎮,國華里,107,1111,369,235,604,58,662
公投第１６案,宜蘭縣,羅東鎮,國華里,108,1139,413,237,650,60,710
公投第１６案,宜蘭縣,羅東鎮,國華里,109,1130,360,263,623,71,694
公投第１６案,宜蘭縣,羅東鎮,國華里,110,980,300,230,530,51,581
公投第１６案,宜蘭縣,羅東鎮,賢文里,111,1431,455,272,727,78,805
公投第１６案,宜蘭縣,羅東鎮,賢文里,112,1109,353,225,578,55,633
公投第１６案,宜蘭縣,羅東鎮,賢文里,113,1083,335,220,555,54,609
公投第１６案,宜蘭縣,羅東鎮,公正里,114,1404,410,329,739,76,815
公投第１６案,宜蘭縣,羅東鎮,公正里,115,1288,406,264,670,72,742
公投第１６案,宜蘭縣,羅東鎮,集祥里,116,1183,278,215,493,54,547
公投第１６案,宜蘭縣,羅東鎮,信義里,117,1105,343,265,608,53,661
公投第１６案,宜蘭縣,羅東鎮,信義里,118,987,318,231,549,55,604
公投第１６案,宜蘭縣,羅東鎮,信義里,119,773,243,175,418,52,470
公投第１６案,宜蘭縣,羅東鎮,樹林里,120,1366,483,322,805,63,868
公投第１６案,宜蘭縣,羅東鎮,樹林里,121,907,357,192,549,35,584
公投第１６案,宜蘭縣,羅東鎮,樹林里,122,1158,385,273,658,60,718
公投第１６案,宜蘭縣,羅東鎮,竹林里,123,977,268,203,471,97,568
公投第１６案,宜蘭縣,羅東鎮,竹林里,124,972,263,205,468,62,530
公投第１６案,宜蘭縣,羅東鎮,竹林里,125,977,318,209,527,52,579
公投第１６案,宜蘭縣,羅東鎮,仁愛里,126,1398,439,304,743,76,819
公投第１６案,宜蘭縣,羅東鎮,仁愛里,127,1022,315,216,531,44,575
公投第１６案,宜蘭縣,羅東鎮,仁愛里,128,1131,365,251,616,69,685
公投第１６案,宜蘭縣,蘇澳鎮,龍德里,129,1194,329,267,596,80,676
公投第１６案,宜蘭縣,蘇澳鎮,龍德里,130,1128,313,218,531,55,586
公投第１６案,宜蘭縣,蘇澳鎮,龍德里,131,1042,361,212,573,69,642
公投第１６案,宜蘭縣,蘇澳鎮,頂寮里,132,997,318,215,533,53,586
公投第１６案,宜蘭縣,蘇澳鎮,永榮里,133,1303,419,244,663,73,736
公投第１６案,宜蘭縣,蘇澳鎮,永榮里,134,1260,411,241,652,94,746
公投第１６案,宜蘭縣,蘇澳鎮,永榮里,135,1130,337,190,527,136,663
公投第１６案,宜蘭縣,蘇澳鎮,存仁里,136,559,151,117,268,47,315
公投第１６案,宜蘭縣,蘇澳鎮,存仁里,137,351,98,55,153,34,187
公投第１６案,宜蘭縣,蘇澳鎮,港邊里,138,889,258,167,425,65,490
公投第１６案,宜蘭縣,蘇澳鎮,港邊里,139,434,107,91,198,44,242
公投第１６案,宜蘭縣,蘇澳鎮,隘丁里,140,835,248,205,453,37,490
公投第１６案,宜蘭縣,蘇澳鎮,隘丁里,141,975,284,206,490,66,556
公投第１６案,宜蘭縣,蘇澳鎮,隘丁里,142,1135,339,230,569,110,679
公投第１６案,宜蘭縣,蘇澳鎮,新城里,143,788,255,200,455,57,512
公投第１６案,宜蘭縣,蘇澳鎮,新城里,144,469,121,90,211,39,250
公投第１６案,宜蘭縣,蘇澳鎮,聖愛里,145,811,230,147,377,54,431
公投第１６案,宜蘭縣,蘇澳鎮,聖愛里,146,867,252,179,431,37,468
公投第１６案,宜蘭縣,蘇澳鎮,聖愛里,147,1139,375,202,577,64,641
公投第１６案,宜蘭縣,蘇澳鎮,聖湖里,148,1146,339,195,534,70,604
公投第１６案,宜蘭縣,蘇澳鎮,聖湖里,149,1154,338,222,560,91,651
公投第１６案,宜蘭縣,蘇澳鎮,蘇西里,150,908,243,183,426,33,459
公投第１６案,宜蘭縣,蘇澳鎮,蘇西里,151,656,212,124,336,29,365
公投第１６案,宜蘭縣,蘇澳鎮,蘇西里,152,834,254,182,436,74,510
公投第１６案,宜蘭縣,蘇澳鎮,蘇北里,153,1025,347,215,562,51,613
公投第１６案,宜蘭縣,蘇澳鎮,蘇南里,154,455,134,112,246,21,267
公投第１６案,宜蘭縣,蘇澳鎮,蘇東里,155,535,155,118,273,40,313
公投第１６案,宜蘭縣,蘇澳鎮,長安里,156,536,165,135,300,40,340
公投第１６案,宜蘭縣,蘇澳鎮,永光里,157,451,149,107,256,19,275
公投第１６案,宜蘭縣,蘇澳鎮,永春里,158,593,178,104,282,50,332
公投第１６案,宜蘭縣,蘇澳鎮,永樂里,159,441,140,79,219,30,249
公投第１６案,宜蘭縣,蘇澳鎮,南安里,160,954,288,184,472,75,547
公投第１６案,宜蘭縣,蘇澳鎮,南正里,161,952,257,166,423,96,519
公投第１６案,宜蘭縣,蘇澳鎮,南成里,162,1125,291,197,488,102,590
公投第１６案,宜蘭縣,蘇澳鎮,南興里,163,763,217,122,339,94,433
公投第１６案,宜蘭縣,蘇澳鎮,南興里,164,706,154,91,245,68,313
公投第１６案,宜蘭縣,蘇澳鎮,南寧里,165,1068,246,188,434,82,516
公投第１６案,宜蘭縣,蘇澳鎮,南建里,166,666,191,122,313,75,388
公投第１６案,宜蘭縣,蘇澳鎮,南建里,167,574,132,97,229,99,328
公投第１６案,宜蘭縣,蘇澳鎮,東澳里,168,351,53,65,118,16,134
公投第１６案,宜蘭縣,蘇澳鎮,南強里,169,717,229,120,349,55,404
公投第１６案,宜蘭縣,蘇澳鎮,朝陽里,170,373,84,45,129,24,153
公投第１６案,宜蘭縣,蘇澳鎮,朝陽里,171,223,48,16,64,13,77
公投第１６案,宜蘭縣,頭城鎮,石城里,172,292,58,33,91,17,108
公投第１６案,宜蘭縣,頭城鎮,大里里,173,688,183,118,301,69,370
公投第１６案,宜蘭縣,頭城鎮,龜山里,174,688,202,144,346,50,396
公投第１６案,宜蘭縣,頭城鎮,大溪里,175,879,211,165,376,74,450
公投第１６案,宜蘭縣,頭城鎮,合興里,176,335,95,77,172,32,204
公投第１６案,宜蘭縣,頭城鎮,更新里,177,624,146,176,322,71,393
公投第１６案,宜蘭縣,頭城鎮,更新里,178,732,168,115,283,61,344
公投第１６案,宜蘭縣,頭城鎮,外澳里,179,892,206,140,346,73,419
公投第１６案,宜蘭縣,頭城鎮,港口里,180,690,159,118,277,35,312
公投第１６案,宜蘭縣,頭城鎮,武營里,181,842,233,161,394,58,452
公投第１６案,宜蘭縣,頭城鎮,武營里,182,736,211,148,359,51,410
公投第１６案,宜蘭縣,頭城鎮,大坑里,183,788,209,141,350,43,393
公投第１６案,宜蘭縣,頭城鎮,大坑里,184,560,132,110,242,46,288
公投第１６案,宜蘭縣,頭城鎮,城東里,185,712,231,136,367,57,424
公投第１６案,宜蘭縣,頭城鎮,城北里,186,502,163,123,286,35,321
公投第１６案,宜蘭縣,頭城鎮,城西里,187,569,185,138,323,36,359
公投第１６案,宜蘭縣,頭城鎮,城南里,188,633,179,140,319,42,361
公投第１６案,宜蘭縣,頭城鎮,竹安里,189,1132,256,197,453,80,533
公投第１６案,宜蘭縣,頭城鎮,竹安里,190,1035,249,172,421,74,495
公投第１６案,宜蘭縣,頭城鎮,新建里,191,847,246,200,446,58,504
公投第１６案,宜蘭縣,頭城鎮,新建里,192,1172,345,248,593,71,664
公投第１６案,宜蘭縣,頭城鎮,拔雅里,193,896,255,174,429,40,469
公投第１６案,宜蘭縣,頭城鎮,拔雅里,194,1075,331,245,576,46,622
公投第１６案,宜蘭縣,頭城鎮,福成里,195,931,255,219,474,75,549
公投第１６案,宜蘭縣,頭城鎮,金面里,196,1021,319,172,491,71,562
公投第１６案,宜蘭縣,頭城鎮,金面里,197,709,177,114,291,59,350
公投第１６案,宜蘭縣,頭城鎮,金盈里,198,689,231,167,398,44,442
公投第１６案,宜蘭縣,頭城鎮,頂埔里,199,615,209,121,330,55,385
公投第１６案,宜蘭縣,頭城鎮,頂埔里,200,759,234,122,356,59,415
公投第１６案,宜蘭縣,頭城鎮,下埔里,201,917,276,211,487,73,560
公投第１６案,宜蘭縣,頭城鎮,中崙里,202,1045,304,211,515,84,599
公投第１６案,宜蘭縣,頭城鎮,二城里,203,1130,295,255,550,90,640
公投第１６案,宜蘭縣,礁溪鄉,白雲村,204,1122,298,179,477,55,532
公投第１６案,宜蘭縣,礁溪鄉,白雲村,205,505,130,96,226,41,267
公投第１６案,宜蘭縣,礁溪鄉,玉石村,206,988,258,192,450,61,511
公投第１６案,宜蘭縣,礁溪鄉,玉石村,207,971,351,118,469,46,515
公投第１６案,宜蘭縣,礁溪鄉,德陽村,208,1246,324,228,552,68,620
公投第１６案,宜蘭縣,礁溪鄉,德陽村,209,1655,410,312,722,55,777
公投第１６案,宜蘭縣,礁溪鄉,德陽村,210,1132,287,203,490,28,518
公投第１６案,宜蘭縣,礁溪鄉,大忠村,211,783,237,165,402,37,439
公投第１６案,宜蘭縣,礁溪鄉,大忠村,212,928,247,199,446,52,498
公投第１６案,宜蘭縣,礁溪鄉,大忠村,213,848,247,160,407,49,456
公投第１６案,宜蘭縣,礁溪鄉,大義村,214,663,229,135,364,53,417
公投第１６案,宜蘭縣,礁溪鄉,六結村,215,608,199,117,316,25,341
公投第１６案,宜蘭縣,礁溪鄉,六結村,216,833,256,161,417,48,465
公投第１６案,宜蘭縣,礁溪鄉,二龍村,217,1233,297,225,522,41,563
公投第１６案,宜蘭縣,礁溪鄉,時潮村,218,854,261,164,425,54,479
公投第１６案,宜蘭縣,礁溪鄉,時潮村,219,575,156,109,265,38,303
公投第１６案,宜蘭縣,礁溪鄉,玉田村,220,835,234,174,408,60,468
公投第１６案,宜蘭縣,礁溪鄉,玉田村,221,1305,403,257,660,86,746
公投第１６案,宜蘭縣,礁溪鄉,三民村,222,830,219,164,383,77,460
公投第１６案,宜蘭縣,礁溪鄉,三民村,223,649,216,150,366,61,427
公投第１６案,宜蘭縣,礁溪鄉,三民村,224,923,217,176,393,68,461
公投第１６案,宜蘭縣,礁溪鄉,林美村,225,1177,306,169,475,59,534
公投第１６案,宜蘭縣,礁溪鄉,白鵝村,226,840,264,147,411,51,462
公投第１６案,宜蘭縣,礁溪鄉,玉光村,227,1051,293,224,517,59,576
公投第１６案,宜蘭縣,礁溪鄉,光武村,228,1339,369,222,591,73,664
公投第１６案,宜蘭縣,礁溪鄉,吳沙村,229,1194,384,234,618,84,702
公投第１６案,宜蘭縣,礁溪鄉,吳沙村,230,1314,351,304,655,119,774
公投第１６案,宜蘭縣,礁溪鄉,龍潭村,231,1125,313,245,558,42,600
公投第１６案,宜蘭縣,礁溪鄉,龍潭村,232,1207,375,252,627,95,722
公投第１６案,宜蘭縣,礁溪鄉,龍潭村,233,979,262,209,471,77,548
公投第１６案,宜蘭縣,礁溪鄉,匏崙村,234,954,295,213,508,77,585
公投第１６案,宜蘭縣,礁溪鄉,二結村,235,418,118,98,216,8,224
公投第１６案,宜蘭縣,壯圍鄉,吉祥村,236,1435,438,299,737,125,862
公投第１６案,宜蘭縣,壯圍鄉,吉祥村,237,1049,312,235,547,77,624
公投第１６案,宜蘭縣,壯圍鄉,古結村,238,1068,299,252,551,104,655
公投第１６案,宜蘭縣,壯圍鄉,美福村,239,868,223,172,395,103,498
公投第１６案,宜蘭縣,壯圍鄉,美福村,240,967,273,182,455,55,510
公投第１６案,宜蘭縣,壯圍鄉,新南村,241,940,278,214,492,84,576
公投第１６案,宜蘭縣,壯圍鄉,東港村,242,975,255,134,389,62,451
公投第１６案,宜蘭縣,壯圍鄉,復興村,243,797,224,178,402,86,488
公投第１６案,宜蘭縣,壯圍鄉,復興村,244,808,237,133,370,97,467
公投第１６案,宜蘭縣,壯圍鄉,過嶺村,245,911,247,187,434,106,540
公投第１６案,宜蘭縣,壯圍鄉,過嶺村,246,612,175,101,276,40,316
公投第１６案,宜蘭縣,壯圍鄉,永鎮村,247,790,241,183,424,81,505
公投第１６案,宜蘭縣,壯圍鄉,忠孝村,248,878,270,176,446,78,524
公投第１６案,宜蘭縣,壯圍鄉,忠孝村,249,723,242,167,409,63,472
公投第１６案,宜蘭縣,壯圍鄉,忠孝村,250,737,179,141,320,46,366
公投第１６案,宜蘭縣,壯圍鄉,古亭村,251,686,203,140,343,70,413
公投第１６案,宜蘭縣,壯圍鄉,古亭村,252,895,269,171,440,6,446
公投第１６案,宜蘭縣,壯圍鄉,功勞村,253,1237,386,280,666,89,755
公投第１６案,宜蘭縣,壯圍鄉,美城村,254,1134,362,202,564,86,650
公投第１６案,宜蘭縣,壯圍鄉,美城村,255,1107,316,209,525,85,610
公投第１６案,宜蘭縣,壯圍鄉,新社村,256,1057,310,228,538,70,608
公投第１６案,宜蘭縣,壯圍鄉,大福村,257,1051,286,203,489,46,535
公投第１６案,宜蘭縣,壯圍鄉,大福村,258,722,209,129,338,61,399
公投第１６案,宜蘭縣,員山鄉,員山村,259,1393,406,244,650,54,704
公投第１６案,宜蘭縣,員山鄉,員山村,260,895,237,188,425,40,465
公投第１６案,宜蘭縣,員山鄉,員山村,261,1231,332,229,561,102,663
公投第１６案,宜蘭縣,員山鄉,員山村,262,1098,313,198,511,48,559
公投第１６案,宜蘭縣,員山鄉,員山村,263,1031,282,191,473,62,535
公投第１６案,宜蘭縣,員山鄉,尚德村,264,1030,167,303,470,85,555
公投第１６案,宜蘭縣,員山鄉,尚德村,265,1168,233,258,491,59,550
公投第１６案,宜蘭縣,員山鄉,惠好村,266,809,220,161,381,78,459
公投第１６案,宜蘭縣,員山鄉,惠好村,267,778,218,163,381,70,451
公投第１６案,宜蘭縣,員山鄉,七賢村,268,1465,459,283,742,102,844
公投第１６案,宜蘭縣,員山鄉,深溝村,269,979,300,202,502,76,578
公投第１６案,宜蘭縣,員山鄉,深溝村,270,860,245,167,412,66,478
公投第１６案,宜蘭縣,員山鄉,蓁巷村,271,1205,287,214,501,101,602
公投第１６案,宜蘭縣,員山鄉,內城村,272,1082,309,190,499,117,616
公投第１６案,宜蘭縣,員山鄉,內城村,273,412,111,93,204,39,243
公投第１６案,宜蘭縣,員山鄉,中華村,274,403,89,72,161,26,187
公投第１６案,宜蘭縣,員山鄉,中華村,275,232,54,36,90,14,104
公投第１６案,宜蘭縣,員山鄉,永和村,276,944,265,189,454,50,504
公投第１６案,宜蘭縣,員山鄉,永和村,277,894,248,176,424,74,498
公投第１６案,宜蘭縣,員山鄉,頭分村,278,1356,378,276,654,101,755
公投第１６案,宜蘭縣,員山鄉,枕山村,279,780,214,182,396,58,454
公投第１６案,宜蘭縣,員山鄉,枕山村,280,932,262,238,500,93,593
公投第１６案,宜蘭縣,員山鄉,枕山村,281,583,125,123,248,52,300
公投第１６案,宜蘭縣,員山鄉,同樂村,282,900,245,181,426,78,504
公投第１６案,宜蘭縣,員山鄉,同樂村,283,747,205,141,346,55,401
公投第１６案,宜蘭縣,員山鄉,同樂村,284,788,217,143,360,70,430
公投第１６案,宜蘭縣,員山鄉,湖東村,285,884,229,149,378,82,460
公投第１６案,宜蘭縣,員山鄉,逸仙村,286,857,233,138,371,41,412
公投第１６案,宜蘭縣,員山鄉,湖北村,287,1016,238,203,441,52,493
公投第１６案,宜蘭縣,員山鄉,湖西村,288,690,155,100,255,51,306
公投第１６案,宜蘭縣,員山鄉,湖西村,289,689,166,118,284,78,362
公投第１６案,宜蘭縣,冬山鄉,珍珠村,290,807,245,179,424,63,487
公投第１６案,宜蘭縣,冬山鄉,珍珠村,291,817,264,174,438,27,465
公投第１６案,宜蘭縣,冬山鄉,補城村,292,1156,347,237,584,74,658
公投第１６案,宜蘭縣,冬山鄉,三奇村,293,892,249,166,415,58,473
公投第１６案,宜蘭縣,冬山鄉,大興村,294,897,274,192,466,58,524
公投第１６案,宜蘭縣,冬山鄉,東城村,295,1392,465,289,754,85,839
公投第１６案,宜蘭縣,冬山鄉,香和村,296,1471,448,320,768,68,836
公投第１６案,宜蘭縣,冬山鄉,香和村,297,1435,333,246,579,61,640
公投第１６案,宜蘭縣,冬山鄉,南興村,298,1519,427,296,723,49,772
公投第１６案,宜蘭縣,冬山鄉,南興村,299,1456,440,326,766,50,816
公投第１６案,宜蘭縣,冬山鄉,安平村,300,711,233,143,376,56,432
公投第１６案,宜蘭縣,冬山鄉,冬山村,301,694,221,145,366,41,407
公投第１６案,宜蘭縣,冬山鄉,太和村,302,1526,541,342,883,73,956
公投第１６案,宜蘭縣,冬山鄉,八寶村,303,884,261,186,447,34,481
公投第１６案,宜蘭縣,冬山鄉,丸山村,304,1465,382,241,623,90,713
公投第１６案,宜蘭縣,冬山鄉,中山村,305,488,149,102,251,26,277
公投第１６案,宜蘭縣,冬山鄉,順安村,306,1218,351,214,565,83,648
公投第１６案,宜蘭縣,冬山鄉,順安村,307,1291,350,238,588,69,657
公投第１６案,宜蘭縣,冬山鄉,順安村,308,1324,359,252,611,54,665
公投第１６案,宜蘭縣,冬山鄉,順安村,309,1160,337,196,533,41,574
公投第１６案,宜蘭縣,冬山鄉,永美村,310,1246,366,220,586,82,668
公投第１６案,宜蘭縣,冬山鄉,永美村,311,1754,447,367,814,66,880
公投第１６案,宜蘭縣,冬山鄉,武淵村,312,1217,337,256,593,51,644
公投第１６案,宜蘭縣,冬山鄉,群英村,313,1495,413,249,662,60,722
公投第１６案,宜蘭縣,冬山鄉,群英村,314,937,280,184,464,46,510
公投第１６案,宜蘭縣,冬山鄉,群英村,315,1101,309,209,518,41,559
公投第１６案,宜蘭縣,冬山鄉,群英村,316,1118,287,221,508,74,582
公投第１６案,宜蘭縣,冬山鄉,清溝村,317,1301,409,297,706,51,757
公投第１６案,宜蘭縣,冬山鄉,清溝村,318,1225,340,258,598,42,640
公投第１６案,宜蘭縣,冬山鄉,清溝村,319,1206,382,261,643,66,709
公投第１６案,宜蘭縣,冬山鄉,鹿埔村,320,1278,336,247,583,51,634
公投第１６案,宜蘭縣,冬山鄉,鹿埔村,321,1151,313,217,530,65,595
公投第１６案,宜蘭縣,冬山鄉,得安村,322,1094,295,170,465,76,541
公投第１６案,宜蘭縣,冬山鄉,廣興村,323,1247,363,281,644,65,709
公投第１６案,宜蘭縣,冬山鄉,廣興村,324,1247,337,222,559,68,627
公投第１６案,宜蘭縣,冬山鄉,廣安村,325,979,285,215,500,31,531
公投第１６案,宜蘭縣,冬山鄉,廣安村,326,698,237,158,395,30,425
公投第１６案,宜蘭縣,冬山鄉,柯林村,327,1726,669,161,830,47,877
公投第１６案,宜蘭縣,冬山鄉,大進村,328,782,163,144,307,26,333
公投第１６案,宜蘭縣,五結鄉,三興村,329,1076,283,197,480,71,551
公投第１６案,宜蘭縣,五結鄉,三興村,330,944,234,218,452,36,488
公投第１６案,宜蘭縣,五結鄉,二結村,331,836,266,153,419,41,460
公投第１６案,宜蘭縣,五結鄉,二結村,332,937,271,200,471,61,532
公投第１６案,宜蘭縣,五結鄉,鎮安村,333,1255,314,293,607,47,654
公投第１６案,宜蘭縣,五結鄉,鎮安村,334,1270,300,288,588,98,686
公投第１６案,宜蘭縣,五結鄉,上四村,335,801,211,154,365,29,394
公投第１６案,宜蘭縣,五結鄉,上四村,336,802,223,148,371,47,418
公投第１６案,宜蘭縣,五結鄉,中興村,337,1306,360,228,588,61,649
公投第１６案,宜蘭縣,五結鄉,四結村,338,1190,347,216,563,65,628
公投第１６案,宜蘭縣,五結鄉,四結村,339,1316,376,269,645,34,679
公投第１６案,宜蘭縣,五結鄉,福興村,340,965,294,191,485,38,523
公投第１６案,宜蘭縣,五結鄉,福興村,341,814,233,151,384,51,435
公投第１６案,宜蘭縣,五結鄉,五結村,342,1254,341,242,583,55,638
公投第１６案,宜蘭縣,五結鄉,五結村,343,1060,312,218,530,73,603
公投第１６案,宜蘭縣,五結鄉,五結村,344,1323,431,238,669,61,730
公投第１６案,宜蘭縣,五結鄉,協和村,345,1120,360,211,571,68,639
公投第１６案,宜蘭縣,五結鄉,協和村,346,893,286,154,440,36,476
公投第１６案,宜蘭縣,五結鄉,協和村,347,1220,320,275,595,54,649
公投第１６案,宜蘭縣,五結鄉,大吉村,348,924,304,197,501,37,538
公投第１６案,宜蘭縣,五結鄉,大吉村,349,933,307,193,500,61,561
公投第１６案,宜蘭縣,五結鄉,大吉村,350,986,285,194,479,49,528
公投第１６案,宜蘭縣,五結鄉,大吉村,351,748,210,139,349,59,408
公投第１６案,宜蘭縣,五結鄉,孝威村,352,1550,428,300,728,108,836
公投第１６案,宜蘭縣,五結鄉,錦眾村,353,629,200,111,311,45,356
公投第１６案,宜蘭縣,五結鄉,錦眾村,354,806,231,137,368,71,439
公投第１６案,宜蘭縣,五結鄉,利澤村,355,956,228,209,437,60,497
公投第１６案,宜蘭縣,五結鄉,利澤村,356,1066,300,217,517,52,569
公投第１６案,宜蘭縣,五結鄉,成興村,357,1513,395,270,665,85,750
公投第１６案,宜蘭縣,五結鄉,成興村,358,1566,445,293,738,86,824
公投第１６案,宜蘭縣,五結鄉,季新村,359,894,239,171,410,87,497
公投第１６案,宜蘭縣,五結鄉,季新村,360,1235,267,215,482,100,582
公投第１６案,宜蘭縣,五結鄉,季新村,361,704,214,119,333,65,398
公投第１６案,宜蘭縣,三星鄉,員山村,362,215,52,43,95,19,114
公投第１６案,宜蘭縣,三星鄉,天山村,363,523,120,81,201,40,241
公投第１６案,宜蘭縣,三星鄉,天福村,364,745,172,172,344,46,390
公投第１６案,宜蘭縣,三星鄉,萬德村,365,617,127,140,267,45,312
公投第１６案,宜蘭縣,三星鄉,貴林村,366,497,108,110,218,48,266
公投第１６案,宜蘭縣,三星鄉,萬富村,367,735,192,166,358,53,411
公投第１６案,宜蘭縣,三星鄉,雙賢村,368,583,154,109,263,61,324
公投第１６案,宜蘭縣,三星鄉,人和村,369,436,112,86,198,37,235
公投第１６案,宜蘭縣,三星鄉,義德村,370,1224,338,219,557,87,644
公投第１６案,宜蘭縣,三星鄉,集慶村,371,1151,269,215,484,66,550
公投第１６案,宜蘭縣,三星鄉,月眉村,372,870,269,180,449,30,479
公投第１６案,宜蘭縣,三星鄉,拱照村,373,1284,278,187,465,69,534
公投第１６案,宜蘭縣,三星鄉,行健村,374,897,275,196,471,59,530
公投第１６案,宜蘭縣,三星鄉,大隱村,375,1439,430,270,700,80,780
公投第１６案,宜蘭縣,三星鄉,大隱村,376,1445,389,264,653,83,736
公投第１６案,宜蘭縣,三星鄉,大隱村,377,1402,385,272,657,65,722
公投第１６案,宜蘭縣,三星鄉,大義村,378,1230,318,253,571,73,644
公投第１６案,宜蘭縣,三星鄉,尚武村,379,774,240,131,371,61,432
公投第１６案,宜蘭縣,三星鄉,大洲村,380,827,274,159,433,47,480
公投第１６案,宜蘭縣,三星鄉,大洲村,381,736,226,129,355,36,391
公投第１６案,宜蘭縣,三星鄉,尾塹村,382,1421,363,275,638,110,748
公投第１６案,宜蘭縣,大同鄉,寒溪村,383,893,183,119,302,68,370
公投第１６案,宜蘭縣,大同鄉,崙埤村,384,632,221,151,372,88,460
公投第１６案,宜蘭縣,大同鄉,松羅村,385,684,179,109,288,28,316
公投第１６案,宜蘭縣,大同鄉,復興村,386,264,89,55,144,31,175
公投第１６案,宜蘭縣,大同鄉,英士村,387,337,73,36,109,9,118
公投第１６案,宜蘭縣,大同鄉,樂水村,388,404,85,58,143,9,152
公投第１６案,宜蘭縣,大同鄉,太平村,389,55,10,10,20,6,26
公投第１６案,宜蘭縣,大同鄉,茂安村,390,199,60,62,122,31,153
公投第１６案,宜蘭縣,大同鄉,四季村,391,787,129,99,228,27,255
公投第１６案,宜蘭縣,大同鄉,南山村,392,680,193,108,301,65,366
公投第１６案,宜蘭縣,南澳鄉,東岳村,393,444,142,67,209,17,226
公投第１６案,宜蘭縣,南澳鄉,南澳村,394,1210,386,174,560,43,603
公投第１６案,宜蘭縣,南澳鄉,碧候村,395,962,316,186,502,100,602
公投第１６案,宜蘭縣,南澳鄉,金岳村,396,411,92,43,135,16,151
公投第１６案,宜蘭縣,南澳鄉,武塔村,397,447,145,132,277,29,306
公投第１６案,宜蘭縣,南澳鄉,金洋村,398,475,176,127,303,65,368
公投第１６案,宜蘭縣,南澳鄉,澳花村,399,695,234,118,352,59,411
公投第１６案,新竹縣,竹北市,鹿場里,1,1319,512,311,823,30,853
公投第１６案,新竹縣,竹北市,鹿場里,2,1321,467,312,779,24,803
公投第１６案,新竹縣,竹北市,鹿場里,3,1272,448,307,755,48,803
公投第１６案,新竹縣,竹北市,鹿場里,4,1467,503,302,805,44,849
公投第１６案,新竹縣,竹北市,鹿場里,5,1226,412,273,685,16,701
公投第１６案,新竹縣,竹北市,鹿場里,6,1412,446,341,787,15,802
公投第１６案,新竹縣,竹北市,鹿場里,7,1400,519,342,861,18,879
公投第１６案,新竹縣,竹北市,東平里,8,1415,476,369,845,35,880
公投第１６案,新竹縣,竹北市,東平里,9,1361,457,302,759,36,795
公投第１６案,新竹縣,竹北市,東平里,10,1515,484,327,811,26,837
公投第１６案,新竹縣,竹北市,東平里,11,1495,365,512,877,17,894
公投第１６案,新竹縣,竹北市,東平里,12,1417,501,318,819,20,839
公投第１６案,新竹縣,竹北市,東平里,13,1548,461,391,852,37,889
公投第１６案,新竹縣,竹北市,東平里,14,1434,446,328,774,31,805
公投第１６案,新竹縣,竹北市,中興里,15,1385,486,283,769,43,812
公投第１６案,新竹縣,竹北市,中興里,16,1247,439,322,761,36,797
公投第１６案,新竹縣,竹北市,中興里,17,1373,431,340,771,28,799
公投第１６案,新竹縣,竹北市,中興里,18,1345,498,331,829,30,859
公投第１６案,新竹縣,竹北市,中興里,19,1165,391,244,635,37,672
公投第１６案,新竹縣,竹北市,隘口里,20,1164,399,292,691,57,748
公投第１６案,新竹縣,竹北市,隘口里,21,1212,422,292,714,41,755
公投第１６案,新竹縣,竹北市,東海里,22,1507,455,274,729,33,762
公投第１６案,新竹縣,竹北市,東海里,23,1576,504,266,770,48,818
公投第１６案,新竹縣,竹北市,東興里,24,1464,463,325,788,39,827
公投第１６案,新竹縣,竹北市,東興里,25,1428,441,336,777,41,818
公投第１６案,新竹縣,竹北市,東興里,26,1442,576,123,699,29,728
公投第１６案,新竹縣,竹北市,東興里,27,1415,463,308,771,70,841
公投第１６案,新竹縣,竹北市,北興里,28,1666,486,336,822,28,850
公投第１６案,新竹縣,竹北市,北興里,29,1751,521,371,892,50,942
公投第１６案,新竹縣,竹北市,十興里,30,1196,403,307,710,25,735
公投第１６案,新竹縣,竹北市,十興里,31,1235,415,300,715,29,744
公投第１６案,新竹縣,竹北市,十興里,32,1204,363,301,664,21,685
公投第１６案,新竹縣,竹北市,十興里,33,1308,444,320,764,36,800
公投第１６案,新竹縣,竹北市,十興里,34,1233,403,286,689,18,707
公投第１６案,新竹縣,竹北市,興安里,35,1129,391,260,651,21,672
公投第１６案,新竹縣,竹北市,興安里,36,1069,391,242,633,29,662
公投第１６案,新竹縣,竹北市,興安里,37,1114,381,283,664,48,712
公投第１６案,新竹縣,竹北市,文化里,38,1103,400,242,642,37,679
公投第１６案,新竹縣,竹北市,文化里,39,1029,370,265,635,35,670
公投第１６案,新竹縣,竹北市,文化里,40,1133,427,268,695,36,731
公投第１６案,新竹縣,竹北市,斗崙里,41,1301,429,310,739,22,761
公投第１６案,新竹縣,竹北市,斗崙里,42,1798,601,402,1003,50,1053
公投第１６案,新竹縣,竹北市,斗崙里,43,1427,503,301,804,48,852
公投第１６案,新竹縣,竹北市,斗崙里,44,1462,555,310,865,45,910
公投第１６案,新竹縣,竹北市,中崙里,45,1342,507,303,810,37,847
公投第１６案,新竹縣,竹北市,中崙里,46,1480,575,300,875,32,907
公投第１６案,新竹縣,竹北市,中崙里,47,1645,524,379,903,29,932
公投第１６案,新竹縣,竹北市,中崙里,48,1256,466,301,767,30,797
公投第１６案,新竹縣,竹北市,北崙里,49,1181,377,306,683,40,723
公投第１６案,新竹縣,竹北市,北崙里,50,1329,500,308,808,53,861
公投第１６案,新竹縣,竹北市,北崙里,51,1228,456,299,755,31,786
公投第１６案,新竹縣,竹北市,新崙里,52,1552,492,334,826,50,876
公投第１６案,新竹縣,竹北市,新崙里,53,1480,538,324,862,31,893
公投第１６案,新竹縣,竹北市,新崙里,54,1487,436,325,761,43,804
公投第１６案,新竹縣,竹北市,新崙里,55,1470,451,296,747,57,804
公投第１６案,新竹縣,竹北市,竹北里,56,1477,460,277,737,49,786
公投第１６案,新竹縣,竹北市,竹北里,57,1611,572,352,924,60,984
公投第１６案,新竹縣,竹北市,竹北里,58,1555,525,309,834,77,911
公投第１６案,新竹縣,竹北市,竹北里,59,1468,435,315,750,49,799
公投第１６案,新竹縣,竹北市,竹仁里,60,1509,528,314,842,58,900
公投第１６案,新竹縣,竹北市,竹仁里,61,1602,479,355,834,57,891
公投第１６案,新竹縣,竹北市,竹仁里,62,1448,501,302,803,61,864
公投第１６案,新竹縣,竹北市,竹仁里,63,1318,466,250,716,80,796
公投第１６案,新竹縣,竹北市,竹仁里,64,1634,546,384,930,71,1001
公投第１６案,新竹縣,竹北市,竹仁里,65,1345,401,303,704,68,772
公投第１６案,新竹縣,竹北市,福德里,66,958,349,242,591,35,626
公投第１６案,新竹縣,竹北市,福德里,67,1112,410,242,652,51,703
公投第１６案,新竹縣,竹北市,福德里,68,1134,357,246,603,66,669
公投第１６案,新竹縣,竹北市,竹義里,69,1483,490,322,812,43,855
公投第１６案,新竹縣,竹北市,竹義里,70,1332,429,264,693,55,748
公投第１６案,新竹縣,竹北市,竹義里,71,1482,430,292,722,45,767
公投第１６案,新竹縣,竹北市,竹義里,72,1449,338,255,593,28,621
公投第１６案,新竹縣,竹北市,泰和里,73,1319,413,270,683,33,716
公投第１６案,新竹縣,竹北市,泰和里,74,1332,393,285,678,51,729
公投第１６案,新竹縣,竹北市,泰和里,75,1412,433,285,718,34,752
公投第１６案,新竹縣,竹北市,泰和里,76,1640,453,370,823,57,880
公投第１６案,新竹縣,竹北市,新社里,77,1323,426,282,708,44,752
公投第１６案,新竹縣,竹北市,新社里,78,1428,466,330,796,59,855
公投第１６案,新竹縣,竹北市,新社里,79,1533,496,335,831,62,893
公投第１６案,新竹縣,竹北市,新社里,80,1346,384,290,674,32,706
公投第１６案,新竹縣,竹北市,新社里,81,1219,385,223,608,61,669
公投第１６案,新竹縣,竹北市,新國里,82,1466,489,341,830,67,897
公投第１６案,新竹縣,竹北市,新國里,83,1147,335,257,592,40,632
公投第１６案,新竹縣,竹北市,新國里,84,1529,505,200,705,46,751
公投第１６案,新竹縣,竹北市,新國里,85,1522,518,306,824,54,878
公投第１６案,新竹縣,竹北市,聯興里,86,1383,429,337,766,66,832
公投第１６案,新竹縣,竹北市,聯興里,87,1569,499,344,843,59,902
公投第１６案,新竹縣,竹北市,聯興里,88,1506,486,265,751,38,789
公投第１６案,新竹縣,竹北市,麻園里,89,877,280,191,471,36,507
公投第１６案,新竹縣,竹北市,麻園里,90,1074,361,219,580,48,628
公投第１６案,新竹縣,竹北市,溪州里,91,1089,388,256,644,61,705
公投第１６案,新竹縣,竹北市,溪州里,92,1336,428,298,726,67,793
公投第１６案,新竹縣,竹北市,新庄里,93,1058,319,223,542,64,606
公投第１６案,新竹縣,竹北市,白地里,94,937,328,239,567,59,626
公投第１６案,新竹縣,竹北市,白地里,95,1206,368,254,622,70,692
公投第１６案,新竹縣,竹北市,新港里,96,1205,349,272,621,67,688
公投第１６案,新竹縣,竹北市,大眉里,97,1718,559,383,942,86,1028
公投第１６案,新竹縣,竹北市,大義里,98,917,265,202,467,59,526
公投第１６案,新竹縣,竹北市,大義里,99,668,228,142,370,37,407
公投第１６案,新竹縣,竹北市,尚義里,100,824,235,174,409,49,458
公投第１６案,新竹縣,竹北市,尚義里,101,782,237,153,390,75,465
公投第１６案,新竹縣,竹北市,崇義里,102,977,317,205,522,79,601
公投第１６案,新竹縣,竹北市,崇義里,103,937,229,200,429,28,457
公投第１６案,新竹縣,竹東鎮,上坪里,104,309,82,55,137,17,154
公投第１６案,新竹縣,竹東鎮,瑞峰里,105,416,94,81,175,38,213
公投第１６案,新竹縣,竹東鎮,軟橋里,106,386,116,65,181,12,193
公投第１６案,新竹縣,竹東鎮,員崠里,107,950,378,61,439,33,472
公投第１６案,新竹縣,竹東鎮,員崠里,108,1275,405,242,647,21,668
公投第１６案,新竹縣,竹東鎮,上舘里,109,1213,391,223,614,43,657
公投第１６案,新竹縣,竹東鎮,上舘里,110,1548,503,316,819,48,867
公投第１６案,新竹縣,竹東鎮,上舘里,111,1246,369,202,571,51,622
公投第１６案,新竹縣,竹東鎮,上舘里,112,1252,306,205,511,64,575
公投第１６案,新竹縣,竹東鎮,上舘里,113,1359,403,252,655,64,719
公投第１６案,新竹縣,竹東鎮,上舘里,114,1255,333,278,611,58,669
公投第１６案,新竹縣,竹東鎮,上舘里,115,1304,414,272,686,63,749
公投第１６案,新竹縣,竹東鎮,東寧里,116,1292,414,253,667,61,728
公投第１６案,新竹縣,竹東鎮,東寧里,117,1111,326,210,536,21,557
公投第１６案,新竹縣,竹東鎮,東寧里,118,880,285,188,473,52,525
公投第１６案,新竹縣,竹東鎮,中正里,119,670,197,166,363,30,393
公投第１６案,新竹縣,竹東鎮,中正里,120,1244,441,243,684,43,727
公投第１６案,新竹縣,竹東鎮,大鄉里,121,1126,346,199,545,63,608
公投第１６案,新竹縣,竹東鎮,大鄉里,122,1073,341,196,537,51,588
公投第１６案,新竹縣,竹東鎮,大鄉里,123,1215,384,267,651,44,695
公投第１６案,新竹縣,竹東鎮,大鄉里,124,1155,386,242,628,35,663
公投第１６案,新竹縣,竹東鎮,中山里,125,852,247,186,433,49,482
公投第１６案,新竹縣,竹東鎮,中山里,126,875,272,221,493,33,526
公投第１６案,新竹縣,竹東鎮,南華里,127,1070,389,213,602,48,650
公投第１６案,新竹縣,竹東鎮,東華里,128,704,210,136,346,33,379
公投第１６案,新竹縣,竹東鎮,商華里,129,951,213,137,350,32,382
公投第１６案,新竹縣,竹東鎮,商華里,130,984,312,230,542,21,563
公投第１６案,新竹縣,竹東鎮,商華里,131,1113,255,197,452,25,477
公投第１６案,新竹縣,竹東鎮,竹東里,132,595,179,140,319,38,357
公投第１６案,新竹縣,竹東鎮,竹東里,133,762,245,173,418,51,469
公投第１６案,新竹縣,竹東鎮,忠孝里,134,763,233,164,397,24,421
公投第１６案,新竹縣,竹東鎮,忠孝里,135,813,229,174,403,20,423
公投第１６案,新竹縣,竹東鎮,鷄林里,136,1310,347,240,587,36,623
公投第１６案,新竹縣,竹東鎮,鷄林里,137,1434,396,239,635,70,705
公投第１６案,新竹縣,竹東鎮,鷄林里,138,1131,355,239,594,42,636
公投第１６案,新竹縣,竹東鎮,仁愛里,139,967,305,191,496,32,528
公投第１６案,新竹縣,竹東鎮,仁愛里,140,1196,334,229,563,50,613
公投第１６案,新竹縣,竹東鎮,仁愛里,141,1154,367,234,601,55,656
公投第１６案,新竹縣,竹東鎮,榮樂里,142,715,204,190,394,43,437
公投第１６案,新竹縣,竹東鎮,榮樂里,143,685,227,144,371,18,389
公投第１６案,新竹縣,竹東鎮,榮華里,144,1352,421,240,661,59,720
公投第１６案,新竹縣,竹東鎮,榮華里,145,1407,455,292,747,59,806
公投第１６案,新竹縣,竹東鎮,榮華里,146,1362,441,249,690,43,733
公投第１６案,新竹縣,竹東鎮,榮華里,147,1330,432,274,706,49,755
公投第１６案,新竹縣,竹東鎮,榮華里,148,1441,431,275,706,79,785
公投第１６案,新竹縣,竹東鎮,五豐里,149,1248,360,241,601,29,630
公投第１６案,新竹縣,竹東鎮,五豐里,150,1263,317,211,528,38,566
公投第１６案,新竹縣,竹東鎮,五豐里,151,1232,326,225,551,43,594
公投第１６案,新竹縣,竹東鎮,五豐里,152,1143,287,218,505,38,543
公投第１６案,新竹縣,竹東鎮,五豐里,153,1529,516,282,798,39,837
公投第１６案,新竹縣,竹東鎮,五豐里,154,1140,338,230,568,59,627
公投第１６案,新竹縣,竹東鎮,陸豐里,155,570,186,149,335,31,366
公投第１６案,新竹縣,竹東鎮,三重里,156,1345,387,230,617,38,655
公投第１６案,新竹縣,竹東鎮,三重里,157,1381,399,243,642,94,736
公投第１６案,新竹縣,竹東鎮,三重里,158,1379,412,293,705,60,765
公投第１６案,新竹縣,竹東鎮,三重里,159,1033,340,207,547,56,603
公投第１６案,新竹縣,竹東鎮,三重里,160,1066,344,202,546,37,583
公投第１６案,新竹縣,竹東鎮,二重里,161,938,283,217,500,56,556
公投第１６案,新竹縣,竹東鎮,二重里,162,952,323,210,533,54,587
公投第１６案,新竹縣,竹東鎮,二重里,163,1468,528,305,833,52,885
公投第１６案,新竹縣,竹東鎮,二重里,164,1915,496,431,927,45,972
公投第１６案,新竹縣,竹東鎮,二重里,165,1220,331,250,581,55,636
公投第１６案,新竹縣,竹東鎮,二重里,166,1166,302,208,510,22,532
公投第１６案,新竹縣,竹東鎮,二重里,167,1492,433,238,671,44,715
公投第１６案,新竹縣,竹東鎮,二重里,168,1245,377,242,619,40,659
公投第１６案,新竹縣,竹東鎮,頭重里,169,1083,341,221,562,63,625
公投第１６案,新竹縣,竹東鎮,頭重里,170,1102,339,230,569,40,609
公投第１６案,新竹縣,竹東鎮,頭重里,171,1068,346,206,552,32,584
公投第１６案,新竹縣,竹東鎮,頭重里,172,1097,363,237,600,25,625
公投第１６案,新竹縣,竹東鎮,員山里,173,962,292,152,444,37,481
公投第１６案,新竹縣,竹東鎮,員山里,174,909,281,205,486,32,518
公投第１６案,新竹縣,竹東鎮,柯湖里,175,603,163,105,268,34,302
公投第１６案,新竹縣,新埔鎮,新埔里,176,983,354,204,558,32,590
公投第１６案,新竹縣,新埔鎮,新生里,177,597,204,137,341,28,369
公投第１６案,新竹縣,新埔鎮,新民里,178,1070,360,202,562,31,593
公投第１６案,新竹縣,新埔鎮,田新里,179,935,390,95,485,39,524
公投第１６案,新竹縣,新埔鎮,田新里,180,753,233,164,397,37,434
公投第１６案,新竹縣,新埔鎮,田新里,181,838,325,202,527,25,552
公投第１６案,新竹縣,新埔鎮,旱坑里,182,924,320,159,479,45,524
公投第１６案,新竹縣,新埔鎮,旱坑里,183,905,273,153,426,26,452
公投第１６案,新竹縣,新埔鎮,五埔里,184,948,312,195,507,30,537
公投第１６案,新竹縣,新埔鎮,五埔里,185,1017,331,214,545,48,593
公投第１６案,新竹縣,新埔鎮,四座里,186,1176,419,256,675,43,718
公投第１６案,新竹縣,新埔鎮,四座里,187,1122,387,241,628,70,698
公投第１６案,新竹縣,新埔鎮,四座里,188,1022,239,194,433,18,451
公投第１６案,新竹縣,新埔鎮,照門里,189,1429,409,255,664,49,713
公投第１６案,新竹縣,新埔鎮,清水里,190,451,165,101,266,38,304
公投第１６案,新竹縣,新埔鎮,鹿鳴里,191,724,199,179,378,33,411
公投第１６案,新竹縣,新埔鎮,新北里,192,617,205,146,351,43,394
公投第１６案,新竹縣,新埔鎮,巨埔里,193,1144,382,238,620,59,679
公投第１６案,新竹縣,新埔鎮,內立里,194,1139,374,239,613,46,659
公投第１６案,新竹縣,新埔鎮,寶石里,195,861,289,171,460,22,482
公投第１６案,新竹縣,新埔鎮,文山里,196,1093,300,216,516,40,556
公投第１６案,新竹縣,新埔鎮,文山里,197,978,277,192,469,36,505
公投第１６案,新竹縣,新埔鎮,文山里,198,1040,293,195,488,30,518
公投第１６案,新竹縣,新埔鎮,文山里,199,1160,353,217,570,50,620
公投第１６案,新竹縣,新埔鎮,上寮里,200,950,320,223,543,35,578
公投第１６案,新竹縣,新埔鎮,上寮里,201,882,288,168,456,42,498
公投第１６案,新竹縣,新埔鎮,下寮里,202,1281,416,262,678,61,739
公投第１６案,新竹縣,新埔鎮,下寮里,203,1212,366,221,587,65,652
公投第１６案,新竹縣,新埔鎮,南平里,204,1013,282,150,432,52,484
公投第１６案,新竹縣,新埔鎮,北平里,205,630,215,146,361,41,402
公投第１６案,新竹縣,關西鎮,東興里,206,480,169,104,273,34,307
公投第１６案,新竹縣,關西鎮,西安里,207,903,286,197,483,59,542
公投第１６案,新竹縣,關西鎮,西安里,208,1020,321,225,546,48,594
公投第１６案,新竹縣,關西鎮,南雄里,209,705,186,168,354,27,381
公投第１６案,新竹縣,關西鎮,北斗里,210,1056,300,238,538,46,584
公投第１６案,新竹縣,關西鎮,北斗里,211,1275,366,273,639,59,698
公投第１６案,新竹縣,關西鎮,北斗里,212,1287,392,296,688,66,754
公投第１６案,新竹縣,關西鎮,北山里,213,771,258,168,426,40,466
公投第１６案,新竹縣,關西鎮,仁安里,214,1046,305,218,523,45,568
公投第１６案,新竹縣,關西鎮,南山里,215,1030,290,249,539,63,602
公投第１６案,新竹縣,關西鎮,東安里,216,1208,398,242,640,48,688
公投第１６案,新竹縣,關西鎮,東安里,217,1095,289,208,497,29,526
公投第１６案,新竹縣,關西鎮,東安里,218,1350,342,253,595,117,712
公投第１６案,新竹縣,關西鎮,東山里,219,846,289,212,501,35,536
公投第１６案,新竹縣,關西鎮,東光里,220,1362,405,264,669,73,742
公投第１６案,新竹縣,關西鎮,南新里,221,903,241,167,408,39,447
公投第１６案,新竹縣,關西鎮,新富里,222,551,139,104,243,25,268
公投第１６案,新竹縣,關西鎮,玉山里,223,461,101,71,172,20,192
公投第１６案,新竹縣,關西鎮,金山里,224,572,179,109,288,31,319
公投第１６案,新竹縣,關西鎮,錦山里,225,943,252,221,473,34,507
公投第１６案,新竹縣,關西鎮,大同里,226,808,231,190,421,48,469
公投第１６案,新竹縣,關西鎮,石光里,227,923,342,200,542,41,583
公投第１６案,新竹縣,關西鎮,石光里,228,903,297,202,499,40,539
公投第１６案,新竹縣,關西鎮,東平里,229,977,334,192,526,51,577
公投第１６案,新竹縣,關西鎮,上林里,230,824,270,191,461,44,505
公投第１６案,新竹縣,關西鎮,新力里,231,559,191,126,317,25,342
公投第１６案,新竹縣,關西鎮,南和里,232,854,284,214,498,36,534
公投第１６案,新竹縣,湖口鄉,和興村,233,1393,369,282,651,58,709
公投第１６案,新竹縣,湖口鄉,和興村,234,1505,466,345,811,57,868
公投第１６案,新竹縣,湖口鄉,東興村,235,1188,388,310,698,54,752
公投第１６案,新竹縣,湖口鄉,東興村,236,1267,387,280,667,54,721
公投第１６案,新竹縣,湖口鄉,東興村,237,1668,519,359,878,57,935
公投第１６案,新竹縣,湖口鄉,德盛村,238,1719,579,336,915,83,998
公投第１６案,新竹縣,湖口鄉,德盛村,239,1162,405,246,651,69,720
公投第１６案,新竹縣,湖口鄉,德盛村,240,1833,531,345,876,52,928
公投第１６案,新竹縣,湖口鄉,愛勢村,241,1444,459,311,770,60,830
公投第１６案,新竹縣,湖口鄉,愛勢村,242,1347,478,284,762,76,838
公投第１６案,新竹縣,湖口鄉,愛勢村,243,1202,397,266,663,28,691
公投第１６案,新竹縣,湖口鄉,仁勢村,244,851,262,208,470,47,517
公投第１６案,新竹縣,湖口鄉,孝勢村,245,1272,418,294,712,56,768
公投第１６案,新竹縣,湖口鄉,中勢村,246,1275,389,275,664,58,722
公投第１６案,新竹縣,湖口鄉,中勢村,247,1560,533,366,899,65,964
公投第１６案,新竹縣,湖口鄉,中正村,248,1147,402,232,634,100,734
公投第１６案,新竹縣,湖口鄉,中正村,249,1729,563,345,908,65,973
公投第１６案,新竹縣,湖口鄉,信勢村,250,1402,420,269,689,65,754
公投第１６案,新竹縣,湖口鄉,信勢村,251,1183,401,248,649,57,706
公投第１６案,新竹縣,湖口鄉,信勢村,252,1282,412,321,733,53,786
公投第１６案,新竹縣,湖口鄉,信勢村,253,1335,441,321,762,42,804
公投第１６案,新竹縣,湖口鄉,信義村,254,1493,540,338,878,52,930
公投第１６案,新竹縣,湖口鄉,信義村,255,1877,577,393,970,29,999
公投第１６案,新竹縣,湖口鄉,波羅村,256,1082,369,256,625,48,673
公投第１６案,新竹縣,湖口鄉,波羅村,257,1115,361,273,634,52,686
公投第１６案,新竹縣,湖口鄉,長嶺村,258,1193,338,210,548,56,604
公投第１６案,新竹縣,湖口鄉,長嶺村,259,1947,581,376,957,51,1008
公投第１６案,新竹縣,湖口鄉,長安村,260,1125,371,248,619,62,681
公投第１６案,新竹縣,湖口鄉,湖口村,261,1050,336,237,573,49,622
公投第１６案,新竹縣,湖口鄉,湖口村,262,1733,588,361,949,52,1001
公投第１６案,新竹縣,湖口鄉,湖鏡村,263,1284,434,277,711,48,759
公投第１６案,新竹縣,湖口鄉,湖鏡村,264,1062,373,225,598,34,632
公投第１６案,新竹縣,湖口鄉,湖南村,265,1547,512,290,802,77,879
公投第１６案,新竹縣,湖口鄉,中興村,266,1494,430,274,704,37,741
公投第１６案,新竹縣,湖口鄉,中興村,267,1634,461,286,747,39,786
公投第１６案,新竹縣,湖口鄉,中興村,268,1444,392,250,642,29,671
公投第１６案,新竹縣,湖口鄉,中興村,269,1324,377,274,651,43,694
公投第１６案,新竹縣,湖口鄉,鳳凰村,270,1058,341,216,557,44,601
公投第１６案,新竹縣,湖口鄉,鳳凰村,271,1220,288,196,484,23,507
公投第１６案,新竹縣,湖口鄉,鳳凰村,272,1333,430,271,701,47,748
公投第１６案,新竹縣,湖口鄉,鳳凰村,273,1461,396,304,700,66,766
公投第１６案,新竹縣,湖口鄉,勝利村,274,1429,434,278,712,37,749
公投第１６案,新竹縣,湖口鄉,勝利村,275,1506,400,279,679,29,708
公投第１６案,新竹縣,湖口鄉,勝利村,276,1103,392,234,626,44,670
公投第１６案,新竹縣,湖口鄉,鳳山村,277,1495,402,303,705,36,741
公投第１６案,新竹縣,湖口鄉,鳳山村,278,752,240,143,383,51,434
公投第１６案,新竹縣,湖口鄉,鳳山村,279,986,309,194,503,43,546
公投第１６案,新竹縣,新豐鄉,福興村,280,1080,298,211,509,69,578
公投第１６案,新竹縣,新豐鄉,青埔村,281,887,246,187,433,37,470
公投第１６案,新竹縣,新豐鄉,青埔村,282,954,286,212,498,39,537
公投第１６案,新竹縣,新豐鄉,中崙村,283,1003,279,227,506,50,556
公投第１６案,新竹縣,新豐鄉,中崙村,284,1106,350,207,557,47,604
公投第１６案,新竹縣,新豐鄉,中崙村,285,1123,359,256,615,45,660
公投第１６案,新竹縣,新豐鄉,瑞興村,286,891,263,209,472,54,526
公投第１６案,新竹縣,新豐鄉,瑞興村,287,874,233,166,399,41,440
公投第１６案,新竹縣,新豐鄉,後湖村,288,824,235,190,425,33,458
公投第１６案,新竹縣,新豐鄉,後湖村,289,975,287,174,461,29,490
公投第１６案,新竹縣,新豐鄉,坡頭村,290,847,275,151,426,57,483
公投第１６案,新竹縣,新豐鄉,埔和村,291,1477,412,342,754,77,831
公投第１６案,新竹縣,新豐鄉,埔和村,292,1266,345,253,598,65,663
公投第１６案,新竹縣,新豐鄉,新豐村,293,1029,290,184,474,82,556
公投第１６案,新竹縣,新豐鄉,新豐村,294,1063,286,229,515,62,577
公投第１６案,新竹縣,新豐鄉,員山村,295,1055,328,218,546,34,580
公投第１６案,新竹縣,新豐鄉,員山村,296,1445,474,299,773,37,810
公投第１６案,新竹縣,新豐鄉,忠孝村,297,1413,500,315,815,51,866
公投第１６案,新竹縣,新豐鄉,忠孝村,298,971,326,265,591,33,624
公投第１６案,新竹縣,新豐鄉,忠孝村,299,1135,378,273,651,29,680
公投第１６案,新竹縣,新豐鄉,山崎村,300,1269,385,256,641,46,687
公投第１６案,新竹縣,新豐鄉,山崎村,301,1257,399,260,659,49,708
公投第１６案,新竹縣,新豐鄉,山崎村,302,1662,550,349,899,58,957
公投第１６案,新竹縣,新豐鄉,上坑村,303,1486,448,291,739,31,770
公投第１６案,新竹縣,新豐鄉,鳳坑村,304,1067,368,226,594,74,668
公投第１６案,新竹縣,新豐鄉,重興村,305,1302,450,270,720,69,789
公投第１６案,新竹縣,新豐鄉,重興村,306,1410,424,286,710,77,787
公投第１６案,新竹縣,新豐鄉,重興村,307,1267,381,248,629,66,695
公投第１６案,新竹縣,新豐鄉,重興村,308,1258,347,229,576,52,628
公投第１６案,新竹縣,新豐鄉,崎頂村,309,1217,336,225,561,34,595
公投第１６案,新竹縣,新豐鄉,崎頂村,310,1456,478,281,759,41,800
公投第１６案,新竹縣,新豐鄉,松林村,311,1157,389,243,632,48,680
公投第１６案,新竹縣,新豐鄉,松林村,312,1089,325,218,543,34,577
公投第１６案,新竹縣,新豐鄉,松林村,313,1160,381,252,633,21,654
公投第１６案,新竹縣,新豐鄉,松林村,314,976,359,224,583,26,609
公投第１６案,新竹縣,新豐鄉,松柏村,315,1443,476,307,783,33,816
公投第１６案,新竹縣,新豐鄉,松柏村,316,1247,377,227,604,32,636
公投第１６案,新竹縣,新豐鄉,松柏村,317,1411,487,279,766,26,792
公投第１６案,新竹縣,新豐鄉,松柏村,318,1238,262,416,678,58,736
公投第１６案,新竹縣,芎林鄉,華龍村,319,417,111,112,223,20,243
公投第１６案,新竹縣,芎林鄉,五龍村,320,534,184,157,341,34,375
公投第１６案,新竹縣,芎林鄉,秀湖村,321,963,278,224,502,63,565
公投第１６案,新竹縣,芎林鄉,永興村,322,418,144,102,246,26,272
公投第１６案,新竹縣,芎林鄉,石潭村,323,1312,348,305,653,69,722
公投第１６案,新竹縣,芎林鄉,石潭村,324,1354,336,285,621,57,678
公投第１６案,新竹縣,芎林鄉,新鳳村,325,785,252,169,421,50,471
公投第１６案,新竹縣,芎林鄉,新鳳村,326,797,240,163,403,86,489
公投第１６案,新竹縣,芎林鄉,中坑村,327,623,195,155,350,29,379
公投第１６案,新竹縣,芎林鄉,水坑村,328,759,217,176,393,46,439
公投第１６案,新竹縣,芎林鄉,文林村,329,1272,345,241,586,61,647
公投第１６案,新竹縣,芎林鄉,文林村,330,1129,370,255,625,47,672
公投第１６案,新竹縣,芎林鄉,芎林村,331,713,231,173,404,40,444
公投第１６案,新竹縣,芎林鄉,芎林村,332,839,273,204,477,47,524
公投第１６案,新竹縣,芎林鄉,上山村,333,1123,418,283,701,38,739
公投第１６案,新竹縣,芎林鄉,上山村,334,981,365,192,557,26,583
公投第１６案,新竹縣,芎林鄉,上山村,335,1078,369,230,599,62,661
公投第１６案,新竹縣,芎林鄉,上山村,336,1094,349,203,552,43,595
公投第１６案,新竹縣,芎林鄉,下山村,337,1102,343,248,591,60,651
公投第１６案,新竹縣,橫山鄉,橫山村,338,1231,398,287,685,69,754
公投第１６案,新竹縣,橫山鄉,橫山村,339,1041,308,258,566,61,627
公投第１６案,新竹縣,橫山鄉,橫山村,340,1132,380,259,639,48,687
公投第１６案,新竹縣,橫山鄉,田寮村,341,859,294,174,468,41,509
公投第１６案,新竹縣,橫山鄉,南昌村,342,204,60,40,100,17,117
公投第１６案,新竹縣,橫山鄉,豐鄉村,343,222,52,37,89,11,100
公投第１６案,新竹縣,橫山鄉,豐田村,344,338,103,67,170,47,217
公投第１６案,新竹縣,橫山鄉,內灣村,345,916,272,182,454,38,492
公投第１６案,新竹縣,橫山鄉,力行村,346,573,135,89,224,15,239
公投第１６案,新竹縣,橫山鄉,力行村,347,275,92,83,175,14,189
公投第１６案,新竹縣,橫山鄉,福興村,348,463,125,76,201,25,226
公投第１６案,新竹縣,橫山鄉,沙坑村,349,690,238,149,387,54,441
公投第１６案,新竹縣,橫山鄉,沙坑村,350,288,78,57,135,13,148
公投第１６案,新竹縣,橫山鄉,新興村,351,685,243,145,388,53,441
公投第１６案,新竹縣,橫山鄉,新興村,352,868,316,174,490,46,536
公投第１６案,新竹縣,橫山鄉,大肚村,353,1561,519,367,886,81,967
公投第１６案,新竹縣,北埔鄉,北埔村,354,1158,346,209,555,19,574
公投第１６案,新竹縣,北埔鄉,南興村,355,1238,367,297,664,73,737
公投第１６案,新竹縣,北埔鄉,大湖村,356,580,164,148,312,27,339
公投第１６案,新竹縣,北埔鄉,埔尾村,357,931,323,185,508,35,543
公投第１６案,新竹縣,北埔鄉,埔尾村,358,1653,516,330,846,84,930
公投第１６案,新竹縣,北埔鄉,水磜村,359,845,277,161,438,47,485
公投第１６案,新竹縣,北埔鄉,南埔村,360,384,111,83,194,17,211
公投第１６案,新竹縣,北埔鄉,大林村,361,763,235,160,395,26,421
公投第１６案,新竹縣,北埔鄉,南坑村,362,333,83,81,164,20,184
公投第１６案,新竹縣,北埔鄉,外坪村,363,295,91,52,143,8,151
公投第１６案,新竹縣,寶山鄉,雙溪村,364,1158,341,237,578,84,662
公投第１６案,新竹縣,寶山鄉,雙溪村,365,1437,475,299,774,50,824
公投第１６案,新竹縣,寶山鄉,雙新村,366,1470,471,295,766,72,838
公投第１６案,新竹縣,寶山鄉,雙新村,367,1170,368,291,659,50,709
公投第１６案,新竹縣,寶山鄉,大崎村,368,1900,652,383,1035,63,1098
公投第１６案,新竹縣,寶山鄉,三峰村,369,1056,316,198,514,26,540
公投第１６案,新竹縣,寶山鄉,新城村,370,1205,412,283,695,66,761
公投第１６案,新竹縣,寶山鄉,寶斗村,371,766,249,145,394,46,440
公投第１６案,新竹縣,寶山鄉,深井村,372,846,293,175,468,51,519
公投第１６案,新竹縣,寶山鄉,寶山村,373,804,266,179,445,46,491
公投第１６案,新竹縣,寶山鄉,油田村,374,607,212,132,344,18,362
公投第１６案,新竹縣,寶山鄉,山湖村,375,554,189,146,335,20,355
公投第１６案,新竹縣,峨眉鄉,峨眉村,376,879,290,215,505,69,574
公投第１６案,新竹縣,峨眉鄉,中盛村,377,683,213,161,374,57,431
公投第１６案,新竹縣,峨眉鄉,石井村,378,604,185,147,332,34,366
公投第１６案,新竹縣,峨眉鄉,七星村,379,339,99,76,175,23,198
公投第１６案,新竹縣,峨眉鄉,七星村,380,276,52,58,110,6,116
公投第１６案,新竹縣,峨眉鄉,富興村,381,1406,443,294,737,119,856
公投第１６案,新竹縣,峨眉鄉,湖光村,382,462,176,68,244,47,291
公投第１６案,新竹縣,峨眉鄉,湖光村,383,419,121,83,204,23,227
公投第１６案,新竹縣,尖石鄉,嘉樂村,384,474,96,76,172,15,187
公投第１６案,新竹縣,尖石鄉,嘉樂村,385,357,113,48,161,9,170
公投第１６案,新竹縣,尖石鄉,義興村,386,225,50,43,93,17,110
公投第１６案,新竹縣,尖石鄉,義興村,387,374,104,51,155,12,167
公投第１６案,新竹縣,尖石鄉,新樂村,388,773,191,108,299,15,314
公投第１６案,新竹縣,尖石鄉,新樂村,389,490,121,91,212,17,229
公投第１６案,新竹縣,尖石鄉,錦屏村,390,531,104,71,175,6,181
公投第１６案,新竹縣,尖石鄉,錦屏村,391,660,158,129,287,11,298
公投第１６案,新竹縣,尖石鄉,梅花村,392,613,173,165,338,63,401
公投第１６案,新竹縣,尖石鄉,玉峰村,393,593,131,123,254,3,257
公投第１６案,新竹縣,尖石鄉,玉峰村,394,575,121,120,241,31,272
公投第１６案,新竹縣,尖石鄉,玉峰村,395,126,43,33,76,8,84
公投第１６案,新竹縣,尖石鄉,秀巒村,396,499,97,70,167,7,174
公投第１６案,新竹縣,尖石鄉,秀巒村,397,785,124,82,206,20,226
公投第１６案,新竹縣,尖石鄉,秀巒村,398,289,71,69,140,24,164
公投第１６案,新竹縣,五峰鄉,大隘村,399,672,215,121,336,30,366
公投第１６案,新竹縣,五峰鄉,大隘村,400,713,166,117,283,24,307
公投第１６案,新竹縣,五峰鄉,桃山村,401,594,131,61,192,8,200
公投第１６案,新竹縣,五峰鄉,桃山村,402,896,196,127,323,57,380
公投第１６案,新竹縣,五峰鄉,花園村,403,727,164,109,273,13,286
公投第１６案,新竹縣,五峰鄉,竹林村,404,395,74,66,140,9,149
公投第１６案,苗栗縣,苗栗市,中苗里,1,1087,368,225,593,33,626
公投第１６案,苗栗縣,苗栗市,青苗里,2,1018,350,190,540,31,571
公投第１６案,苗栗縣,苗栗市,維祥里,3,1156,375,232,607,30,637
公投第１６案,苗栗縣,苗栗市,維祥里,4,1118,401,178,579,37,616
公投第１６案,苗栗縣,苗栗市,維祥里,5,1084,376,216,592,45,637
公投第１６案,苗栗縣,苗栗市,維新里,6,1203,416,251,667,50,717
公投第１６案,苗栗縣,苗栗市,維新里,7,1306,479,237,716,59,775
公投第１６案,苗栗縣,苗栗市,維新里,8,1193,412,235,647,68,715
公投第１６案,苗栗縣,苗栗市,玉清里,9,1115,402,225,627,35,662
公投第１６案,苗栗縣,苗栗市,玉清里,10,1119,418,221,639,48,687
公投第１６案,苗栗縣,苗栗市,玉華里,11,1132,397,246,643,54,697
公投第１６案,苗栗縣,苗栗市,玉華里,12,1289,428,263,691,49,740
公投第１６案,苗栗縣,苗栗市,玉華里,13,1264,447,262,709,53,762
公投第１６案,苗栗縣,苗栗市,綠苗里,14,870,285,175,460,37,497
公投第１６案,苗栗縣,苗栗市,高苗里,15,1008,338,131,469,46,515
公投第１６案,苗栗縣,苗栗市,高苗里,16,1078,342,195,537,32,569
公投第１６案,苗栗縣,苗栗市,高苗里,17,1077,380,225,605,42,647
公投第１６案,苗栗縣,苗栗市,新苗里,18,880,292,187,479,34,513
公投第１６案,苗栗縣,苗栗市,玉苗里,19,894,265,189,454,49,503
公投第１６案,苗栗縣,苗栗市,大同里,20,522,173,109,282,22,304
公投第１６案,苗栗縣,苗栗市,恭敬里,21,1376,486,317,803,69,872
公投第１６案,苗栗縣,苗栗市,水源里,22,1391,454,250,704,47,751
公投第１６案,苗栗縣,苗栗市,水源里,23,1081,368,224,592,57,649
公投第１６案,苗栗縣,苗栗市,勝利里,24,1272,413,243,656,54,710
公投第１６案,苗栗縣,苗栗市,勝利里,25,1112,377,265,642,73,715
公投第１６案,苗栗縣,苗栗市,勝利里,26,813,328,193,521,23,544
公投第１６案,苗栗縣,苗栗市,勝利里,27,767,248,163,411,26,437
公投第１６案,苗栗縣,苗栗市,清華里,28,1010,329,202,531,36,567
公投第１６案,苗栗縣,苗栗市,清華里,29,1182,432,203,635,31,666
公投第１６案,苗栗縣,苗栗市,清華里,30,965,324,208,532,22,554
公投第１６案,苗栗縣,苗栗市,上苗里,31,607,220,132,352,12,364
公投第１６案,苗栗縣,苗栗市,上苗里,32,990,365,217,582,30,612
公投第１６案,苗栗縣,苗栗市,北苗里,33,1230,356,212,568,108,676
公投第１６案,苗栗縣,苗栗市,北苗里,34,1372,465,282,747,48,795
公投第１６案,苗栗縣,苗栗市,北苗里,35,1213,429,224,653,59,712
公投第１６案,苗栗縣,苗栗市,北苗里,36,1272,459,217,676,48,724
公投第１６案,苗栗縣,苗栗市,嘉盛里,37,1221,458,252,710,38,748
公投第１６案,苗栗縣,苗栗市,嘉盛里,38,1104,357,233,590,53,643
公投第１６案,苗栗縣,苗栗市,嘉盛里,39,1171,391,202,593,15,608
公投第１６案,苗栗縣,苗栗市,福星里,40,1392,461,268,729,58,787
公投第１６案,苗栗縣,苗栗市,福星里,41,1356,438,299,737,60,797
公投第１６案,苗栗縣,苗栗市,福星里,42,1387,445,296,741,67,808
公投第１６案,苗栗縣,苗栗市,福安里,43,1206,393,245,638,38,676
公投第１６案,苗栗縣,苗栗市,福安里,44,1004,359,237,596,42,638
公投第１６案,苗栗縣,苗栗市,福安里,45,1202,391,245,636,37,673
公投第１６案,苗栗縣,苗栗市,嘉新里,46,1052,370,237,607,36,643
公投第１６案,苗栗縣,苗栗市,嘉新里,47,873,320,189,509,29,538
公投第１６案,苗栗縣,苗栗市,嘉新里,48,975,389,214,603,49,652
公投第１６案,苗栗縣,苗栗市,建功里,49,1003,405,188,593,50,643
公投第１６案,苗栗縣,苗栗市,建功里,50,1000,331,221,552,29,581
公投第１６案,苗栗縣,苗栗市,建功里,51,1047,366,186,552,39,591
公投第１６案,苗栗縣,苗栗市,建功里,52,1025,354,239,593,38,631
公投第１６案,苗栗縣,苗栗市,福麗里,53,1130,341,235,576,34,610
公投第１６案,苗栗縣,苗栗市,福麗里,54,1146,400,222,622,32,654
公投第１６案,苗栗縣,苗栗市,福麗里,55,1432,497,284,781,60,841
公投第１６案,苗栗縣,苗栗市,福麗里,56,1492,436,222,658,46,704
公投第１６案,苗栗縣,苗栗市,文山里,57,1125,389,262,651,39,690
公投第１６案,苗栗縣,苗栗市,文山里,58,1241,410,238,648,48,696
公投第１６案,苗栗縣,苗栗市,文山里,59,1278,449,280,729,36,765
公投第１６案,苗栗縣,苗栗市,文聖里,60,1293,442,248,690,32,722
公投第１６案,苗栗縣,苗栗市,文聖里,61,1342,417,245,662,45,707
公投第１６案,苗栗縣,苗栗市,文聖里,62,857,252,179,431,46,477
公投第１６案,苗栗縣,苗栗市,新川里,63,1180,362,237,599,47,646
公投第１６案,苗栗縣,苗栗市,南勢里,64,1072,360,236,596,40,636
公投第１６案,苗栗縣,苗栗市,南勢里,65,912,307,153,460,26,486
公投第１６案,苗栗縣,苗栗市,新英里,66,796,249,136,385,41,426
公投第１６案,苗栗縣,苗栗市,新英里,67,869,234,171,405,27,432
公投第１６案,苗栗縣,公館鄉,館中村,68,789,272,201,473,49,522
公投第１６案,苗栗縣,公館鄉,館中村,69,792,295,196,491,33,524
公投第１６案,苗栗縣,公館鄉,館東村,70,1117,388,231,619,101,720
公投第１６案,苗栗縣,公館鄉,館東村,71,1255,421,290,711,74,785
公投第１６案,苗栗縣,公館鄉,館南村,72,1141,366,255,621,63,684
公投第１６案,苗栗縣,公館鄉,館南村,73,1172,385,237,622,65,687
公投第１６案,苗栗縣,公館鄉,館南村,74,1100,391,247,638,57,695
公投第１６案,苗栗縣,公館鄉,中義村,75,1232,393,208,601,52,653
公投第１６案,苗栗縣,公館鄉,中義村,76,1081,330,175,505,67,572
公投第１６案,苗栗縣,公館鄉,玉泉村,77,1250,468,245,713,62,775
公投第１６案,苗栗縣,公館鄉,玉泉村,78,1081,343,239,582,50,632
公投第１６案,苗栗縣,公館鄉,大坑村,79,964,280,195,475,80,555
公投第１６案,苗栗縣,公館鄉,福基村,80,1038,340,205,545,86,631
公投第１６案,苗栗縣,公館鄉,福德村,81,360,121,81,202,26,228
公投第１６案,苗栗縣,公館鄉,福星村,82,865,259,191,450,48,498
公投第１６案,苗栗縣,公館鄉,福星村,83,1166,333,254,587,65,652
公投第１６案,苗栗縣,公館鄉,石墻村,84,719,232,168,400,30,430
公投第１６案,苗栗縣,公館鄉,石墻村,85,788,230,159,389,46,435
公投第１６案,苗栗縣,公館鄉,開礦村,86,303,108,57,165,37,202
公投第１６案,苗栗縣,公館鄉,五谷村,87,1322,454,276,730,65,795
公投第１６案,苗栗縣,公館鄉,五谷村,88,933,304,179,483,52,535
公投第１６案,苗栗縣,公館鄉,玉谷村,89,1455,410,290,700,92,792
公投第１６案,苗栗縣,公館鄉,鶴岡村,90,1615,543,348,891,111,1002
公投第１６案,苗栗縣,公館鄉,鶴山村,91,1451,438,267,705,99,804
公投第１６案,苗栗縣,公館鄉,尖山村,92,1462,496,308,804,78,882
公投第１６案,苗栗縣,公館鄉,仁安村,93,1317,396,265,661,76,737
公投第１６案,苗栗縣,公館鄉,南河村,94,221,78,39,117,14,131
公投第１６案,苗栗縣,公館鄉,北河村,95,329,95,65,160,15,175
公投第１６案,苗栗縣,頭屋鄉,頭屋村,96,1335,495,329,824,69,893
公投第１６案,苗栗縣,頭屋鄉,頭屋村,97,1168,438,281,719,108,827
公投第１６案,苗栗縣,頭屋鄉,獅潭村,98,792,280,200,480,40,520
公投第１６案,苗栗縣,頭屋鄉,獅潭村,99,918,378,226,604,54,658
公投第１６案,苗栗縣,頭屋鄉,北坑村,100,725,272,152,424,40,464
公投第１６案,苗栗縣,頭屋鄉,曲洞村,101,899,329,183,512,43,555
公投第１６案,苗栗縣,頭屋鄉,飛鳳村,102,369,98,69,167,14,181
公投第１６案,苗栗縣,頭屋鄉,象山村,103,844,267,200,467,37,504
公投第１６案,苗栗縣,頭屋鄉,象山村,104,1007,352,221,573,31,604
公投第１６案,苗栗縣,頭屋鄉,明德村,105,794,305,163,468,33,501
公投第１６案,苗栗縣,頭屋鄉,明德村,106,211,84,54,138,18,156
公投第１６案,苗栗縣,頭屋鄉,鳴鳳村,107,328,132,82,214,24,238
公投第１６案,苗栗縣,銅鑼鄉,銅鑼村,108,887,324,177,501,48,549
公投第１６案,苗栗縣,銅鑼鄉,銅鑼村,109,1052,356,221,577,54,631
公投第１６案,苗栗縣,銅鑼鄉,銅鑼村,110,1347,456,317,773,54,827
公投第１６案,苗栗縣,銅鑼鄉,銅鑼村,111,1177,377,242,619,53,672
公投第１６案,苗栗縣,銅鑼鄉,樟樹村,112,1268,368,276,644,41,685
公投第１６案,苗栗縣,銅鑼鄉,九湖村,113,1185,334,221,555,28,583
公投第１６案,苗栗縣,銅鑼鄉,福興村,114,1029,373,177,550,47,597
公投第１６案,苗栗縣,銅鑼鄉,朝陽村,115,905,304,181,485,36,521
公投第１６案,苗栗縣,銅鑼鄉,朝陽村,116,750,252,168,420,46,466
公投第１６案,苗栗縣,銅鑼鄉,竹森村,117,1080,312,202,514,39,553
公投第１６案,苗栗縣,銅鑼鄉,中平村,118,1108,345,202,547,54,601
公投第１６案,苗栗縣,銅鑼鄉,中平村,119,862,266,153,419,38,457
公投第１６案,苗栗縣,銅鑼鄉,中平村,120,1216,345,259,604,43,647
公投第１６案,苗栗縣,銅鑼鄉,興隆村,121,588,166,107,273,30,303
公投第１６案,苗栗縣,銅鑼鄉,盛隆村,122,429,126,81,207,27,234
公投第１６案,苗栗縣,銅鑼鄉,新隆村,123,541,171,116,287,30,317
公投第１６案,苗栗縣,三義鄉,廣盛村,124,853,271,192,463,58,521
公投第１６案,苗栗縣,三義鄉,廣盛村,125,983,351,230,581,34,615
公投第１６案,苗栗縣,三義鄉,廣盛村,126,1080,354,235,589,59,648
公投第１６案,苗栗縣,三義鄉,廣盛村,127,1216,380,240,620,31,651
公投第１６案,苗栗縣,三義鄉,勝興村,128,1017,322,236,558,45,603
公投第１６案,苗栗縣,三義鄉,勝興村,129,1180,290,318,608,24,632
公投第１６案,苗栗縣,三義鄉,勝興村,130,1198,374,280,654,30,684
公投第１６案,苗栗縣,三義鄉,龍騰村,131,417,135,86,221,21,242
公投第１６案,苗栗縣,三義鄉,双湖村,132,991,294,190,484,32,516
公投第１６案,苗栗縣,三義鄉,双湖村,133,834,256,210,466,22,488
公投第１６案,苗栗縣,三義鄉,双潭村,134,622,193,143,336,30,366
公投第１６案,苗栗縣,三義鄉,双潭村,135,749,234,185,419,41,460
公投第１６案,苗栗縣,三義鄉,西湖村,136,692,276,151,427,33,460
公投第１６案,苗栗縣,三義鄉,西湖村,137,759,299,199,498,37,535
公投第１６案,苗栗縣,三義鄉,鯉魚潭村,138,629,160,132,292,44,336
公投第１６案,苗栗縣,三義鄉,鯉魚潭村,139,669,207,144,351,37,388
公投第１６案,苗栗縣,西湖鄉,高埔村,140,601,172,128,300,26,326
公投第１６案,苗栗縣,西湖鄉,下埔村,141,566,197,118,315,26,341
公投第１６案,苗栗縣,西湖鄉,五湖村,142,843,249,188,437,55,492
公投第１６案,苗栗縣,西湖鄉,四湖村,143,648,197,121,318,24,342
公投第１６案,苗栗縣,西湖鄉,三湖村,144,936,262,155,417,55,472
公投第１６案,苗栗縣,西湖鄉,龍洞村,145,461,142,92,234,13,247
公投第１６案,苗栗縣,西湖鄉,金獅村,146,515,153,121,274,20,294
公投第１６案,苗栗縣,西湖鄉,湖東村,147,1141,309,236,545,70,615
公投第１６案,苗栗縣,西湖鄉,二湖村,148,671,208,146,354,40,394
公投第１６案,苗栗縣,通霄鎮,通東里,149,1142,325,273,598,62,660
公投第１６案,苗栗縣,通霄鎮,通西里,150,884,278,238,516,60,576
公投第１６案,苗栗縣,通霄鎮,通西里,151,1068,297,214,511,90,601
公投第１６案,苗栗縣,通霄鎮,平元里,152,1009,296,234,530,49,579
公投第１６案,苗栗縣,通霄鎮,平元里,153,859,285,213,498,63,561
公投第１６案,苗栗縣,通霄鎮,平安里,154,1040,372,182,554,54,608
公投第１６案,苗栗縣,通霄鎮,平安里,155,1008,244,157,401,23,424
公投第１６案,苗栗縣,通霄鎮,圳頭里,156,686,180,153,333,75,408
公投第１６案,苗栗縣,通霄鎮,梅南里,157,761,228,220,448,61,509
公投第１６案,苗栗縣,通霄鎮,梅南里,158,790,225,134,359,43,402
公投第１６案,苗栗縣,通霄鎮,通南里,159,966,268,194,462,72,534
公投第１６案,苗栗縣,通霄鎮,通南里,160,972,255,162,417,86,503
公投第１６案,苗栗縣,通霄鎮,通南里,161,771,225,156,381,52,433
公投第１６案,苗栗縣,通霄鎮,內湖里,162,758,176,139,315,26,341
公投第１６案,苗栗縣,通霄鎮,內湖里,163,1078,330,198,528,54,582
公投第１６案,苗栗縣,通霄鎮,楓樹里,164,459,99,71,170,29,199
公投第１６案,苗栗縣,通霄鎮,烏眉里,165,894,240,163,403,46,449
公投第１６案,苗栗縣,通霄鎮,福龍里,166,402,87,63,150,9,159
公投第１６案,苗栗縣,通霄鎮,福源里,167,802,238,145,383,50,433
公投第１６案,苗栗縣,通霄鎮,城北里,168,684,178,136,314,33,347
公投第１６案,苗栗縣,通霄鎮,城南里,169,943,236,157,393,50,443
公投第１６案,苗栗縣,通霄鎮,南和里,170,790,225,187,412,67,479
公投第１６案,苗栗縣,通霄鎮,福興里,171,673,156,112,268,18,286
公投第１６案,苗栗縣,通霄鎮,坪頂里,172,1232,357,214,571,80,651
公投第１６案,苗栗縣,通霄鎮,五南里,173,1286,410,262,672,83,755
公投第１６案,苗栗縣,通霄鎮,五北里,174,649,175,156,331,54,385
公投第１６案,苗栗縣,通霄鎮,五北里,175,769,200,141,341,45,386
公投第１６案,苗栗縣,通霄鎮,通灣里,176,1148,313,228,541,90,631
公投第１６案,苗栗縣,通霄鎮,通灣里,177,1138,264,209,473,102,575
公投第１６案,苗栗縣,通霄鎮,新埔里,178,1121,296,189,485,70,555
公投第１６案,苗栗縣,通霄鎮,內島里,179,769,229,165,394,31,425
公投第１６案,苗栗縣,通霄鎮,白東里,180,616,142,137,279,19,298
公投第１６案,苗栗縣,通霄鎮,白東里,181,799,236,148,384,52,436
公投第１６案,苗栗縣,通霄鎮,白西里,182,743,195,140,335,38,373
公投第１６案,苗栗縣,苑裡鎮,苑東里,183,873,260,202,462,61,523
公投第１６案,苗栗縣,苑裡鎮,苑東里,184,1346,433,296,729,60,789
公投第１６案,苗栗縣,苑裡鎮,苑南里,185,951,328,241,569,61,630
公投第１６案,苗栗縣,苑裡鎮,苑南里,186,615,166,136,302,21,323
公投第１６案,苗栗縣,苑裡鎮,苑北里,187,878,266,203,469,80,549
公投第１６案,苗栗縣,苑裡鎮,西平里,188,767,243,175,418,55,473
公投第１６案,苗栗縣,苑裡鎮,西平里,189,776,218,171,389,48,437
公投第１６案,苗栗縣,苑裡鎮,苑港里,190,1231,341,212,553,82,635
公投第１６案,苗栗縣,苑裡鎮,西勢里,191,1145,364,254,618,61,679
公投第１６案,苗栗縣,苑裡鎮,西勢里,192,850,255,171,426,50,476
公投第１６案,苗栗縣,苑裡鎮,海岸里,193,1052,309,196,505,77,582
公投第１６案,苗栗縣,苑裡鎮,房裡里,194,1114,326,259,585,54,639
公投第１６案,苗栗縣,苑裡鎮,房裡里,195,1136,354,244,598,72,670
公投第１６案,苗栗縣,苑裡鎮,客庄里,196,1194,382,251,633,38,671
公投第１６案,苗栗縣,苑裡鎮,客庄里,197,1579,499,329,828,74,902
公投第１６案,苗栗縣,苑裡鎮,客庄里,198,1149,378,266,644,69,713
公投第１６案,苗栗縣,苑裡鎮,中正里,199,1057,300,262,562,81,643
公投第１６案,苗栗縣,苑裡鎮,中正里,200,1101,333,193,526,22,548
公投第１６案,苗栗縣,苑裡鎮,苑坑里,201,912,191,189,380,47,427
公投第１６案,苗栗縣,苑裡鎮,水坡里,202,652,177,143,320,44,364
公投第１６案,苗栗縣,苑裡鎮,新復里,203,1348,423,270,693,88,781
公投第１６案,苗栗縣,苑裡鎮,山脚里,204,733,168,144,312,31,343
公投第１６案,苗栗縣,苑裡鎮,山脚里,205,662,188,122,310,22,332
公投第１６案,苗栗縣,苑裡鎮,舊社里,206,893,265,197,462,54,516
公投第１６案,苗栗縣,苑裡鎮,舊社里,207,910,310,184,494,51,545
公投第１６案,苗栗縣,苑裡鎮,福田里,208,1270,343,298,641,58,699
公投第１６案,苗栗縣,苑裡鎮,石鎮里,209,545,158,101,259,33,292
公投第１６案,苗栗縣,苑裡鎮,蕉埔里,210,792,258,159,417,85,502
公投第１６案,苗栗縣,苑裡鎮,南勢里,211,726,215,165,380,38,418
公投第１６案,苗栗縣,苑裡鎮,泰田里,212,827,200,115,315,29,344
公投第１６案,苗栗縣,苑裡鎮,泰田里,213,782,229,178,407,56,463
公投第１６案,苗栗縣,苑裡鎮,上舘里,214,788,223,174,397,38,435
公投第１６案,苗栗縣,苑裡鎮,上舘里,215,846,215,211,426,36,462
公投第１６案,苗栗縣,苑裡鎮,玉田里,216,828,254,187,441,64,505
公投第１６案,苗栗縣,苑裡鎮,玉田里,217,943,292,185,477,73,550
公投第１６案,苗栗縣,苑裡鎮,社苓里,218,1082,361,235,596,36,632
公投第１６案,苗栗縣,苑裡鎮,社苓里,219,1234,373,306,679,69,748
公投第１６案,苗栗縣,苑裡鎮,山柑里,220,1434,389,321,710,73,783
公投第１６案,苗栗縣,苑裡鎮,田心里,221,987,317,203,520,51,571
公投第１６案,苗栗縣,苑裡鎮,田心里,222,882,279,225,504,59,563
公投第１６案,苗栗縣,後龍鎮,南龍里,223,590,182,126,308,36,344
公投第１６案,苗栗縣,後龍鎮,南龍里,224,883,263,233,496,61,557
公投第１６案,苗栗縣,後龍鎮,中龍里,225,793,254,177,431,62,493
公投第１６案,苗栗縣,後龍鎮,北龍里,226,732,218,181,399,42,441
公投第１６案,苗栗縣,後龍鎮,北龍里,227,592,189,135,324,36,360
公投第１６案,苗栗縣,後龍鎮,大庄里,228,1113,345,257,602,61,663
公投第１６案,苗栗縣,後龍鎮,大庄里,229,1195,346,267,613,64,677
公投第１６案,苗栗縣,後龍鎮,大庄里,230,997,345,223,568,50,618
公投第１６案,苗栗縣,後龍鎮,大庄里,231,913,239,178,417,25,442
公投第１６案,苗栗縣,後龍鎮,東明里,232,641,184,118,302,33,335
公投第１６案,苗栗縣,後龍鎮,東明里,233,848,236,159,395,49,444
公投第１６案,苗栗縣,後龍鎮,灣寶里,234,1264,357,250,607,93,700
公投第１６案,苗栗縣,後龍鎮,海寶里,235,965,243,187,430,58,488
公投第１６案,苗栗縣,後龍鎮,豐富里,236,1216,478,291,769,83,852
公投第１６案,苗栗縣,後龍鎮,校椅里,237,977,288,196,484,49,533
公投第１６案,苗栗縣,後龍鎮,埔頂里,238,943,246,177,423,53,476
公投第１６案,苗栗縣,後龍鎮,埔頂里,239,910,238,203,441,80,521
公投第１６案,苗栗縣,後龍鎮,埔頂里,240,851,234,187,421,52,473
公投第１６案,苗栗縣,後龍鎮,新民里,241,725,229,196,425,25,450
公投第１６案,苗栗縣,後龍鎮,新民里,242,650,195,145,340,50,390
公投第１６案,苗栗縣,後龍鎮,復興里,243,706,188,138,326,47,373
公投第１６案,苗栗縣,後龍鎮,大山里,244,748,225,163,388,48,436
公投第１６案,苗栗縣,後龍鎮,大山里,245,801,199,133,332,42,374
公投第１６案,苗栗縣,後龍鎮,溪洲里,246,1107,333,239,572,53,625
公投第１６案,苗栗縣,後龍鎮,溪洲里,247,1197,311,248,559,90,649
公投第１６案,苗栗縣,後龍鎮,外埔里,248,1036,283,191,474,54,528
公投第１６案,苗栗縣,後龍鎮,海埔里,249,913,215,166,381,38,419
公投第１６案,苗栗縣,後龍鎮,秀水里,250,719,228,155,383,57,440
公投第１６案,苗栗縣,後龍鎮,水尾里,251,1037,296,202,498,99,597
公投第１６案,苗栗縣,後龍鎮,龍津里,252,601,165,121,286,21,307
公投第１６案,苗栗縣,後龍鎮,龍坑里,253,1269,295,226,521,54,575
公投第１６案,苗栗縣,後龍鎮,福寧里,254,735,195,137,332,28,360
公投第１６案,苗栗縣,後龍鎮,中和里,255,422,66,65,131,13,144
公投第１６案,苗栗縣,後龍鎮,中和里,256,625,187,134,321,31,352
公投第１６案,苗栗縣,後龍鎮,南港里,257,1234,293,223,516,63,579
公投第１６案,苗栗縣,造橋鄉,造橋村,258,1171,392,288,680,85,765
公投第１６案,苗栗縣,造橋鄉,造橋村,259,889,290,190,480,49,529
公投第１６案,苗栗縣,造橋鄉,平興村,260,479,149,66,215,22,237
公投第１６案,苗栗縣,造橋鄉,豐湖村,261,1024,347,205,552,50,602
公投第１６案,苗栗縣,造橋鄉,大西村,262,1214,310,270,580,77,657
公投第１６案,苗栗縣,造橋鄉,大西村,263,1071,297,232,529,31,560
公投第１６案,苗栗縣,造橋鄉,大西村,264,1157,328,208,536,72,608
公投第１６案,苗栗縣,造橋鄉,錦水村,265,512,151,111,262,37,299
公投第１６案,苗栗縣,造橋鄉,大龍村,266,491,184,100,284,26,310
公投第１６案,苗栗縣,造橋鄉,朝陽村,267,1272,396,291,687,78,765
公投第１６案,苗栗縣,造橋鄉,談文村,268,785,244,155,399,52,451
公投第１６案,苗栗縣,造橋鄉,龍昇村,269,962,298,243,541,97,638
公投第１６案,苗栗縣,竹南鎮,竹南里,270,1086,327,284,611,41,652
公投第１６案,苗栗縣,竹南鎮,竹南里,271,826,272,186,458,30,488
公投第１６案,苗栗縣,竹南鎮,照南里,272,1051,318,183,501,56,557
公投第１６案,苗栗縣,竹南鎮,照南里,273,1235,433,251,684,50,734
公投第１６案,苗栗縣,竹南鎮,照南里,274,1016,337,198,535,80,615
公投第１６案,苗栗縣,竹南鎮,正南里,275,1472,444,281,725,75,800
公投第１６案,苗栗縣,竹南鎮,正南里,276,1301,356,242,598,40,638
公投第１６案,苗栗縣,竹南鎮,新南里,277,1544,455,284,739,43,782
公投第１６案,苗栗縣,竹南鎮,新南里,278,1512,455,335,790,41,831
公投第１６案,苗栗縣,竹南鎮,新南里,279,1463,403,310,713,62,775
公投第１６案,苗栗縣,竹南鎮,大厝里,280,1073,302,230,532,38,570
公投第１６案,苗栗縣,竹南鎮,大厝里,281,1453,460,332,792,46,838
公投第１６案,苗栗縣,竹南鎮,大厝里,282,1245,431,283,714,39,753
公投第１６案,苗栗縣,竹南鎮,大厝里,283,1487,498,355,853,36,889
公投第１６案,苗栗縣,竹南鎮,營盤里,284,1018,322,226,548,49,597
公投第１６案,苗栗縣,竹南鎮,營盤里,285,1105,336,275,611,45,656
公投第１６案,苗栗縣,竹南鎮,營盤里,286,1322,358,284,642,59,701
公投第１６案,苗栗縣,竹南鎮,聖福里,287,1140,394,235,629,32,661
公投第１６案,苗栗縣,竹南鎮,聖福里,288,1067,368,231,599,55,654
公投第１６案,苗栗縣,竹南鎮,聖福里,289,1136,375,301,676,42,718
公投第１６案,苗栗縣,竹南鎮,竹興里,290,1253,372,218,590,63,653
公投第１６案,苗栗縣,竹南鎮,竹興里,291,963,240,198,438,76,514
公投第１６案,苗栗縣,竹南鎮,竹興里,292,1021,296,203,499,57,556
公投第１６案,苗栗縣,竹南鎮,龍山里,293,1154,409,235,644,48,692
公投第１６案,苗栗縣,竹南鎮,龍山里,294,1042,305,242,547,48,595
公投第１６案,苗栗縣,竹南鎮,天文里,295,1293,428,272,700,46,746
公投第１６案,苗栗縣,竹南鎮,天文里,296,816,273,176,449,36,485
公投第１６案,苗栗縣,竹南鎮,龍鳳里,297,989,307,196,503,60,563
公投第１６案,苗栗縣,竹南鎮,龍鳳里,298,1122,394,226,620,58,678
公投第１６案,苗栗縣,竹南鎮,山佳里,299,1111,271,205,476,49,525
公投第１６案,苗栗縣,竹南鎮,山佳里,300,1036,330,233,563,52,615
公投第１６案,苗栗縣,竹南鎮,山佳里,301,1112,305,224,529,30,559
公投第１６案,苗栗縣,竹南鎮,山佳里,302,1348,409,258,667,38,705
公投第１６案,苗栗縣,竹南鎮,佳興里,303,1114,347,264,611,40,651
公投第１６案,苗栗縣,竹南鎮,佳興里,304,1119,365,251,616,58,674
公投第１６案,苗栗縣,竹南鎮,佳興里,305,878,275,190,465,34,499
公投第１６案,苗栗縣,竹南鎮,中港里,306,1059,343,258,601,54,655
公投第１６案,苗栗縣,竹南鎮,中華里,307,869,282,190,472,49,521
公投第１６案,苗栗縣,竹南鎮,中華里,308,800,240,169,409,38,447
公投第１６案,苗栗縣,竹南鎮,中華里,309,1165,399,268,667,44,711
公投第１６案,苗栗縣,竹南鎮,中英里,310,791,242,178,420,41,461
公投第１６案,苗栗縣,竹南鎮,中英里,311,677,205,140,345,27,372
公投第１６案,苗栗縣,竹南鎮,中美里,312,797,275,182,457,60,517
公投第１６案,苗栗縣,竹南鎮,中美里,313,1191,369,230,599,44,643
公投第１６案,苗栗縣,竹南鎮,開元里,314,1027,303,210,513,23,536
公投第１６案,苗栗縣,竹南鎮,海口里,315,1341,411,321,732,62,794
公投第１６案,苗栗縣,竹南鎮,海口里,316,1378,397,246,643,61,704
公投第１６案,苗栗縣,竹南鎮,海口里,317,1216,388,255,643,38,681
公投第１６案,苗栗縣,竹南鎮,港墘里,318,1570,480,301,781,47,828
公投第１６案,苗栗縣,竹南鎮,港墘里,319,538,156,132,288,44,332
公投第１６案,苗栗縣,竹南鎮,公舘里,320,1166,299,216,515,30,545
公投第１６案,苗栗縣,竹南鎮,大埔里,321,1488,545,190,735,43,778
公投第１６案,苗栗縣,竹南鎮,大埔里,322,1449,418,265,683,38,721
公投第１６案,苗栗縣,竹南鎮,大埔里,323,1182,339,248,587,75,662
公投第１６案,苗栗縣,竹南鎮,頂埔里,324,1175,317,274,591,77,668
公投第１６案,苗栗縣,竹南鎮,頂埔里,325,983,289,233,522,37,559
公投第１６案,苗栗縣,竹南鎮,崎頂里,326,492,177,110,287,21,308
公投第１６案,苗栗縣,竹南鎮,崎頂里,327,1074,327,240,567,55,622
公投第１６案,苗栗縣,竹南鎮,崎頂里,328,852,230,198,428,45,473
公投第１６案,苗栗縣,竹南鎮,崎頂里,329,1297,360,284,644,44,688
公投第１６案,苗栗縣,竹南鎮,公義里,330,1028,311,189,500,58,558
公投第１６案,苗栗縣,頭份市,流東里,331,915,245,185,430,68,498
公投第１６案,苗栗縣,頭份市,流東里,332,1292,390,270,660,76,736
公投第１６案,苗栗縣,頭份市,珊湖里,333,928,288,228,516,36,552
公投第１６案,苗栗縣,頭份市,珊湖里,334,835,249,152,401,12,413
公投第１６案,苗栗縣,頭份市,斗煥里,335,1070,339,213,552,35,587
公投第１６案,苗栗縣,頭份市,斗煥里,336,879,238,172,410,30,440
公投第１６案,苗栗縣,頭份市,斗煥里,337,1039,284,216,500,38,538
公投第１６案,苗栗縣,頭份市,新華里,338,1129,341,252,593,66,659
公投第１６案,苗栗縣,頭份市,新華里,339,1041,287,217,504,69,573
公投第１６案,苗栗縣,頭份市,新華里,340,1546,447,260,707,80,787
公投第１６案,苗栗縣,頭份市,興隆里,341,935,318,221,539,45,584
公投第１６案,苗栗縣,頭份市,興隆里,342,1180,299,283,582,35,617
公投第１６案,苗栗縣,頭份市,興隆里,343,1499,441,300,741,27,768
公投第１６案,苗栗縣,頭份市,興隆里,344,747,230,154,384,20,404
公投第１６案,苗栗縣,頭份市,上埔里,345,1406,446,269,715,43,758
公投第１６案,苗栗縣,頭份市,上埔里,346,1193,349,258,607,67,674
公投第１６案,苗栗縣,頭份市,土牛里,347,948,280,220,500,52,552
公投第１６案,苗栗縣,頭份市,頭份里,348,869,274,170,444,23,467
公投第１６案,苗栗縣,頭份市,頭份里,349,1142,351,252,603,59,662
公投第１６案,苗栗縣,頭份市,頭份里,350,1286,385,286,671,29,700
公投第１６案,苗栗縣,頭份市,忠孝里,351,903,307,185,492,44,536
公投第１６案,苗栗縣,頭份市,忠孝里,352,1186,430,248,678,58,736
公投第１６案,苗栗縣,頭份市,忠孝里,353,1016,380,190,570,29,599
公投第１６案,苗栗縣,頭份市,自強里,354,985,258,258,516,43,559
公投第１６案,苗栗縣,頭份市,自強里,355,1037,322,205,527,38,565
公投第１６案,苗栗縣,頭份市,信義里,356,947,262,178,440,24,464
公投第１６案,苗栗縣,頭份市,仁愛里,357,890,300,183,483,36,519
公投第１６案,苗栗縣,頭份市,仁愛里,358,646,210,159,369,39,408
公投第１６案,苗栗縣,頭份市,上興里,359,975,303,236,539,43,582
公投第１６案,苗栗縣,頭份市,上興里,360,1015,193,181,374,19,393
公投第１６案,苗栗縣,頭份市,下興里,361,1399,506,285,791,76,867
公投第１６案,苗栗縣,頭份市,下興里,362,1143,355,270,625,64,689
公投第１６案,苗栗縣,頭份市,和平里,363,1030,374,234,608,64,672
公投第１６案,苗栗縣,頭份市,山下里,364,1338,420,303,723,51,774
公投第１６案,苗栗縣,頭份市,山下里,365,1450,456,282,738,40,778
公投第１６案,苗栗縣,頭份市,山下里,366,1042,356,227,583,26,609
公投第１６案,苗栗縣,頭份市,後庄里,367,1326,457,300,757,39,796
公投第１６案,苗栗縣,頭份市,後庄里,368,1270,485,280,765,38,803
公投第１６案,苗栗縣,頭份市,後庄里,369,1288,386,280,666,49,715
公投第１６案,苗栗縣,頭份市,合興里,370,1243,447,229,676,43,719
公投第１６案,苗栗縣,頭份市,合興里,371,1280,444,275,719,37,756
公投第１６案,苗栗縣,頭份市,文化里,372,1618,477,360,837,76,913
公投第１６案,苗栗縣,頭份市,文化里,373,1759,523,356,879,63,942
公投第１６案,苗栗縣,頭份市,中興里,374,1264,443,247,690,62,752
公投第１６案,苗栗縣,頭份市,中興里,375,1326,432,285,717,48,765
公投第１６案,苗栗縣,頭份市,蟠桃里,376,1551,539,306,845,42,887
公投第１６案,苗栗縣,頭份市,蟠桃里,377,1574,458,309,767,47,814
公投第１６案,苗栗縣,頭份市,建國里,378,1262,337,292,629,72,701
公投第１６案,苗栗縣,頭份市,建國里,379,1171,408,232,640,46,686
公投第１６案,苗栗縣,頭份市,建國里,380,1074,387,253,640,55,695
公投第１６案,苗栗縣,頭份市,成功里,381,1141,381,259,640,49,689
公投第１６案,苗栗縣,頭份市,成功里,382,1259,377,306,683,48,731
公投第１６案,苗栗縣,頭份市,成功里,383,1186,358,235,593,62,655
公投第１６案,苗栗縣,頭份市,民族里,384,1121,335,202,537,46,583
公投第１６案,苗栗縣,頭份市,民族里,385,847,264,185,449,36,485
公投第１６案,苗栗縣,頭份市,民權里,386,993,345,218,563,36,599
公投第１６案,苗栗縣,頭份市,民權里,387,1055,309,223,532,40,572
公投第１６案,苗栗縣,頭份市,東庄里,388,1655,463,292,755,75,830
公投第１６案,苗栗縣,頭份市,東庄里,389,1799,561,321,882,107,989
公投第１６案,苗栗縣,頭份市,田寮里,390,1141,352,255,607,56,663
公投第１６案,苗栗縣,頭份市,田寮里,391,1431,441,283,724,59,783
公投第１６案,苗栗縣,頭份市,田寮里,392,1412,369,259,628,25,653
公投第１６案,苗栗縣,頭份市,民生里,393,1074,286,222,508,56,564
公投第１６案,苗栗縣,頭份市,民生里,394,1245,432,256,688,54,742
公投第１６案,苗栗縣,頭份市,蘆竹里,395,1344,438,290,728,74,802
公投第１６案,苗栗縣,頭份市,尖山里,396,1363,435,308,743,98,841
公投第１６案,苗栗縣,頭份市,廣興里,397,898,299,205,504,59,563
公投第１６案,苗栗縣,頭份市,尖下里,398,1182,376,243,619,93,712
公投第１６案,苗栗縣,頭份市,尖下里,399,1413,442,280,722,53,775
公投第１６案,苗栗縣,頭份市,濫坑里,400,991,328,232,560,57,617
公投第１６案,苗栗縣,頭份市,濫坑里,401,1180,376,255,631,65,696
公投第１６案,苗栗縣,三灣鄉,三灣村,402,996,346,215,561,35,596
公投第１６案,苗栗縣,三灣鄉,三灣村,403,1205,380,242,622,66,688
公投第１６案,苗栗縣,三灣鄉,內灣村,404,635,199,132,331,55,386
公投第１６案,苗栗縣,三灣鄉,銅鏡村,405,862,253,172,425,69,494
公投第１６案,苗栗縣,三灣鄉,頂寮村,406,238,55,50,105,13,118
公投第１６案,苗栗縣,三灣鄉,北埔村,407,541,131,125,256,36,292
公投第１６案,苗栗縣,三灣鄉,大河村,408,578,159,104,263,35,298
公投第１６案,苗栗縣,三灣鄉,大坪村,409,405,128,101,229,50,279
公投第１６案,苗栗縣,三灣鄉,永和村,410,392,117,83,200,22,222
公投第１６案,苗栗縣,南庄鄉,東村,411,1155,326,238,564,75,639
公投第１６案,苗栗縣,南庄鄉,西村,412,650,201,137,338,28,366
公投第１６案,苗栗縣,南庄鄉,南江村,413,1353,360,264,624,75,699
公投第１６案,苗栗縣,南庄鄉,田美村,414,813,189,124,313,44,357
公投第１６案,苗栗縣,南庄鄉,獅山村,415,837,193,131,324,39,363
公投第１６案,苗栗縣,南庄鄉,南富村,416,1093,341,186,527,47,574
公投第１６案,苗栗縣,南庄鄉,員林村,417,1048,281,232,513,60,573
公投第１６案,苗栗縣,南庄鄉,蓬萊村,418,872,233,178,411,36,447
公投第１６案,苗栗縣,南庄鄉,東河村,419,963,163,124,287,16,303
公投第１６案,苗栗縣,大湖鄉,大湖村,420,744,211,161,372,34,406
公投第１６案,苗栗縣,大湖鄉,大湖村,421,881,275,181,456,32,488
公投第１６案,苗栗縣,大湖鄉,明湖村,422,596,177,120,297,42,339
公投第１６案,苗栗縣,大湖鄉,大寮村,423,1260,349,237,586,66,652
公投第１６案,苗栗縣,大湖鄉,靜湖村,424,867,253,152,405,48,453
公投第１６案,苗栗縣,大湖鄉,靜湖村,425,923,296,192,488,23,511
公投第１６案,苗栗縣,大湖鄉,富興村,426,1395,352,275,627,110,737
公投第１６案,苗栗縣,大湖鄉,大南村,427,561,111,70,181,22,203
公投第１６案,苗栗縣,大湖鄉,南湖村,428,638,231,117,348,22,370
公投第１６案,苗栗縣,大湖鄉,東興村,429,754,210,143,353,46,399
公投第１６案,苗栗縣,大湖鄉,武榮村,430,501,133,100,233,18,251
公投第１６案,苗栗縣,大湖鄉,義和村,431,652,210,128,338,21,359
公投第１６案,苗栗縣,大湖鄉,義和村,432,843,213,169,382,31,413
公投第１６案,苗栗縣,大湖鄉,栗林村,433,1020,289,188,477,102,579
公投第１６案,苗栗縣,大湖鄉,新開村,434,1018,341,187,528,51,579
公投第１６案,苗栗縣,獅潭鄉,百壽村,435,328,77,40,117,12,129
公投第１６案,苗栗縣,獅潭鄉,永興村,436,565,128,81,209,39,248
公投第１６案,苗栗縣,獅潭鄉,新店村,437,911,285,179,464,59,523
公投第１６案,苗栗縣,獅潭鄉,和興村,438,568,159,84,243,25,268
公投第１６案,苗栗縣,獅潭鄉,豐林村,439,580,190,124,314,27,341
公投第１６案,苗栗縣,獅潭鄉,新豐村,440,333,103,58,161,9,170
公投第１６案,苗栗縣,獅潭鄉,竹木村,441,683,209,118,327,21,348
公投第１６案,苗栗縣,卓蘭鎮,老庄里,442,961,343,204,547,39,586
公投第１６案,苗栗縣,卓蘭鎮,老庄里,443,1017,286,214,500,73,573
公投第１６案,苗栗縣,卓蘭鎮,新榮里,444,1095,402,238,640,63,703
公投第１６案,苗栗縣,卓蘭鎮,中街里,445,745,262,148,410,41,451
公投第１６案,苗栗縣,卓蘭鎮,新厝里,446,783,245,132,377,54,431
公投第１６案,苗栗縣,卓蘭鎮,新厝里,447,745,235,105,340,19,359
公投第１６案,苗栗縣,卓蘭鎮,豐田里,448,999,276,182,458,40,498
公投第１６案,苗栗縣,卓蘭鎮,西坪里,449,671,220,150,370,48,418
公投第１６案,苗栗縣,卓蘭鎮,苗豐里,450,734,231,187,418,65,483
公投第１６案,苗栗縣,卓蘭鎮,上新里,451,865,290,195,485,52,537
公投第１６案,苗栗縣,卓蘭鎮,上新里,452,828,265,188,453,69,522
公投第１６案,苗栗縣,卓蘭鎮,上新里,453,386,125,82,207,37,244
公投第１６案,苗栗縣,卓蘭鎮,內灣里,454,688,246,152,398,46,444
公投第１６案,苗栗縣,卓蘭鎮,內灣里,455,792,276,171,447,47,494
公投第１６案,苗栗縣,卓蘭鎮,內灣里,456,729,243,142,385,45,430
公投第１６案,苗栗縣,卓蘭鎮,坪林里,457,1093,279,199,478,39,517
公投第１６案,苗栗縣,卓蘭鎮,坪林里,458,615,209,119,328,17,345
公投第１６案,苗栗縣,卓蘭鎮,西坪里,459,86,28,16,44,1,45
公投第１６案,苗栗縣,卓蘭鎮,景山里,460,940,315,180,495,21,516
公投第１６案,苗栗縣,泰安鄉,八卦村,461,325,70,62,132,16,148
公投第１６案,苗栗縣,泰安鄉,錦水村,462,484,154,96,250,34,284
公投第１６案,苗栗縣,泰安鄉,錦水村,463,666,252,186,438,48,486
公投第１６案,苗栗縣,泰安鄉,清安村,464,574,207,128,335,54,389
公投第１６案,苗栗縣,泰安鄉,清安村,465,333,102,57,159,12,171
公投第１６案,苗栗縣,泰安鄉,大興村,466,495,192,129,321,15,336
公投第１６案,苗栗縣,泰安鄉,中興村,467,544,202,148,350,40,390
公投第１６案,苗栗縣,泰安鄉,梅園村,468,500,123,92,215,25,240
公投第１６案,苗栗縣,泰安鄉,象鼻村,469,670,257,172,429,50,479
公投第１６案,苗栗縣,泰安鄉,士林村,470,589,188,249,437,6,443
公投第１６案,彰化縣,彰化市,桃源里,1,871,293,190,483,47,530
公投第１６案,彰化縣,彰化市,桃源里,2,751,187,133,320,43,363
公投第１６案,彰化縣,彰化市,桃源里,3,923,334,225,559,51,610
公投第１６案,彰化縣,彰化市,東興里,4,779,258,173,431,53,484
公投第１６案,彰化縣,彰化市,東興里,5,779,240,194,434,45,479
公投第１６案,彰化縣,彰化市,華北里,6,720,221,174,395,31,426
公投第１６案,彰化縣,彰化市,華北里,7,749,248,156,404,43,447
公投第１６案,彰化縣,彰化市,華陽里,8,767,282,170,452,51,503
公投第１６案,彰化縣,彰化市,華陽里,9,1047,338,247,585,67,652
公投第１６案,彰化縣,彰化市,大同里,10,1027,300,234,534,53,587
公投第１６案,彰化縣,彰化市,永生里,11,1249,363,280,643,74,717
公投第１６案,彰化縣,彰化市,建寶里,12,1136,357,260,617,58,675
公投第１６案,彰化縣,彰化市,建寶里,13,1169,384,256,640,85,725
公投第１６案,彰化縣,彰化市,光南里,14,766,263,190,453,31,484
公投第１６案,彰化縣,彰化市,光南里,15,643,224,129,353,24,377
公投第１６案,彰化縣,彰化市,介壽里,16,1251,432,241,673,72,745
公投第１６案,彰化縣,彰化市,介壽里,17,1301,265,204,469,40,509
公投第１６案,彰化縣,彰化市,延平里,18,1280,464,255,719,50,769
公投第１６案,彰化縣,彰化市,延平里,19,1179,398,269,667,60,727
公投第１６案,彰化縣,彰化市,延平里,20,1168,405,241,646,43,689
公投第１６案,彰化縣,彰化市,延平里,21,1218,399,264,663,51,714
公投第１６案,彰化縣,彰化市,延平里,22,1351,494,328,822,65,887
公投第１６案,彰化縣,彰化市,延平里,23,1204,408,287,695,42,737
公投第１６案,彰化縣,彰化市,延平里,24,1189,418,264,682,27,709
公投第１６案,彰化縣,彰化市,延和里,25,1207,376,254,630,68,698
公投第１６案,彰化縣,彰化市,延和里,26,1161,379,256,635,61,696
公投第１６案,彰化縣,彰化市,延和里,27,1166,312,300,612,45,657
公投第１６案,彰化縣,彰化市,延和里,28,1362,485,301,786,60,846
公投第１６案,彰化縣,彰化市,南興里,29,1236,403,323,726,45,771
公投第１６案,彰化縣,彰化市,南興里,30,1065,337,254,591,54,645
公投第１６案,彰化縣,彰化市,南興里,31,1199,392,272,664,62,726
公投第１６案,彰化縣,彰化市,南興里,32,1233,408,293,701,39,740
公投第１６案,彰化縣,彰化市,南興里,33,1245,411,276,687,34,721
公投第１６案,彰化縣,彰化市,南興里,34,1153,380,291,671,50,721
公投第１６案,彰化縣,彰化市,南瑤里,35,1045,312,234,546,47,593
公投第１６案,彰化縣,彰化市,南瑤里,36,1097,351,261,612,23,635
公投第１６案,彰化縣,彰化市,南瑤里,37,1190,391,252,643,49,692
公投第１６案,彰化縣,彰化市,南瑤里,38,1106,392,258,650,44,694
公投第１６案,彰化縣,彰化市,南瑤里,39,1097,371,244,615,47,662
公投第１６案,彰化縣,彰化市,南瑤里,40,1048,342,238,580,63,643
公投第１６案,彰化縣,彰化市,南瑤里,41,980,342,228,570,47,617
公投第１６案,彰化縣,彰化市,成功里,42,707,245,172,417,29,446
公投第１６案,彰化縣,彰化市,成功里,43,809,247,191,438,56,494
公投第１６案,彰化縣,彰化市,福安里,44,1008,312,266,578,58,636
公投第１６案,彰化縣,彰化市,西安里,45,901,267,180,447,66,513
公投第１６案,彰化縣,彰化市,西安里,46,951,302,200,502,48,550
公投第１６案,彰化縣,彰化市,西安里,47,1076,357,249,606,43,649
公投第１６案,彰化縣,彰化市,彰安里,48,1022,200,314,514,46,560
公投第１６案,彰化縣,彰化市,彰安里,49,894,293,193,486,54,540
公投第１６案,彰化縣,彰化市,彰安里,50,1016,328,238,566,52,618
公投第１６案,彰化縣,彰化市,中央里,51,771,245,173,418,83,501
公投第１６案,彰化縣,彰化市,富貴里,52,868,256,220,476,55,531
公投第１６案,彰化縣,彰化市,民權里,53,1135,330,265,595,92,687
公投第１６案,彰化縣,彰化市,萬壽里,54,910,268,223,491,74,565
公投第１６案,彰化縣,彰化市,長樂里,55,1004,287,279,566,49,615
公投第１６案,彰化縣,彰化市,西興里,56,1077,354,267,621,53,674
公投第１６案,彰化縣,彰化市,西興里,57,1258,465,296,761,67,828
公投第１６案,彰化縣,彰化市,西興里,58,1025,346,249,595,57,652
公投第１６案,彰化縣,彰化市,西勢里,59,1177,399,271,670,71,741
公投第１６案,彰化縣,彰化市,西勢里,60,1262,411,235,646,74,720
公投第１６案,彰化縣,彰化市,西勢里,61,1209,417,243,660,96,756
公投第１６案,彰化縣,彰化市,忠權里,62,1041,364,236,600,57,657
公投第１６案,彰化縣,彰化市,忠權里,63,1075,354,261,615,57,672
公投第１６案,彰化縣,彰化市,忠權里,64,1029,325,211,536,56,592
公投第１６案,彰化縣,彰化市,忠孝里,65,1203,344,279,623,77,700
公投第１６案,彰化縣,彰化市,五權里,66,1014,289,236,525,63,588
公投第１６案,彰化縣,彰化市,五權里,67,1069,360,238,598,49,647
公投第１６案,彰化縣,彰化市,五權里,68,969,262,197,459,36,495
公投第１６案,彰化縣,彰化市,五權里,69,1105,322,219,541,51,592
公投第１６案,彰化縣,彰化市,平和里,70,981,344,234,578,51,629
公投第１６案,彰化縣,彰化市,平和里,71,1095,340,273,613,78,691
公投第１６案,彰化縣,彰化市,平和里,72,1087,356,275,631,42,673
公投第１６案,彰化縣,彰化市,平和里,73,1050,374,214,588,51,639
公投第１６案,彰化縣,彰化市,崙平里,74,1252,430,279,709,63,772
公投第１６案,彰化縣,彰化市,崙平里,75,1113,329,241,570,50,620
公投第１６案,彰化縣,彰化市,崙平里,76,1009,341,248,589,42,631
公投第１６案,彰化縣,彰化市,崙平里,77,999,318,210,528,48,576
公投第１６案,彰化縣,彰化市,崙平里,78,997,306,250,556,31,587
公投第１６案,彰化縣,彰化市,向陽里,79,1145,431,264,695,48,743
公投第１６案,彰化縣,彰化市,向陽里,80,1227,398,289,687,33,720
公投第１６案,彰化縣,彰化市,向陽里,81,1208,393,307,700,54,754
公投第１６案,彰化縣,彰化市,向陽里,82,1598,502,370,872,58,930
公投第１６案,彰化縣,彰化市,莿桐里,83,890,303,198,501,48,549
公投第１６案,彰化縣,彰化市,莿桐里,84,1104,405,254,659,43,702
公投第１６案,彰化縣,彰化市,莿桐里,85,1097,363,234,597,35,632
公投第１６案,彰化縣,彰化市,南美里,86,799,260,157,417,54,471
公投第１６案,彰化縣,彰化市,南美里,87,1000,333,215,548,72,620
公投第１６案,彰化縣,彰化市,南安里,88,1153,336,237,573,96,669
公投第１６案,彰化縣,彰化市,南安里,89,977,284,246,530,76,606
公投第１６案,彰化縣,彰化市,東芳里,90,1201,343,280,623,74,697
公投第１６案,彰化縣,彰化市,東芳里,91,1057,317,275,592,70,662
公投第１６案,彰化縣,彰化市,東芳里,92,1238,368,278,646,84,730
公投第１６案,彰化縣,彰化市,磚磘里,93,1210,395,297,692,55,747
公投第１６案,彰化縣,彰化市,磚磘里,94,1026,325,248,573,62,635
公投第１６案,彰化縣,彰化市,磚磘里,95,1061,427,214,641,57,698
公投第１６案,彰化縣,彰化市,卦山里,96,1213,387,266,653,72,725
公投第１６案,彰化縣,彰化市,卦山里,97,1264,411,309,720,53,773
公投第１６案,彰化縣,彰化市,光復里,98,691,208,206,414,53,467
公投第１６案,彰化縣,彰化市,永福里,99,893,302,215,517,61,578
公投第１６案,彰化縣,彰化市,光華里,100,733,220,186,406,50,456
公投第１６案,彰化縣,彰化市,中正里,101,692,213,192,405,43,448
公投第１６案,彰化縣,彰化市,中正里,102,728,214,172,386,48,434
公投第１６案,彰化縣,彰化市,中山里,103,773,272,199,471,30,501
公投第１６案,彰化縣,彰化市,龍山里,104,975,280,186,466,29,495
公投第１６案,彰化縣,彰化市,龍山里,105,908,302,215,517,43,560
公投第１６案,彰化縣,彰化市,新興里,106,1156,354,292,646,13,659
公投第１６案,彰化縣,彰化市,新興里,107,1235,392,306,698,58,756
公投第１６案,彰化縣,彰化市,新興里,108,1376,426,296,722,54,776
公投第１６案,彰化縣,彰化市,新興里,109,1389,420,323,743,46,789
公投第１６案,彰化縣,彰化市,新華里,110,846,272,230,502,58,560
公投第１６案,彰化縣,彰化市,新華里,111,859,300,209,509,46,555
公投第１６案,彰化縣,彰化市,興北里,112,781,278,180,458,26,484
公投第１６案,彰化縣,彰化市,興北里,113,875,293,189,482,38,520
公投第１６案,彰化縣,彰化市,信義里,114,816,260,176,436,50,486
公投第１６案,彰化縣,彰化市,民生里,115,687,207,186,393,41,434
公投第１６案,彰化縣,彰化市,民生里,116,727,247,167,414,57,471
公投第１６案,彰化縣,彰化市,文化里,117,662,217,182,399,30,429
公投第１６案,彰化縣,彰化市,文化里,118,633,239,141,380,27,407
公投第１６案,彰化縣,彰化市,陽明里,119,906,311,231,542,46,588
公投第１６案,彰化縣,彰化市,陽明里,120,853,267,165,432,58,490
公投第１６案,彰化縣,彰化市,萬安里,121,1027,347,241,588,58,646
公投第１６案,彰化縣,彰化市,萬安里,122,993,325,256,581,53,634
公投第１６案,彰化縣,彰化市,萬安里,123,848,242,220,462,58,520
公投第１６案,彰化縣,彰化市,萬安里,124,1118,372,289,661,45,706
公投第１６案,彰化縣,彰化市,下廍里,125,1263,426,282,708,59,767
公投第１６案,彰化縣,彰化市,下廍里,126,1268,432,298,730,70,800
公投第１６案,彰化縣,彰化市,下廍里,127,1258,439,275,714,59,773
公投第１６案,彰化縣,彰化市,下廍里,128,1212,418,282,700,43,743
公投第１６案,彰化縣,彰化市,茄苳里,129,924,305,187,492,81,573
公投第１６案,彰化縣,彰化市,茄南里,130,939,338,227,565,33,598
公投第１６案,彰化縣,彰化市,茄南里,131,953,323,257,580,63,643
公投第１６案,彰化縣,彰化市,茄南里,132,981,367,234,601,48,649
公投第１６案,彰化縣,彰化市,寶廍里,133,1249,415,292,707,84,791
公投第１６案,彰化縣,彰化市,古夷里,134,817,261,193,454,62,516
公投第１６案,彰化縣,彰化市,古夷里,135,872,302,187,489,41,530
公投第１６案,彰化縣,彰化市,古夷里,136,689,226,147,373,31,404
公投第１６案,彰化縣,彰化市,阿夷里,137,1156,439,252,691,40,731
公投第１６案,彰化縣,彰化市,阿夷里,138,1291,435,263,698,42,740
公投第１６案,彰化縣,彰化市,阿夷里,139,1139,374,250,624,39,663
公投第１６案,彰化縣,彰化市,阿夷里,140,1125,365,271,636,62,698
公投第１６案,彰化縣,彰化市,阿夷里,141,1258,405,275,680,41,721
公投第１６案,彰化縣,彰化市,阿夷里,142,1123,379,238,617,49,666
公投第１６案,彰化縣,彰化市,阿夷里,143,1175,367,263,630,70,700
公投第１６案,彰化縣,彰化市,和調里,144,862,286,245,531,40,571
公投第１６案,彰化縣,彰化市,和調里,145,872,282,211,493,36,529
公投第１６案,彰化縣,彰化市,和調里,146,897,311,240,551,26,577
公投第１６案,彰化縣,彰化市,復興里,147,1003,297,228,525,33,558
公投第１６案,彰化縣,彰化市,復興里,148,915,278,213,491,25,516
公投第１６案,彰化縣,彰化市,復興里,149,1158,369,242,611,57,668
公投第１６案,彰化縣,彰化市,復興里,150,1084,355,283,638,46,684
公投第１６案,彰化縣,彰化市,中庄里,151,1372,408,305,713,70,783
公投第１６案,彰化縣,彰化市,中庄里,152,1113,359,272,631,54,685
公投第１６案,彰化縣,彰化市,竹中里,153,800,280,185,465,43,508
公投第１６案,彰化縣,彰化市,竹中里,154,885,255,228,483,56,539
公投第１６案,彰化縣,彰化市,香山里,155,1000,353,230,583,32,615
公投第１６案,彰化縣,彰化市,香山里,156,1159,336,248,584,47,631
公投第１６案,彰化縣,彰化市,香山里,157,1123,353,247,600,44,644
公投第１６案,彰化縣,彰化市,牛埔里,158,907,328,195,523,78,601
公投第１６案,彰化縣,彰化市,牛埔里,159,989,316,164,480,83,563
公投第１６案,彰化縣,彰化市,牛埔里,160,1012,326,244,570,66,636
公投第１６案,彰化縣,彰化市,台鳳里,161,1033,283,213,496,48,544
公投第１６案,彰化縣,彰化市,台鳳里,162,1116,427,200,627,54,681
公投第１６案,彰化縣,彰化市,台鳳里,163,1154,408,274,682,31,713
公投第１６案,彰化縣,彰化市,台鳳里,164,1064,357,227,584,49,633
公投第１６案,彰化縣,彰化市,國聖里,165,770,252,189,441,60,501
公投第１６案,彰化縣,彰化市,國聖里,166,889,287,223,510,47,557
公投第１６案,彰化縣,彰化市,國聖里,167,786,257,181,438,62,500
公投第１６案,彰化縣,彰化市,福山里,168,1120,317,237,554,61,615
公投第１６案,彰化縣,彰化市,福山里,169,1269,337,323,660,28,688
公投第１６案,彰化縣,彰化市,福山里,170,1159,384,261,645,63,708
公投第１６案,彰化縣,彰化市,福山里,171,1184,352,305,657,69,726
公投第１６案,彰化縣,彰化市,福山里,172,1089,332,253,585,51,636
公投第１６案,彰化縣,彰化市,福山里,173,968,323,251,574,59,633
公投第１６案,彰化縣,彰化市,安溪里,174,930,316,198,514,32,546
公投第１６案,彰化縣,彰化市,安溪里,175,973,336,216,552,45,597
公投第１６案,彰化縣,彰化市,三村里,176,1184,355,213,568,45,613
公投第１６案,彰化縣,彰化市,大竹里,177,1002,313,222,535,77,612
公投第１６案,彰化縣,彰化市,大竹里,178,1148,393,224,617,27,644
公投第１６案,彰化縣,彰化市,大竹里,179,1112,382,210,592,54,646
公投第１６案,彰化縣,彰化市,田中里,180,907,348,215,563,59,622
公投第１６案,彰化縣,彰化市,快官里,181,1112,380,230,610,69,679
公投第１６案,彰化縣,彰化市,竹巷里,182,823,228,149,377,45,422
公投第１６案,彰化縣,彰化市,福田里,183,1276,393,276,669,90,759
公投第１６案,彰化縣,彰化市,石牌里,184,1161,337,263,600,60,660
公投第１６案,彰化縣,花壇鄉,花壇村,185,901,268,204,472,68,540
公投第１６案,彰化縣,花壇鄉,花壇村,186,1042,352,230,582,50,632
公投第１６案,彰化縣,花壇鄉,花壇村,187,1314,360,300,660,29,689
公投第１６案,彰化縣,花壇鄉,金墩村,188,808,229,206,435,55,490
公投第１６案,彰化縣,花壇鄉,金墩村,189,1019,312,222,534,53,587
公投第１６案,彰化縣,花壇鄉,中庄村,190,1144,344,256,600,103,703
公投第１６案,彰化縣,花壇鄉,中庄村,191,1240,351,234,585,139,724
公投第１６案,彰化縣,花壇鄉,崙雅村,192,1425,448,335,783,93,876
公投第１６案,彰化縣,花壇鄉,劉厝村,193,1095,360,255,615,78,693
公投第１６案,彰化縣,花壇鄉,南口村,194,910,290,200,490,56,546
公投第１６案,彰化縣,花壇鄉,南口村,195,982,295,225,520,54,574
公投第１６案,彰化縣,花壇鄉,北口村,196,1070,311,234,545,19,564
公投第１６案,彰化縣,花壇鄉,北口村,197,700,209,142,351,24,375
公投第１６案,彰化縣,花壇鄉,中口村,198,764,243,202,445,58,503
公投第１６案,彰化縣,花壇鄉,文德村,199,953,331,212,543,60,603
公投第１６案,彰化縣,花壇鄉,文德村,200,974,290,226,516,40,556
公投第１６案,彰化縣,花壇鄉,文德村,201,1111,337,243,580,68,648
公投第１６案,彰化縣,花壇鄉,白沙村,202,1101,374,209,583,89,672
公投第１６案,彰化縣,花壇鄉,白沙村,203,1110,345,206,551,62,613
公投第１６案,彰化縣,花壇鄉,白沙村,204,1262,385,281,666,67,733
公投第１６案,彰化縣,花壇鄉,白沙村,205,1103,334,274,608,41,649
公投第１６案,彰化縣,花壇鄉,岩竹村,206,1347,348,275,623,71,694
公投第１６案,彰化縣,花壇鄉,長沙村,207,1169,333,246,579,60,639
公投第１６案,彰化縣,花壇鄉,長沙村,208,1274,466,236,702,62,764
公投第１６案,彰化縣,花壇鄉,長沙村,209,1280,474,273,747,54,801
公投第１６案,彰化縣,花壇鄉,長沙村,210,1244,394,276,670,52,722
公投第１６案,彰化縣,花壇鄉,橋頭村,211,1159,335,279,614,68,682
公投第１６案,彰化縣,花壇鄉,橋頭村,212,1042,362,243,605,46,651
公投第１６案,彰化縣,花壇鄉,橋頭村,213,1111,301,241,542,66,608
公投第１６案,彰化縣,花壇鄉,灣雅村,214,893,306,204,510,58,568
公投第１６案,彰化縣,花壇鄉,灣東村,215,953,284,214,498,65,563
公投第１６案,彰化縣,花壇鄉,三春村,216,987,283,183,466,41,507
公投第１６案,彰化縣,花壇鄉,三春村,217,925,314,228,542,58,600
公投第１６案,彰化縣,花壇鄉,永春村,218,951,293,184,477,52,529
公投第１６案,彰化縣,花壇鄉,永春村,219,955,319,188,507,38,545
公投第１６案,彰化縣,花壇鄉,長春村,220,895,280,186,466,21,487
公投第１６案,彰化縣,花壇鄉,長春村,221,711,226,151,377,34,411
公投第１６案,彰化縣,芬園鄉,舊社村,222,958,308,175,483,56,539
公投第１６案,彰化縣,芬園鄉,舊社村,223,794,245,155,400,56,456
公投第１６案,彰化縣,芬園鄉,大埔村,224,1415,389,273,662,88,750
公投第１６案,彰化縣,芬園鄉,竹林村,225,927,306,224,530,38,568
公投第１６案,彰化縣,芬園鄉,竹林村,226,831,266,156,422,52,474
公投第１６案,彰化縣,芬園鄉,楓坑村,227,570,188,113,301,23,324
公投第１６案,彰化縣,芬園鄉,社口村,228,1227,351,225,576,63,639
公投第１６案,彰化縣,芬園鄉,社口村,229,1238,381,221,602,81,683
公投第１６案,彰化縣,芬園鄉,茄荖村,230,1362,414,290,704,82,786
公投第１６案,彰化縣,芬園鄉,茄荖村,231,989,292,208,500,84,584
公投第１６案,彰化縣,芬園鄉,嘉興村,232,1054,364,245,609,57,666
公投第１６案,彰化縣,芬園鄉,嘉興村,233,607,232,133,365,33,398
公投第１６案,彰化縣,芬園鄉,芬園村,234,882,308,179,487,49,536
公投第１６案,彰化縣,芬園鄉,縣庄村,235,1143,329,180,509,53,562
公投第１６案,彰化縣,芬園鄉,圳墘村,236,661,178,95,273,27,300
公投第１６案,彰化縣,芬園鄉,溪頭村,237,838,241,158,399,6,405
公投第１６案,彰化縣,芬園鄉,溪頭村,238,847,241,176,417,30,447
公投第１６案,彰化縣,芬園鄉,進芬村,239,987,304,223,527,65,592
公投第１６案,彰化縣,芬園鄉,同安村,240,1217,336,226,562,74,636
公投第１６案,彰化縣,芬園鄉,中崙村,241,865,219,167,386,78,464
公投第１６案,彰化縣,芬園鄉,大竹村,242,996,261,202,463,52,515
公投第１６案,彰化縣,鹿港鎮,大有里,243,1140,304,287,591,77,668
公投第１６案,彰化縣,鹿港鎮,中興里,244,511,158,107,265,39,304
公投第１６案,彰化縣,鹿港鎮,洛津里,245,857,227,155,382,22,404
公投第１６案,彰化縣,鹿港鎮,順興里,246,946,300,238,538,73,611
公投第１６案,彰化縣,鹿港鎮,埔崙里,247,945,288,227,515,49,564
公投第１６案,彰化縣,鹿港鎮,埔崙里,248,1097,355,237,592,64,656
公投第１６案,彰化縣,鹿港鎮,埔崙里,249,1479,415,280,695,44,739
公投第１６案,彰化縣,鹿港鎮,埔崙里,250,1425,432,338,770,85,855
公投第１６案,彰化縣,鹿港鎮,新宮里,251,880,287,200,487,71,558
公投第１６案,彰化縣,鹿港鎮,玉順里,252,1183,350,227,577,83,660
公投第１６案,彰化縣,鹿港鎮,東石里,253,1047,316,240,556,76,632
公投第１６案,彰化縣,鹿港鎮,東石里,254,1097,321,233,554,32,586
公投第１６案,彰化縣,鹿港鎮,東石里,255,1030,325,204,529,64,593
公投第１６案,彰化縣,鹿港鎮,東石里,256,1161,389,234,623,48,671
公投第１６案,彰化縣,鹿港鎮,郭厝里,257,540,148,129,277,63,340
公投第１６案,彰化縣,鹿港鎮,永安里,258,1135,332,247,579,65,644
公投第１６案,彰化縣,鹿港鎮,永安里,259,1155,351,242,593,79,672
公投第１６案,彰化縣,鹿港鎮,永安里,260,1127,391,251,642,56,698
公投第１６案,彰化縣,鹿港鎮,永安里,261,1045,336,229,565,58,623
公投第１６案,彰化縣,鹿港鎮,景福里,262,1127,334,253,587,80,667
公投第１６案,彰化縣,鹿港鎮,泰興里,263,1178,400,286,686,67,753
公投第１６案,彰化縣,鹿港鎮,長興里,264,284,83,71,154,15,169
公投第１６案,彰化縣,鹿港鎮,興化里,265,584,170,134,304,41,345
公投第１６案,彰化縣,鹿港鎮,龍山里,266,659,226,158,384,50,434
公投第１６案,彰化縣,鹿港鎮,菜園里,267,915,273,194,467,30,497
公投第１６案,彰化縣,鹿港鎮,街尾里,268,1079,316,282,598,79,677
公投第１６案,彰化縣,鹿港鎮,街尾里,269,1129,422,230,652,78,730
公投第１６案,彰化縣,鹿港鎮,詔安里,270,1273,396,237,633,72,705
公投第１６案,彰化縣,鹿港鎮,詔安里,271,706,203,121,324,53,377
公投第１６案,彰化縣,鹿港鎮,海埔里,272,1137,342,174,516,114,630
公投第１６案,彰化縣,鹿港鎮,海埔里,273,1195,320,274,594,67,661
公投第１６案,彰化縣,鹿港鎮,海埔里,274,1225,352,230,582,80,662
公投第１６案,彰化縣,鹿港鎮,洋厝里,275,957,345,217,562,68,630
公投第１６案,彰化縣,鹿港鎮,洋厝里,276,758,210,124,334,70,404
公投第１６案,彰化縣,鹿港鎮,洋厝里,277,723,213,158,371,60,431
公投第１６案,彰化縣,鹿港鎮,草中里,278,984,297,195,492,48,540
公投第１６案,彰化縣,鹿港鎮,草中里,279,1018,357,223,580,66,646
公投第１６案,彰化縣,鹿港鎮,草中里,280,1165,371,210,581,64,645
公投第１６案,彰化縣,鹿港鎮,頭南里,281,1161,228,259,487,64,551
公投第１６案,彰化縣,鹿港鎮,頭南里,282,1020,305,186,491,66,557
公投第１６案,彰化縣,鹿港鎮,山崙里,283,1068,325,229,554,72,626
公投第１６案,彰化縣,鹿港鎮,山崙里,284,1024,335,211,546,62,608
公投第１６案,彰化縣,鹿港鎮,山崙里,285,974,295,215,510,88,598
公投第１６案,彰化縣,鹿港鎮,頂番里,286,1505,430,295,725,94,819
公投第１６案,彰化縣,鹿港鎮,頂番里,287,1092,291,248,539,65,604
公投第１６案,彰化縣,鹿港鎮,頂番里,288,1223,396,267,663,79,742
公投第１６案,彰化縣,鹿港鎮,頭崙里,289,1572,438,252,690,51,741
公投第１６案,彰化縣,鹿港鎮,頭崙里,290,1003,358,196,554,64,618
公投第１６案,彰化縣,鹿港鎮,溝墘里,291,933,304,204,508,48,556
公投第１６案,彰化縣,鹿港鎮,溝墘里,292,1093,347,249,596,67,663
公投第１６案,彰化縣,鹿港鎮,溝墘里,293,907,284,192,476,34,510
公投第１６案,彰化縣,鹿港鎮,溝墘里,294,1219,333,274,607,67,674
公投第１６案,彰化縣,鹿港鎮,廖厝里,295,1397,469,320,789,99,888
公投第１６案,彰化縣,鹿港鎮,廖厝里,296,1229,396,263,659,49,708
公投第１６案,彰化縣,鹿港鎮,廖厝里,297,1444,443,296,739,52,791
公投第１６案,彰化縣,鹿港鎮,東崎里,298,1227,398,256,654,77,731
公投第１６案,彰化縣,鹿港鎮,東崎里,299,1187,365,274,639,74,713
公投第１６案,彰化縣,鹿港鎮,東崎里,300,1296,390,256,646,47,693
公投第１６案,彰化縣,鹿港鎮,東崎里,301,1451,390,294,684,69,753
公投第１６案,彰化縣,鹿港鎮,頂厝里,302,1299,368,299,667,69,736
公投第１６案,彰化縣,鹿港鎮,頂厝里,303,1298,462,275,737,65,802
公投第１６案,彰化縣,鹿港鎮,頂厝里,304,1458,468,290,758,82,840
公投第１６案,彰化縣,鹿港鎮,頂厝里,305,1138,343,271,614,57,671
公投第１６案,彰化縣,鹿港鎮,頂厝里,306,1170,362,255,617,67,684
公投第１６案,彰化縣,鹿港鎮,頂厝里,307,1221,399,278,677,65,742
公投第１６案,彰化縣,福興鄉,三汴村,308,1363,358,289,647,89,736
公投第１６案,彰化縣,福興鄉,萬豐村,309,821,250,190,440,29,469
公投第１６案,彰化縣,福興鄉,元中村,310,1256,363,221,584,73,657
公投第１６案,彰化縣,福興鄉,外中村,311,1166,308,227,535,105,640
公投第１６案,彰化縣,福興鄉,外埔村,312,1464,414,284,698,69,767
公投第１６案,彰化縣,福興鄉,大崙村,313,1251,356,247,603,59,662
公投第１６案,彰化縣,福興鄉,番婆村,314,1465,423,290,713,62,775
公投第１６案,彰化縣,福興鄉,番婆村,315,960,247,170,417,55,472
公投第１６案,彰化縣,福興鄉,橋頭村,316,1323,386,245,631,82,713
公投第１６案,彰化縣,福興鄉,橋頭村,317,1365,389,297,686,70,756
公投第１６案,彰化縣,福興鄉,社尾村,318,1458,336,262,598,56,654
公投第１６案,彰化縣,福興鄉,番社村,319,1492,419,272,691,95,786
公投第１６案,彰化縣,福興鄉,西勢村,320,888,257,141,398,30,428
公投第１６案,彰化縣,福興鄉,西勢村,321,1054,335,228,563,66,629
公投第１６案,彰化縣,福興鄉,同安村,322,1043,263,207,470,51,521
公投第１６案,彰化縣,福興鄉,同安村,323,1340,378,280,658,81,739
公投第１６案,彰化縣,福興鄉,秀厝村,324,1085,296,201,497,57,554
公投第１６案,彰化縣,福興鄉,秀厝村,325,1392,359,293,652,53,705
公投第１６案,彰化縣,福興鄉,福興村,326,1316,398,280,678,95,773
公投第１６案,彰化縣,福興鄉,福興村,327,1255,486,201,687,70,757
公投第１６案,彰化縣,福興鄉,福興村,328,1101,388,231,619,56,675
公投第１６案,彰化縣,福興鄉,福南村,329,1167,365,199,564,90,654
公投第１６案,彰化縣,福興鄉,福南村,330,1393,366,259,625,105,730
公投第１６案,彰化縣,福興鄉,鎮平村,331,1216,364,247,611,83,694
公投第１６案,彰化縣,福興鄉,三和村,332,1063,294,190,484,50,534
公投第１６案,彰化縣,福興鄉,二港村,333,1306,357,260,617,86,703
公投第１６案,彰化縣,福興鄉,福寶村,334,1287,324,207,531,69,600
公投第１６案,彰化縣,福興鄉,頂粘村,335,994,305,192,497,62,559
公投第１６案,彰化縣,福興鄉,頂粘村,336,1311,384,249,633,107,740
公投第１６案,彰化縣,福興鄉,廈粘村,337,926,330,184,514,39,553
公投第１６案,彰化縣,福興鄉,廈粘村,338,995,270,189,459,54,513
公投第１６案,彰化縣,福興鄉,麥厝村,339,1079,345,213,558,113,671
公投第１６案,彰化縣,福興鄉,麥厝村,340,1150,288,214,502,103,605
公投第１６案,彰化縣,秀水鄉,秀水村,341,1066,328,213,541,128,669
公投第１６案,彰化縣,秀水鄉,秀水村,342,620,200,145,345,52,397
公投第１６案,彰化縣,秀水鄉,安溪村,343,876,210,209,419,22,441
公投第１６案,彰化縣,秀水鄉,安溪村,344,1196,395,292,687,51,738
公投第１６案,彰化縣,秀水鄉,莊雅村,345,1369,412,323,735,54,789
公投第１６案,彰化縣,秀水鄉,莊雅村,346,1273,411,273,684,72,756
公投第１６案,彰化縣,秀水鄉,陝西村,347,1433,424,301,725,82,807
公投第１６案,彰化縣,秀水鄉,金興村,348,967,307,230,537,35,572
公投第１６案,彰化縣,秀水鄉,金興村,349,921,311,212,523,24,547
公投第１６案,彰化縣,秀水鄉,安東村,350,689,241,148,389,44,433
公投第１６案,彰化縣,秀水鄉,安東村,351,688,229,144,373,48,421
公投第１６案,彰化縣,秀水鄉,安東村,352,1252,419,291,710,72,782
公投第１６案,彰化縣,秀水鄉,安東村,353,1281,382,256,638,55,693
公投第１６案,彰化縣,秀水鄉,鶴鳴村,354,754,223,162,385,31,416
公投第１６案,彰化縣,秀水鄉,鶴鳴村,355,1024,315,221,536,51,587
公投第１６案,彰化縣,秀水鄉,鶴鳴村,356,1433,435,294,729,46,775
公投第１６案,彰化縣,秀水鄉,馬興村,357,1366,467,331,798,75,873
公投第１６案,彰化縣,秀水鄉,馬興村,358,895,274,215,489,57,546
公投第１６案,彰化縣,秀水鄉,義興村,359,1386,390,281,671,82,753
公投第１６案,彰化縣,秀水鄉,福安村,360,896,271,191,462,82,544
公投第１６案,彰化縣,秀水鄉,福安村,361,804,285,188,473,55,528
公投第１６案,彰化縣,秀水鄉,福安村,362,827,285,188,473,45,518
公投第１６案,彰化縣,秀水鄉,福安村,363,996,330,206,536,57,593
公投第１６案,彰化縣,秀水鄉,福安村,364,931,326,229,555,62,617
公投第１６案,彰化縣,秀水鄉,埔崙村,365,715,209,156,365,41,406
公投第１６案,彰化縣,秀水鄉,埔崙村,366,1229,423,279,702,69,771
公投第１６案,彰化縣,秀水鄉,曾厝村,367,890,223,206,429,35,464
公投第１６案,彰化縣,秀水鄉,曾厝村,368,811,265,196,461,50,511
公投第１６案,彰化縣,秀水鄉,金陵村,369,786,249,183,432,55,487
公投第１６案,彰化縣,秀水鄉,金陵村,370,931,288,197,485,57,542
公投第１６案,彰化縣,秀水鄉,下崙村,371,1265,418,264,682,86,768
公投第１６案,彰化縣,秀水鄉,下崙村,372,824,241,173,414,48,462
公投第１６案,彰化縣,和美鎮,竹營里,373,1341,391,270,661,78,739
公投第１６案,彰化縣,和美鎮,竹營里,374,1480,418,286,704,65,769
公投第１６案,彰化縣,和美鎮,竹營里,375,1529,476,330,806,51,857
公投第１６案,彰化縣,和美鎮,竹營里,376,1711,477,336,813,36,849
公投第１６案,彰化縣,和美鎮,和東里,377,1057,326,247,573,42,615
公投第１６案,彰化縣,和美鎮,和東里,378,1032,345,219,564,50,614
公投第１６案,彰化縣,和美鎮,和東里,379,1015,302,251,553,58,611
公投第１６案,彰化縣,和美鎮,和東里,380,1209,414,257,671,63,734
公投第１６案,彰化縣,和美鎮,和南里,381,430,130,102,232,19,251
公投第１６案,彰化縣,和美鎮,和北里,382,856,249,195,444,23,467
公投第１６案,彰化縣,和美鎮,和北里,383,966,341,203,544,37,581
公投第１６案,彰化縣,和美鎮,和西里,384,1059,325,223,548,34,582
公投第１６案,彰化縣,和美鎮,和西里,385,1117,334,249,583,55,638
公投第１６案,彰化縣,和美鎮,和西里,386,1066,306,231,537,55,592
公投第１６案,彰化縣,和美鎮,四張里,387,1252,399,226,625,51,676
公投第１６案,彰化縣,和美鎮,四張里,388,1528,454,285,739,68,807
公投第１６案,彰化縣,和美鎮,頭前里,389,826,263,188,451,46,497
公投第１６案,彰化縣,和美鎮,頭前里,390,854,268,173,441,39,480
公投第１６案,彰化縣,和美鎮,面前里,391,1387,388,280,668,69,737
公投第１６案,彰化縣,和美鎮,面前里,392,765,279,172,451,26,477
公投第１６案,彰化縣,和美鎮,鎮平里,393,1438,426,253,679,71,750
公投第１６案,彰化縣,和美鎮,鎮平里,394,1396,446,307,753,77,830
公投第１６案,彰化縣,和美鎮,大霞里,395,658,211,140,351,28,379
公投第１６案,彰化縣,和美鎮,大霞里,396,809,290,197,487,29,516
公投第１６案,彰化縣,和美鎮,源埤里,397,932,254,200,454,29,483
公投第１６案,彰化縣,和美鎮,源埤里,398,888,280,169,449,37,486
公投第１６案,彰化縣,和美鎮,南佃里,399,1144,398,249,647,51,698
公投第１６案,彰化縣,和美鎮,南佃里,400,1077,347,218,565,50,615
公投第１６案,彰化縣,和美鎮,雅溝里,401,1349,359,278,637,76,713
公投第１６案,彰化縣,和美鎮,山犁里,402,1155,402,268,670,49,719
公投第１６案,彰化縣,和美鎮,山犁里,403,1253,409,230,639,55,694
公投第１６案,彰化縣,和美鎮,山犁里,404,1252,383,249,632,53,685
公投第１６案,彰化縣,和美鎮,山犁里,405,1474,469,283,752,35,787
公投第１６案,彰化縣,和美鎮,仁愛里,406,1396,379,268,647,45,692
公投第１６案,彰化縣,和美鎮,仁愛里,407,1348,429,245,674,50,724
公投第１６案,彰化縣,和美鎮,嘉犁里,408,999,325,255,580,39,619
公投第１６案,彰化縣,和美鎮,嘉犁里,409,911,296,209,505,44,549
公投第１６案,彰化縣,和美鎮,詔安里,410,1005,312,237,549,37,586
公投第１６案,彰化縣,和美鎮,詔安里,411,967,308,199,507,54,561
公投第１６案,彰化縣,和美鎮,鐵山里,412,1308,320,377,697,68,765
公投第１６案,彰化縣,和美鎮,鐵山里,413,1324,425,270,695,53,748
公投第１６案,彰化縣,和美鎮,柑井里,414,1102,305,280,585,72,657
公投第１６案,彰化縣,和美鎮,柑井里,415,1124,324,236,560,60,620
公投第１６案,彰化縣,和美鎮,柑井里,416,1211,362,265,627,77,704
公投第１６案,彰化縣,和美鎮,竹園里,417,884,305,222,527,61,588
公投第１６案,彰化縣,和美鎮,新庄里,418,1119,320,256,576,75,651
公投第１６案,彰化縣,和美鎮,新庄里,419,1300,394,277,671,69,740
公投第１６案,彰化縣,和美鎮,犁盛里,420,1104,310,233,543,61,604
公投第１６案,彰化縣,和美鎮,犁盛里,421,1213,421,259,680,60,740
公投第１６案,彰化縣,和美鎮,中寮里,422,1127,308,211,519,56,575
公投第１６案,彰化縣,和美鎮,中圍里,423,919,277,186,463,61,524
公投第１６案,彰化縣,和美鎮,中圍里,424,987,323,213,536,57,593
公投第１６案,彰化縣,和美鎮,中圍里,425,958,334,209,543,48,591
公投第１６案,彰化縣,和美鎮,糖友里,426,1362,479,255,734,55,789
公投第１６案,彰化縣,和美鎮,糖友里,427,1461,481,276,757,44,801
公投第１６案,彰化縣,和美鎮,糖友里,428,1405,450,315,765,39,804
公投第１６案,彰化縣,和美鎮,還社里,429,860,284,186,470,50,520
公投第１６案,彰化縣,和美鎮,塗厝里,430,875,283,174,457,22,479
公投第１６案,彰化縣,和美鎮,塗厝里,431,871,269,185,454,49,503
公投第１６案,彰化縣,和美鎮,地潭里,432,883,281,209,490,62,552
公投第１６案,彰化縣,和美鎮,湖內里,433,1224,363,254,617,60,677
公投第１６案,彰化縣,和美鎮,嘉寶里,434,1075,317,224,541,56,597
公投第１６案,彰化縣,和美鎮,嘉寶里,435,956,287,210,497,47,544
公投第１６案,彰化縣,和美鎮,月眉里,436,1037,309,218,527,54,581
公投第１６案,彰化縣,和美鎮,月眉里,437,1011,317,211,528,32,560
公投第１６案,彰化縣,和美鎮,月眉里,438,1023,284,221,505,68,573
公投第１６案,彰化縣,和美鎮,好修里,439,719,222,131,353,39,392
公投第１６案,彰化縣,和美鎮,好修里,440,913,248,201,449,66,515
公投第１６案,彰化縣,伸港鄉,大同村,441,1182,421,109,530,65,595
公投第１６案,彰化縣,伸港鄉,大同村,442,1166,480,182,662,57,719
公投第１６案,彰化縣,伸港鄉,海尾村,443,966,300,205,505,58,563
公投第１６案,彰化縣,伸港鄉,海尾村,444,873,261,179,440,48,488
公投第１６案,彰化縣,伸港鄉,全興村,445,812,261,167,428,62,490
公投第１６案,彰化縣,伸港鄉,全興村,446,875,258,185,443,49,492
公投第１６案,彰化縣,伸港鄉,溪底村,447,904,281,168,449,57,506
公投第１６案,彰化縣,伸港鄉,溪底村,448,1008,304,205,509,51,560
公投第１６案,彰化縣,伸港鄉,定興村,449,1154,393,236,629,56,685
公投第１６案,彰化縣,伸港鄉,定興村,450,1486,393,298,691,93,784
公投第１６案,彰化縣,伸港鄉,什股村,451,1095,353,202,555,55,610
公投第１６案,彰化縣,伸港鄉,什股村,452,1087,295,227,522,33,555
公投第１６案,彰化縣,伸港鄉,泉州村,453,1085,338,233,571,75,646
公投第１６案,彰化縣,伸港鄉,泉州村,454,908,320,176,496,47,543
公投第１６案,彰化縣,伸港鄉,泉厝村,455,1264,461,262,723,49,772
公投第１６案,彰化縣,伸港鄉,曾家村,456,854,243,162,405,66,471
公投第１６案,彰化縣,伸港鄉,曾家村,457,846,201,176,377,50,427
公投第１６案,彰化縣,伸港鄉,蚵寮村,458,1143,285,213,498,112,610
公投第１６案,彰化縣,伸港鄉,新港村,459,1357,432,274,706,54,760
公投第１６案,彰化縣,伸港鄉,新港村,460,1349,389,284,673,77,750
公投第１６案,彰化縣,伸港鄉,新港村,461,1154,360,251,611,68,679
公投第１６案,彰化縣,伸港鄉,新港村,462,1279,347,276,623,53,676
公投第１６案,彰化縣,伸港鄉,埤墘村,463,1317,419,291,710,66,776
公投第１６案,彰化縣,伸港鄉,七嘉村,464,990,326,227,553,55,608
公投第１６案,彰化縣,伸港鄉,七嘉村,465,852,298,177,475,29,504
公投第１６案,彰化縣,伸港鄉,七嘉村,466,1178,378,254,632,45,677
公投第１６案,彰化縣,伸港鄉,汴頭村,467,1088,291,248,539,97,636
公投第１６案,彰化縣,伸港鄉,汴頭村,468,1135,361,229,590,59,649
公投第１６案,彰化縣,線西鄉,線西村,469,1071,363,207,570,39,609
公投第１６案,彰化縣,線西鄉,線西村,470,1166,406,243,649,45,694
公投第１６案,彰化縣,線西鄉,頂庄村,471,1269,426,252,678,76,754
公投第１６案,彰化縣,線西鄉,寓埔村,472,1138,366,230,596,58,654
公投第１６案,彰化縣,線西鄉,寓埔村,473,1128,368,270,638,81,719
公投第１６案,彰化縣,線西鄉,塭仔村,474,1275,410,266,676,96,772
公投第１６案,彰化縣,線西鄉,溝內村,475,1187,410,245,655,53,708
公投第１６案,彰化縣,線西鄉,下犁村,476,991,317,232,549,58,607
公投第１６案,彰化縣,線西鄉,下犁村,477,938,286,204,490,73,563
公投第１６案,彰化縣,線西鄉,頂犁村,478,1276,370,232,602,78,680
公投第１６案,彰化縣,線西鄉,頂犁村,479,1285,401,293,694,63,757
公投第１６案,彰化縣,線西鄉,德興村,480,1341,524,275,799,79,878
公投第１６案,彰化縣,員林市,崙雅里,481,1087,337,193,530,36,566
公投第１６案,彰化縣,員林市,崙雅里,482,1353,391,265,656,43,699
公投第１６案,彰化縣,員林市,振興里,483,1313,381,254,635,63,698
公投第１６案,彰化縣,員林市,振興里,484,1328,359,221,580,26,606
公投第１６案,彰化縣,員林市,林厝里,485,1055,251,307,558,39,597
公投第１６案,彰化縣,員林市,林厝里,486,959,287,181,468,55,523
公投第１６案,彰化縣,員林市,林厝里,487,772,232,169,401,50,451
公投第１６案,彰化縣,員林市,出水里,488,831,283,177,460,51,511
公投第１６案,彰化縣,員林市,出水里,489,854,197,169,366,27,393
公投第１６案,彰化縣,員林市,湖水里,490,1190,266,211,477,55,532
公投第１６案,彰化縣,員林市,大峯里,491,726,219,143,362,35,397
公投第１６案,彰化縣,員林市,鎮興里,492,1124,328,231,559,71,630
公投第１６案,彰化縣,員林市,鎮興里,493,860,219,169,388,65,453
公投第１６案,彰化縣,員林市,浮圳里,494,1122,389,224,613,70,683
公投第１６案,彰化縣,員林市,浮圳里,495,1075,371,213,584,57,641
公投第１６案,彰化縣,員林市,西東里,496,993,257,217,474,76,550
公投第１６案,彰化縣,員林市,西東里,497,967,269,217,486,41,527
公投第１６案,彰化縣,員林市,南東里,498,1008,283,228,511,67,578
公投第１６案,彰化縣,員林市,南東里,499,804,223,171,394,61,455
公投第１６案,彰化縣,員林市,中東里,500,867,249,192,441,41,482
公投第１６案,彰化縣,員林市,中東里,501,885,250,165,415,47,462
公投第１６案,彰化縣,員林市,東北里,502,1097,274,173,447,21,468
公投第１６案,彰化縣,員林市,東北里,503,1255,399,238,637,36,673
公投第１６案,彰化縣,員林市,東和里,504,1063,320,245,565,50,615
公投第１６案,彰化縣,員林市,民生里,505,925,400,101,501,18,519
公投第１６案,彰化縣,員林市,民生里,506,947,270,233,503,56,559
公投第１６案,彰化縣,員林市,民生里,507,916,319,199,518,32,550
公投第１６案,彰化縣,員林市,黎明里,508,862,267,170,437,43,480
公投第１６案,彰化縣,員林市,黎明里,509,987,320,207,527,29,556
公投第１６案,彰化縣,員林市,惠來里,510,1085,338,206,544,50,594
公投第１６案,彰化縣,員林市,惠來里,511,1110,360,242,602,37,639
公投第１６案,彰化縣,員林市,惠來里,512,1095,321,213,534,33,567
公投第１６案,彰化縣,員林市,惠來里,513,1278,447,288,735,47,782
公投第１６案,彰化縣,員林市,惠來里,514,1109,387,227,614,39,653
公投第１６案,彰化縣,員林市,中央里,515,1055,312,229,541,70,611
公投第１６案,彰化縣,員林市,中央里,516,876,260,210,470,39,509
公投第１６案,彰化縣,員林市,溝皂里,517,1115,298,220,518,50,568
公投第１６案,彰化縣,員林市,溝皂里,518,1186,402,229,631,58,689
公投第１６案,彰化縣,員林市,大饒里,519,995,365,184,549,51,600
公投第１６案,彰化縣,員林市,大饒里,520,999,309,191,500,24,524
公投第１６案,彰化縣,員林市,大饒里,521,1201,366,246,612,44,656
公投第１６案,彰化縣,員林市,大明里,522,1342,397,297,694,42,736
公投第１６案,彰化縣,員林市,大明里,523,1086,307,234,541,42,583
公投第１６案,彰化縣,員林市,萬年里,524,854,264,146,410,46,456
公投第１６案,彰化縣,員林市,萬年里,525,1064,334,214,548,42,590
公投第１６案,彰化縣,員林市,萬年里,526,879,296,206,502,15,517
公投第１６案,彰化縣,員林市,萬年里,527,827,322,198,520,41,561
公投第１６案,彰化縣,員林市,中正里,528,867,266,168,434,28,462
公投第１６案,彰化縣,員林市,中正里,529,1201,371,271,642,37,679
公投第１６案,彰化縣,員林市,中正里,530,1106,372,228,600,43,643
公投第１６案,彰化縣,員林市,仁美里,531,845,250,202,452,52,504
公投第１６案,彰化縣,員林市,仁美里,532,894,296,187,483,42,525
公投第１６案,彰化縣,員林市,仁美里,533,849,299,158,457,45,502
公投第１６案,彰化縣,員林市,新興里,534,747,246,173,419,50,469
公投第１６案,彰化縣,員林市,和平里,535,884,331,181,512,37,549
公投第１６案,彰化縣,員林市,和平里,536,900,262,182,444,36,480
公投第１６案,彰化縣,員林市,和平里,537,1040,321,188,509,35,544
公投第１６案,彰化縣,員林市,光明里,538,831,264,162,426,30,456
公投第１６案,彰化縣,員林市,中山里,539,591,224,126,350,39,389
公投第１６案,彰化縣,員林市,三條里,540,1330,407,277,684,38,722
公投第１６案,彰化縣,員林市,三條里,541,1295,434,253,687,41,728
公投第１６案,彰化縣,員林市,忠孝里,542,1283,369,257,626,90,716
公投第１６案,彰化縣,員林市,忠孝里,543,943,326,203,529,41,570
公投第１６案,彰化縣,員林市,仁愛里,544,1388,446,353,799,73,872
公投第１６案,彰化縣,員林市,三和里,545,1176,385,247,632,48,680
公投第１６案,彰化縣,員林市,三和里,546,867,245,154,399,21,420
公投第１６案,彰化縣,員林市,三和里,547,1121,321,223,544,70,614
公投第１６案,彰化縣,員林市,三和里,548,1190,390,200,590,45,635
公投第１６案,彰化縣,員林市,三和里,549,945,314,202,516,49,565
公投第１６案,彰化縣,員林市,三和里,550,906,310,196,506,42,548
公投第１６案,彰化縣,員林市,三橋里,551,978,292,256,548,49,597
公投第１６案,彰化縣,員林市,三橋里,552,949,308,192,500,60,560
公投第１６案,彰化縣,員林市,三橋里,553,949,318,223,541,33,574
公投第１６案,彰化縣,員林市,三愛里,554,1006,331,178,509,51,560
公投第１６案,彰化縣,員林市,三愛里,555,889,364,113,477,51,528
公投第１６案,彰化縣,員林市,三愛里,556,923,325,213,538,24,562
公投第１６案,彰化縣,員林市,三信里,557,1209,403,282,685,63,748
公投第１６案,彰化縣,員林市,三信里,558,1075,341,263,604,47,651
公投第１６案,彰化縣,員林市,三多里,559,1342,492,292,784,39,823
公投第１６案,彰化縣,員林市,三多里,560,1039,367,277,644,44,688
公投第１６案,彰化縣,員林市,三義里,561,1131,324,193,517,114,631
公投第１６案,彰化縣,員林市,三義里,562,1356,416,257,673,31,704
公投第１６案,彰化縣,員林市,新生里,563,1370,441,269,710,59,769
公投第１６案,彰化縣,員林市,新生里,564,1090,344,240,584,53,637
公投第１６案,彰化縣,員林市,新生里,565,821,307,197,504,31,535
公投第１６案,彰化縣,員林市,新生里,566,910,290,217,507,34,541
公投第１６案,彰化縣,員林市,南平里,567,1203,386,243,629,54,683
公投第１６案,彰化縣,員林市,南平里,568,1378,446,294,740,40,780
公投第１６案,彰化縣,員林市,南平里,569,1352,443,285,728,35,763
公投第１６案,彰化縣,員林市,南平里,570,1060,384,236,620,33,653
公投第１６案,彰化縣,員林市,南興里,571,1317,374,285,659,67,726
公投第１６案,彰化縣,員林市,南興里,572,1120,339,214,553,56,609
公投第１６案,彰化縣,員林市,南興里,573,1025,310,185,495,60,555
公投第１６案,彰化縣,員林市,南興里,574,1097,347,228,575,55,630
公投第１６案,彰化縣,員林市,源潭里,575,859,264,209,473,51,524
公投第１６案,彰化縣,員林市,源潭里,576,837,256,167,423,42,465
公投第１６案,彰化縣,員林市,大埔里,577,1090,356,267,623,60,683
公投第１６案,彰化縣,員林市,大埔里,578,1073,309,223,532,80,612
公投第１６案,彰化縣,大村鄉,大村村,579,1426,484,341,825,78,903
公投第１６案,彰化縣,大村鄉,大村村,580,1726,595,393,988,85,1073
公投第１６案,彰化縣,大村鄉,茄苳村,581,797,224,214,438,67,505
公投第１６案,彰化縣,大村鄉,茄苳村,582,745,242,155,397,34,431
公投第１６案,彰化縣,大村鄉,田洋村,583,1125,394,228,622,67,689
公投第１６案,彰化縣,大村鄉,貢旗村,584,1486,440,313,753,114,867
公投第１６案,彰化縣,大村鄉,南勢村,585,1426,455,285,740,93,833
公投第１６案,彰化縣,大村鄉,大橋村,586,824,291,185,476,48,524
公投第１６案,彰化縣,大村鄉,大橋村,587,1177,324,225,549,54,603
公投第１６案,彰化縣,大村鄉,加錫村,588,1478,487,306,793,88,881
公投第１６案,彰化縣,大村鄉,大崙村,589,779,216,168,384,27,411
公投第１６案,彰化縣,大村鄉,大崙村,590,812,285,165,450,56,506
公投第１６案,彰化縣,大村鄉,新興村,591,1161,372,222,594,50,644
公投第１６案,彰化縣,大村鄉,擺塘村,592,1238,377,247,624,56,680
公投第１６案,彰化縣,大村鄉,擺塘村,593,1259,391,263,654,73,727
公投第１６案,彰化縣,大村鄉,過溝村,594,1412,458,304,762,57,819
公投第１６案,彰化縣,大村鄉,過溝村,595,1401,460,298,758,35,793
公投第１６案,彰化縣,大村鄉,村上村,596,1395,467,287,754,89,843
公投第１６案,彰化縣,大村鄉,美港村,597,996,324,208,532,69,601
公投第１６案,彰化縣,大村鄉,美港村,598,1047,333,232,565,47,612
公投第１６案,彰化縣,大村鄉,美港村,599,985,329,200,529,54,583
公投第１６案,彰化縣,大村鄉,黃厝村,600,1054,358,244,602,56,658
公投第１６案,彰化縣,大村鄉,黃厝村,601,1200,402,252,654,61,715
公投第１６案,彰化縣,大村鄉,福興村,602,1003,319,221,540,78,618
公投第１６案,彰化縣,大村鄉,福興村,603,1046,289,227,516,58,574
公投第１６案,彰化縣,大村鄉,平和村,604,1189,381,263,644,61,705
公投第１６案,彰化縣,大村鄉,平和村,605,1305,383,254,637,64,701
公投第１６案,彰化縣,永靖鄉,浮圳村,606,1255,348,232,580,95,675
公投第１６案,彰化縣,永靖鄉,東寧村,607,889,278,192,470,72,542
公投第１６案,彰化縣,永靖鄉,東寧村,608,1026,299,225,524,54,578
公投第１６案,彰化縣,永靖鄉,光雲村,609,724,240,158,398,53,451
公投第１６案,彰化縣,永靖鄉,光雲村,610,924,302,200,502,51,553
公投第１６案,彰化縣,永靖鄉,五汴村,611,659,179,180,359,61,420
公投第１６案,彰化縣,永靖鄉,五汴村,612,734,230,165,395,40,435
公投第１６案,彰化縣,永靖鄉,永興村,613,758,191,136,327,25,352
公投第１６案,彰化縣,永靖鄉,永興村,614,848,313,197,510,44,554
公投第１６案,彰化縣,永靖鄉,崙子村,615,1404,381,289,670,93,763
公投第１６案,彰化縣,永靖鄉,永東村,616,792,309,204,513,37,550
公投第１６案,彰化縣,永靖鄉,永西村,617,695,225,177,402,44,446
公投第１６案,彰化縣,永靖鄉,永西村,618,821,299,161,460,49,509
公投第１６案,彰化縣,永靖鄉,永南村,619,1064,382,209,591,81,672
公投第１６案,彰化縣,永靖鄉,永南村,620,840,261,173,434,52,486
公投第１６案,彰化縣,永靖鄉,永北村,621,1079,350,279,629,40,669
公投第１６案,彰化縣,永靖鄉,永北村,622,1048,346,251,597,57,654
公投第１６案,彰化縣,永靖鄉,港西村,623,960,322,222,544,67,611
公投第１６案,彰化縣,永靖鄉,港西村,624,798,260,186,446,36,482
公投第１６案,彰化縣,永靖鄉,五福村,625,796,238,210,448,80,528
公投第１６案,彰化縣,永靖鄉,五福村,626,662,198,132,330,51,381
公投第１６案,彰化縣,永靖鄉,湳港村,627,1040,324,228,552,54,606
公投第１６案,彰化縣,永靖鄉,新莊村,628,1025,305,226,531,54,585
公投第１６案,彰化縣,永靖鄉,瑚璉村,629,1357,498,297,795,81,876
公投第１６案,彰化縣,永靖鄉,瑚璉村,630,1236,431,266,697,79,776
公投第１６案,彰化縣,永靖鄉,獨鰲村,631,871,272,198,470,24,494
公投第１６案,彰化縣,永靖鄉,敦厚村,632,706,227,118,345,42,387
公投第１６案,彰化縣,永靖鄉,崙美村,633,770,252,196,448,46,494
公投第１６案,彰化縣,永靖鄉,同安村,634,669,244,147,391,48,439
公投第１６案,彰化縣,永靖鄉,同仁村,635,862,240,199,439,58,497
公投第１６案,彰化縣,永靖鄉,湳墘村,636,847,258,169,427,50,477
公投第１６案,彰化縣,永靖鄉,四芳村,637,668,243,131,374,56,430
公投第１６案,彰化縣,永靖鄉,福興村,638,1073,306,197,503,45,548
公投第１６案,彰化縣,永靖鄉,竹子村,639,1339,337,256,593,63,656
公投第１６案,彰化縣,溪湖鎮,光平里,640,1221,365,244,609,67,676
公投第１６案,彰化縣,溪湖鎮,平和里,641,638,225,141,366,43,409
公投第１６案,彰化縣,溪湖鎮,太平里,642,817,250,177,427,58,485
公投第１６案,彰化縣,溪湖鎮,太平里,643,968,364,185,549,47,596
公投第１６案,彰化縣,溪湖鎮,光華里,644,448,171,100,271,24,295
公投第１６案,彰化縣,溪湖鎮,湖東里,645,1123,294,237,531,54,585
公投第１６案,彰化縣,溪湖鎮,湖東里,646,1166,351,251,602,56,658
公投第１６案,彰化縣,溪湖鎮,湖東里,647,1151,345,252,597,44,641
公投第１６案,彰化縣,溪湖鎮,湖東里,648,1249,431,246,677,46,723
公投第１６案,彰化縣,溪湖鎮,中山里,649,1146,370,252,622,56,678
公投第１６案,彰化縣,溪湖鎮,中山里,650,1199,424,236,660,53,713
公投第１６案,彰化縣,溪湖鎮,西溪里,651,895,287,175,462,59,521
公投第１６案,彰化縣,溪湖鎮,西溪里,652,964,309,219,528,32,560
公投第１６案,彰化縣,溪湖鎮,中竹里,653,851,253,209,462,35,497
公投第１６案,彰化縣,溪湖鎮,東寮里,654,1072,338,220,558,51,609
公投第１６案,彰化縣,溪湖鎮,東寮里,655,1113,376,234,610,58,668
公投第１６案,彰化縣,溪湖鎮,東寮里,656,1090,392,213,605,48,653
公投第１６案,彰化縣,溪湖鎮,西寮里,657,1193,416,258,674,49,723
公投第１６案,彰化縣,溪湖鎮,西寮里,658,952,348,182,530,61,591
公投第１６案,彰化縣,溪湖鎮,大突里,659,1172,362,244,606,64,670
公投第１６案,彰化縣,溪湖鎮,大突里,660,1027,442,106,548,44,592
公投第１６案,彰化縣,溪湖鎮,大突里,661,1188,430,266,696,50,746
公投第１６案,彰化縣,溪湖鎮,北勢里,662,1403,397,279,676,67,743
公投第１６案,彰化縣,溪湖鎮,汴頭里,663,1397,375,249,624,90,714
公投第１６案,彰化縣,溪湖鎮,汴頭里,664,1636,510,332,842,72,914
公投第１６案,彰化縣,溪湖鎮,大竹里,665,1298,429,251,680,94,774
公投第１６案,彰化縣,溪湖鎮,大竹里,666,1214,395,240,635,64,699
公投第１６案,彰化縣,溪湖鎮,湖西里,667,1297,411,298,709,67,776
公投第１６案,彰化縣,溪湖鎮,湖西里,668,968,347,200,547,58,605
公投第１６案,彰化縣,溪湖鎮,田中里,669,839,258,193,451,57,508
公投第１６案,彰化縣,溪湖鎮,河東里,670,907,277,204,481,70,551
公投第１６案,彰化縣,溪湖鎮,河東里,671,898,258,151,409,40,449
公投第１６案,彰化縣,溪湖鎮,頂庄里,672,650,242,155,397,52,449
公投第１６案,彰化縣,溪湖鎮,忠覺里,673,1279,384,254,638,100,738
公投第１６案,彰化縣,溪湖鎮,湳底里,674,730,240,165,405,62,467
公投第１６案,彰化縣,溪湖鎮,大庭里,675,1407,471,272,743,75,818
公投第１６案,彰化縣,溪湖鎮,媽厝里,676,1273,338,237,575,63,638
公投第１６案,彰化縣,溪湖鎮,番婆里,677,988,300,199,499,38,537
公投第１６案,彰化縣,溪湖鎮,番婆里,678,754,242,182,424,57,481
公投第１６案,彰化縣,溪湖鎮,西勢里,679,1052,279,181,460,65,525
公投第１６案,彰化縣,溪湖鎮,西勢里,680,1149,337,232,569,48,617
公投第１６案,彰化縣,溪湖鎮,東溪里,681,1365,291,449,740,124,864
公投第１６案,彰化縣,埔鹽鄉,埔鹽村,682,958,435,115,550,44,594
公投第１６案,彰化縣,埔鹽鄉,埔鹽村,683,754,237,205,442,53,495
公投第１６案,彰化縣,埔鹽鄉,埔南村,684,757,267,197,464,37,501
公投第１６案,彰化縣,埔鹽鄉,埔南村,685,806,264,198,462,43,505
公投第１６案,彰化縣,埔鹽鄉,廍子村,686,1280,449,254,703,39,742
公投第１６案,彰化縣,埔鹽鄉,出水村,687,928,313,191,504,45,549
公投第１６案,彰化縣,埔鹽鄉,南港村,688,895,302,225,527,74,601
公投第１６案,彰化縣,埔鹽鄉,南港村,689,815,270,201,471,55,526
公投第１６案,彰化縣,埔鹽鄉,打廉村,690,957,308,193,501,59,560
公投第１６案,彰化縣,埔鹽鄉,豐澤村,691,1338,425,235,660,126,786
公投第１６案,彰化縣,埔鹽鄉,崑崙村,692,1106,322,237,559,74,633
公投第１６案,彰化縣,埔鹽鄉,角樹村,693,690,259,162,421,54,475
公投第１６案,彰化縣,埔鹽鄉,瓦磘村,694,1230,402,266,668,38,706
公投第１６案,彰化縣,埔鹽鄉,好修村,695,847,253,189,442,42,484
公投第１６案,彰化縣,埔鹽鄉,好修村,696,897,307,218,525,37,562
公投第１６案,彰化縣,埔鹽鄉,西湖村,697,882,259,212,471,58,529
公投第１６案,彰化縣,埔鹽鄉,西湖村,698,1180,434,223,657,60,717
公投第１６案,彰化縣,埔鹽鄉,大有村,699,1215,366,237,603,103,706
公投第１６案,彰化縣,埔鹽鄉,新興村,700,422,170,80,250,31,281
公投第１６案,彰化縣,埔鹽鄉,永平村,701,1106,355,206,561,62,623
公投第１６案,彰化縣,埔鹽鄉,永樂村,702,874,284,213,497,68,565
公投第１６案,彰化縣,埔鹽鄉,石埤村,703,1445,451,287,738,120,858
公投第１６案,彰化縣,埔鹽鄉,天盛村,704,875,296,172,468,77,545
公投第１６案,彰化縣,埔鹽鄉,太平村,705,837,256,144,400,47,447
公投第１６案,彰化縣,埔鹽鄉,太平村,706,685,220,131,351,61,412
公投第１６案,彰化縣,埔鹽鄉,新水村,707,733,244,160,404,60,464
公投第１６案,彰化縣,埔鹽鄉,新水村,708,798,252,154,406,90,496
公投第１６案,彰化縣,埔鹽鄉,三省村,709,1381,457,256,713,80,793
公投第１６案,彰化縣,埔鹽鄉,南新村,710,1335,388,261,649,55,704
公投第１６案,彰化縣,埔心鄉,東門村,711,1139,381,235,616,93,709
公投第１６案,彰化縣,埔心鄉,東門村,712,1217,370,280,650,65,715
公投第１６案,彰化縣,埔心鄉,東門村,713,1248,428,301,729,45,774
公投第１６案,彰化縣,埔心鄉,埔心村,714,1248,404,323,727,77,804
公投第１６案,彰化縣,埔心鄉,義民村,715,916,338,179,517,50,567
公投第１６案,彰化縣,埔心鄉,義民村,716,625,214,167,381,29,410
公投第１６案,彰化縣,埔心鄉,油車村,717,1271,401,247,648,46,694
公投第１６案,彰化縣,埔心鄉,瓦北村,718,608,213,130,343,35,378
公投第１６案,彰化縣,埔心鄉,瓦北村,719,1132,382,268,650,82,732
公投第１６案,彰化縣,埔心鄉,瓦中村,720,1027,363,209,572,66,638
公投第１６案,彰化縣,埔心鄉,瓦中村,721,926,340,192,532,56,588
公投第１６案,彰化縣,埔心鄉,瓦南村,722,778,252,162,414,68,482
公投第１６案,彰化縣,埔心鄉,瓦南村,723,660,250,143,393,33,426
公投第１６案,彰化縣,埔心鄉,經口村,724,1330,475,276,751,67,818
公投第１６案,彰化縣,埔心鄉,經口村,725,991,313,239,552,29,581
公投第１６案,彰化縣,埔心鄉,太平村,726,985,332,237,569,46,615
公投第１６案,彰化縣,埔心鄉,太平村,727,1034,327,221,548,47,595
公投第１６案,彰化縣,埔心鄉,大華村,728,612,213,131,344,55,399
公投第１６案,彰化縣,埔心鄉,仁里村,729,1236,448,269,717,70,787
公投第１６案,彰化縣,埔心鄉,舊舘村,730,775,257,176,433,58,491
公投第１６案,彰化縣,埔心鄉,舊舘村,731,738,268,185,453,45,498
公投第１６案,彰化縣,埔心鄉,南舘村,732,1036,316,275,591,45,636
公投第１６案,彰化縣,埔心鄉,新舘村,733,975,283,195,478,80,558
公投第１６案,彰化縣,埔心鄉,芎蕉村,734,885,269,181,450,53,503
公投第１６案,彰化縣,埔心鄉,芎蕉村,735,939,311,203,514,77,591
公投第１６案,彰化縣,埔心鄉,羅厝村,736,689,239,122,361,43,404
公投第１６案,彰化縣,埔心鄉,羅厝村,737,659,223,134,357,35,392
公投第１６案,彰化縣,埔心鄉,梧鳳村,738,910,273,182,455,46,501
公投第１６案,彰化縣,埔心鄉,二重村,739,1352,466,332,798,93,891
公投第１６案,彰化縣,埔心鄉,埤霞村,740,759,237,161,398,41,439
公投第１６案,彰化縣,埔心鄉,埤脚村,741,942,323,188,511,57,568
公投第１６案,彰化縣,田中鎮,香山里,742,854,241,151,392,84,476
公投第１６案,彰化縣,田中鎮,碧峰里,743,963,269,166,435,55,490
公投第１６案,彰化縣,田中鎮,碧峰里,744,175,21,17,38,7,45
公投第１６案,彰化縣,田中鎮,東源里,745,739,198,159,357,37,394
公投第１６案,彰化縣,田中鎮,復興里,746,826,246,155,401,42,443
公投第１６案,彰化縣,田中鎮,復興里,747,741,177,217,394,55,449
公投第１６案,彰化縣,田中鎮,平和里,748,506,128,77,205,13,218
公投第１６案,彰化縣,田中鎮,平和里,749,1001,273,186,459,62,521
公投第１６案,彰化縣,田中鎮,頂潭里,750,1281,392,250,642,94,736
公投第１６案,彰化縣,田中鎮,新庄里,751,1035,316,223,539,68,607
公投第１６案,彰化縣,田中鎮,新庄里,752,1327,402,304,706,72,778
公投第１６案,彰化縣,田中鎮,中潭里,753,844,269,200,469,51,520
公投第１６案,彰化縣,田中鎮,中潭里,754,913,285,190,475,43,518
公投第１６案,彰化縣,田中鎮,龍潭里,755,613,226,139,365,40,405
公投第１６案,彰化縣,田中鎮,北路里,756,1382,430,289,719,98,817
公投第１６案,彰化縣,田中鎮,北路里,757,1034,373,245,618,53,671
公投第１６案,彰化縣,田中鎮,北路里,758,935,341,232,573,44,617
公投第１６案,彰化縣,田中鎮,西路里,759,1301,404,280,684,67,751
公投第１６案,彰化縣,田中鎮,西路里,760,1100,376,242,618,49,667
公投第１６案,彰化縣,田中鎮,東路里,761,1071,336,243,579,68,647
公投第１６案,彰化縣,田中鎮,南路里,762,1163,401,242,643,78,721
公投第１６案,彰化縣,田中鎮,中路里,763,809,272,208,480,53,533
公投第１６案,彰化縣,田中鎮,中路里,764,1155,362,274,636,66,702
公投第１６案,彰化縣,田中鎮,梅州里,765,1270,384,258,642,90,732
公投第１６案,彰化縣,田中鎮,三安里,766,870,248,199,447,41,488
公投第１６案,彰化縣,田中鎮,三安里,767,736,196,147,343,79,422
公投第１６案,彰化縣,田中鎮,大崙里,768,1335,351,286,637,57,694
公投第１６案,彰化縣,田中鎮,沙崙里,769,876,243,206,449,47,496
公投第１６案,彰化縣,田中鎮,沙崙里,770,898,245,197,442,51,493
公投第１６案,彰化縣,田中鎮,新民里,771,1298,417,286,703,41,744
公投第１６案,彰化縣,田中鎮,新民里,772,1451,409,302,711,98,809
公投第１６案,彰化縣,田中鎮,新民里,773,1475,463,293,756,81,837
公投第１６案,彰化縣,田中鎮,三民里,774,766,198,145,343,61,404
公投第１６案,彰化縣,田中鎮,三民里,775,810,242,160,402,37,439
公投第１６案,彰化縣,田中鎮,三光里,776,953,279,215,494,76,570
公投第１６案,彰化縣,田中鎮,大社里,777,885,288,197,485,70,555
公投第１６案,彰化縣,社頭鄉,社頭村,778,791,217,205,422,43,465
公投第１６案,彰化縣,社頭鄉,社頭村,779,984,303,209,512,47,559
公投第１６案,彰化縣,社頭鄉,社頭村,780,990,292,192,484,30,514
公投第１６案,彰化縣,社頭鄉,廣興村,781,1016,342,230,572,58,630
公投第１６案,彰化縣,社頭鄉,廣興村,782,1091,555,55,610,49,659
公投第１６案,彰化縣,社頭鄉,廣興村,783,1236,392,271,663,80,743
公投第１６案,彰化縣,社頭鄉,廣興村,784,1203,372,251,623,35,658
公投第１６案,彰化縣,社頭鄉,東興村,785,753,243,151,394,33,427
公投第１６案,彰化縣,社頭鄉,東興村,786,725,211,138,349,37,386
公投第１６案,彰化縣,社頭鄉,松竹村,787,1023,309,242,551,72,623
公投第１６案,彰化縣,社頭鄉,舊社村,788,562,188,146,334,46,380
公投第１６案,彰化縣,社頭鄉,舊社村,789,1049,310,224,534,49,583
公投第１６案,彰化縣,社頭鄉,廣福村,790,933,308,204,512,46,558
公投第１６案,彰化縣,社頭鄉,橋頭村,791,990,304,235,539,67,606
公投第１６案,彰化縣,社頭鄉,橋頭村,792,1076,309,208,517,50,567
公投第１６案,彰化縣,社頭鄉,新厝村,793,742,245,177,422,30,452
公投第１６案,彰化縣,社頭鄉,新厝村,794,672,205,136,341,30,371
公投第１６案,彰化縣,社頭鄉,張厝村,795,1235,346,224,570,54,624
公投第１６案,彰化縣,社頭鄉,湳底村,796,750,233,186,419,36,455
公投第１６案,彰化縣,社頭鄉,湳底村,797,895,252,188,440,47,487
公投第１６案,彰化縣,社頭鄉,仁雅村,798,688,205,118,323,23,346
公投第１６案,彰化縣,社頭鄉,仁雅村,799,870,287,151,438,42,480
公投第１６案,彰化縣,社頭鄉,仁雅村,800,1140,374,265,639,41,680
公投第１６案,彰化縣,社頭鄉,里仁村,801,985,296,226,522,60,582
公投第１６案,彰化縣,社頭鄉,美雅村,802,1266,473,244,717,70,787
公投第１６案,彰化縣,社頭鄉,崙雅村,803,937,291,214,505,49,554
公投第１６案,彰化縣,社頭鄉,清水村,804,1219,386,251,637,55,692
公投第１６案,彰化縣,社頭鄉,山湖村,805,1165,353,238,591,78,669
公投第１６案,彰化縣,社頭鄉,埤斗村,806,986,329,201,530,60,590
公投第１６案,彰化縣,社頭鄉,仁和村,807,724,345,82,427,31,458
公投第１６案,彰化縣,社頭鄉,平和村,808,1015,317,226,543,47,590
公投第１６案,彰化縣,社頭鄉,協和村,809,1116,291,230,521,51,572
公投第１６案,彰化縣,社頭鄉,協和村,810,1061,290,231,521,56,577
公投第１６案,彰化縣,社頭鄉,泰安村,811,992,314,213,527,71,598
公投第１６案,彰化縣,社頭鄉,朝興村,812,1092,342,205,547,35,582
公投第１６案,彰化縣,社頭鄉,龍井村,813,828,273,184,457,48,505
公投第１６案,彰化縣,社頭鄉,湳雅村,814,787,210,155,365,59,424
公投第１６案,彰化縣,社頭鄉,湳雅村,815,719,197,126,323,25,348
公投第１６案,彰化縣,二水鄉,復興村,816,1028,307,219,526,82,608
公投第１６案,彰化縣,二水鄉,十五村,817,689,225,154,379,54,433
公投第１６案,彰化縣,二水鄉,合和村,818,871,232,164,396,76,472
公投第１６案,彰化縣,二水鄉,上豊村,819,953,281,182,463,99,562
公投第１６案,彰化縣,二水鄉,過圳村,820,624,161,123,284,55,339
公投第１６案,彰化縣,二水鄉,五伯村,821,645,207,162,369,57,426
公投第１６案,彰化縣,二水鄉,文化村,822,986,270,253,523,62,585
公投第１６案,彰化縣,二水鄉,光化村,823,943,321,229,550,72,622
公投第１６案,彰化縣,二水鄉,聖化村,824,455,139,120,259,10,269
公投第１６案,彰化縣,二水鄉,二水村,825,831,283,227,510,46,556
公投第１６案,彰化縣,二水鄉,惠民村,826,831,280,184,464,44,508
公投第１６案,彰化縣,二水鄉,裕民村,827,1013,310,223,533,27,560
公投第１６案,彰化縣,二水鄉,大園村,828,796,235,192,427,79,506
公投第１６案,彰化縣,二水鄉,修仁村,829,781,235,152,387,64,451
公投第１６案,彰化縣,二水鄉,合興村,830,692,171,149,320,29,349
公投第１６案,彰化縣,二水鄉,源泉村,831,635,198,142,340,30,370
公投第１６案,彰化縣,二水鄉,倡和村,832,566,200,78,278,49,327
公投第１６案,彰化縣,北斗鎮,中寮里,833,925,262,183,445,74,519
公投第１６案,彰化縣,北斗鎮,中寮里,834,869,266,204,470,59,529
公投第１６案,彰化縣,北斗鎮,中寮里,835,855,285,211,496,52,548
公投第１６案,彰化縣,北斗鎮,大道里,836,1065,382,235,617,57,674
公投第１６案,彰化縣,北斗鎮,大道里,837,828,230,195,425,81,506
公投第１６案,彰化縣,北斗鎮,西德里,838,1124,348,255,603,71,674
公投第１６案,彰化縣,北斗鎮,西德里,839,1096,379,245,624,57,681
公投第１６案,彰化縣,北斗鎮,西德里,840,1213,380,248,628,82,710
公投第１６案,彰化縣,北斗鎮,西德里,841,1164,329,244,573,72,645
公投第１６案,彰化縣,北斗鎮,西安里,842,730,214,155,369,41,410
公投第１６案,彰化縣,北斗鎮,西安里,843,878,291,162,453,39,492
公投第１６案,彰化縣,北斗鎮,光復里,844,833,269,194,463,46,509
公投第１６案,彰化縣,北斗鎮,光復里,845,957,290,227,517,50,567
公投第１６案,彰化縣,北斗鎮,新政里,846,783,250,151,401,38,439
公投第１６案,彰化縣,北斗鎮,重慶里,847,573,144,131,275,40,315
公投第１６案,彰化縣,北斗鎮,五權里,848,672,188,149,337,45,382
公投第１６案,彰化縣,北斗鎮,七星里,849,695,190,147,337,42,379
公投第１６案,彰化縣,北斗鎮,七星里,850,747,210,145,355,46,401
公投第１６案,彰化縣,北斗鎮,居仁里,851,643,237,149,386,27,413
公投第１６案,彰化縣,北斗鎮,居仁里,852,662,215,133,348,42,390
公投第１６案,彰化縣,北斗鎮,東光里,853,1085,378,230,608,83,691
公投第１６案,彰化縣,北斗鎮,東光里,854,1121,360,226,586,80,666
公投第１６案,彰化縣,北斗鎮,文昌里,855,830,272,195,467,42,509
公投第１６案,彰化縣,北斗鎮,文昌里,856,975,310,184,494,52,546
公投第１６案,彰化縣,北斗鎮,文昌里,857,1212,412,211,623,43,666
公投第１６案,彰化縣,北斗鎮,中和里,858,1302,426,270,696,84,780
公投第１６案,彰化縣,北斗鎮,新生里,859,1077,291,195,486,50,536
公投第１６案,彰化縣,北斗鎮,新生里,860,917,275,162,437,67,504
公投第１６案,彰化縣,北斗鎮,大新里,861,825,262,158,420,43,463
公投第１６案,彰化縣,北斗鎮,大新里,862,937,277,221,498,56,554
公投第１６案,彰化縣,田尾鄉,田尾村,863,1284,337,265,602,64,666
公投第１６案,彰化縣,田尾鄉,溪畔村,864,1187,365,279,644,83,727
公投第１６案,彰化縣,田尾鄉,打簾村,865,1033,322,234,556,56,612
公投第１６案,彰化縣,田尾鄉,打簾村,866,696,253,138,391,37,428
公投第１６案,彰化縣,田尾鄉,正義村,867,872,316,183,499,42,541
公投第１６案,彰化縣,田尾鄉,北曾村,868,680,207,123,330,32,362
公投第１６案,彰化縣,田尾鄉,北曾村,869,875,324,184,508,47,555
公投第１６案,彰化縣,田尾鄉,南曾村,870,1337,369,293,662,53,715
公投第１６案,彰化縣,田尾鄉,饒平村,871,1376,505,269,774,70,844
公投第１６案,彰化縣,田尾鄉,饒平村,872,1186,448,236,684,53,737
公投第１６案,彰化縣,田尾鄉,豐田村,873,874,332,208,540,66,606
公投第１６案,彰化縣,田尾鄉,仁里村,874,647,177,134,311,45,356
公投第１６案,彰化縣,田尾鄉,仁里村,875,959,296,217,513,57,570
公投第１６案,彰化縣,田尾鄉,新厝村,876,263,75,49,124,19,143
公投第１６案,彰化縣,田尾鄉,溪頂村,877,618,182,112,294,40,334
公投第１６案,彰化縣,田尾鄉,柳鳳村,878,938,330,220,550,30,580
公投第１６案,彰化縣,田尾鄉,陸豐村,879,880,332,172,504,57,561
公投第１６案,彰化縣,田尾鄉,海豐村,880,804,224,151,375,53,428
公投第１６案,彰化縣,田尾鄉,海豐村,881,592,186,116,302,26,328
公投第１６案,彰化縣,田尾鄉,睦宜村,882,1079,356,237,593,93,686
公投第１６案,彰化縣,田尾鄉,新生村,883,1336,408,298,706,76,782
公投第１６案,彰化縣,田尾鄉,北鎮村,884,1198,372,218,590,57,647
公投第１６案,彰化縣,田尾鄉,南鎮村,885,621,169,119,288,66,354
公投第１６案,彰化縣,田尾鄉,福田村,886,760,228,143,371,41,412
公投第１６案,彰化縣,田尾鄉,新興村,887,1084,366,257,623,80,703
公投第１６案,彰化縣,埤頭鄉,和豊村,888,1178,295,212,507,73,580
公投第１６案,彰化縣,埤頭鄉,和豊村,889,1290,379,248,627,65,692
公投第１６案,彰化縣,埤頭鄉,興農村,890,973,291,163,454,69,523
公投第１６案,彰化縣,埤頭鄉,興農村,891,783,206,172,378,41,419
公投第１６案,彰化縣,埤頭鄉,埤頭村,892,733,224,140,364,54,418
公投第１６案,彰化縣,埤頭鄉,埤頭村,893,899,279,158,437,84,521
公投第１６案,彰化縣,埤頭鄉,豊崙村,894,965,272,199,471,73,544
公投第１６案,彰化縣,埤頭鄉,豊崙村,895,1356,399,237,636,67,703
公投第１６案,彰化縣,埤頭鄉,崙子村,896,1265,370,230,600,89,689
公投第１６案,彰化縣,埤頭鄉,永豊村,897,877,288,178,466,70,536
公投第１６案,彰化縣,埤頭鄉,永豊村,898,705,213,121,334,48,382
公投第１６案,彰化縣,埤頭鄉,合興村,899,1062,360,217,577,61,638
公投第１６案,彰化縣,埤頭鄉,合興村,900,1300,446,223,669,72,741
公投第１６案,彰化縣,埤頭鄉,合興村,901,923,304,161,465,75,540
公投第１６案,彰化縣,埤頭鄉,平原村,902,1085,324,177,501,44,545
公投第１６案,彰化縣,埤頭鄉,平原村,903,1103,366,205,571,83,654
公投第１６案,彰化縣,埤頭鄉,崙腳村,904,735,195,139,334,41,375
公投第１６案,彰化縣,埤頭鄉,元埔村,905,574,178,101,279,37,316
公投第１６案,彰化縣,埤頭鄉,芙朝村,906,767,221,112,333,52,385
公投第１６案,彰化縣,埤頭鄉,芙朝村,907,737,223,139,362,45,407
公投第１６案,彰化縣,埤頭鄉,新庄村,908,1058,217,245,462,76,538
公投第１６案,彰化縣,埤頭鄉,陸嘉村,909,826,200,161,361,63,424
公投第１６案,彰化縣,埤頭鄉,竹圍村,910,1082,288,163,451,101,552
公投第１６案,彰化縣,埤頭鄉,中和村,911,737,229,163,392,55,447
公投第１６案,彰化縣,埤頭鄉,中和村,912,711,213,132,345,32,377
公投第１６案,彰化縣,埤頭鄉,庄內村,913,1043,283,230,513,83,596
公投第１６案,彰化縣,埤頭鄉,大湖村,914,910,241,167,408,30,438
公投第１６案,彰化縣,溪州鄉,溪厝村,915,778,223,158,381,51,432
公投第１６案,彰化縣,溪州鄉,溪厝村,916,1061,256,210,466,36,502
公投第１６案,彰化縣,溪州鄉,坑厝村,917,701,157,128,285,36,321
公投第１６案,彰化縣,溪州鄉,瓦厝村,918,879,263,210,473,59,532
公投第１６案,彰化縣,溪州鄉,溪州村,919,654,208,172,380,49,429
公投第１６案,彰化縣,溪州鄉,溪州村,920,878,259,194,453,42,495
公投第１６案,彰化縣,溪州鄉,尾厝村,921,942,297,226,523,57,580
公投第１６案,彰化縣,溪州鄉,尾厝村,922,871,266,172,438,41,479
公投第１６案,彰化縣,溪州鄉,東州村,923,1047,280,201,481,41,522
公投第１６案,彰化縣,溪州鄉,東州村,924,858,243,204,447,54,501
公投第１６案,彰化縣,溪州鄉,舊眉村,925,1409,332,232,564,87,651
公投第１６案,彰化縣,溪州鄉,圳寮村,926,792,214,131,345,35,380
公投第１６案,彰化縣,溪州鄉,圳寮村,927,714,167,152,319,66,385
公投第１６案,彰化縣,溪州鄉,西畔村,928,1109,274,192,466,73,539
公投第１６案,彰化縣,溪州鄉,西畔村,929,962,222,160,382,47,429
公投第１６案,彰化縣,溪州鄉,柑園村,930,1157,299,165,464,66,530
公投第１６案,彰化縣,溪州鄉,成功村,931,952,265,164,429,61,490
公投第１６案,彰化縣,溪州鄉,成功村,932,887,240,179,419,60,479
公投第１６案,彰化縣,溪州鄉,大庄村,933,866,192,134,326,54,380
公投第１６案,彰化縣,溪州鄉,大庄村,934,1010,241,178,419,63,482
公投第１６案,彰化縣,溪州鄉,榮光村,935,853,205,193,398,27,425
公投第１６案,彰化縣,溪州鄉,潮洋村,936,843,225,145,370,63,433
公投第１６案,彰化縣,溪州鄉,張厝村,937,711,138,91,229,17,246
公投第１６案,彰化縣,溪州鄉,菜公村,938,851,218,168,386,81,467
公投第１６案,彰化縣,溪州鄉,三條村,939,883,203,175,378,37,415
公投第１６案,彰化縣,溪州鄉,三圳村,940,1247,322,196,518,62,580
公投第１６案,彰化縣,溪州鄉,水尾村,941,1490,432,322,754,87,841
公投第１６案,彰化縣,二林鎮,豐田里,942,731,152,130,282,35,317
公投第１６案,彰化縣,二林鎮,豐田里,943,1025,334,195,529,59,588
公投第１６案,彰化縣,二林鎮,豐田里,944,784,241,184,425,27,452
公投第１６案,彰化縣,二林鎮,東和里,945,892,288,186,474,44,518
公投第１６案,彰化縣,二林鎮,東和里,946,1256,340,293,633,83,716
公投第１６案,彰化縣,二林鎮,南光里,947,1043,315,202,517,53,570
公投第１６案,彰化縣,二林鎮,南光里,948,1076,356,242,598,48,646
公投第１６案,彰化縣,二林鎮,南光里,949,1082,342,228,570,71,641
公投第１６案,彰化縣,二林鎮,西平里,950,1427,406,281,687,76,763
公投第１６案,彰化縣,二林鎮,北平里,951,1030,253,201,454,84,538
公投第１６案,彰化縣,二林鎮,北平里,952,1033,275,198,473,67,540
公投第１６案,彰化縣,二林鎮,北平里,953,977,290,201,491,58,549
公投第１６案,彰化縣,二林鎮,中西里,954,683,183,139,322,28,350
公投第１６案,彰化縣,二林鎮,中西里,955,975,246,163,409,97,506
公投第１６案,彰化縣,二林鎮,廣興里,956,1336,305,202,507,94,601
公投第１６案,彰化縣,二林鎮,香田里,957,1019,243,163,406,77,483
公投第１６案,彰化縣,二林鎮,外竹里,958,1003,228,150,378,62,440
公投第１６案,彰化縣,二林鎮,興華里,959,1151,357,211,568,84,652
公投第１６案,彰化縣,二林鎮,東興里,960,1598,469,320,789,120,909
公投第１６案,彰化縣,二林鎮,後厝里,961,1488,446,284,730,69,799
公投第１６案,彰化縣,二林鎮,後厝里,962,1771,582,356,938,68,1006
公投第１６案,彰化縣,二林鎮,頂厝里,963,1360,323,206,529,55,584
公投第１６案,彰化縣,二林鎮,趙甲里,964,1613,401,282,683,81,764
公投第１６案,彰化縣,二林鎮,振興里,965,1228,326,214,540,93,633
公投第１６案,彰化縣,二林鎮,萬興里,966,771,252,151,403,33,436
公投第１６案,彰化縣,二林鎮,永興里,967,858,268,197,465,42,507
公投第１６案,彰化縣,二林鎮,永興里,968,661,180,102,282,2,284
公投第１６案,彰化縣,二林鎮,西庄里,969,1268,336,185,521,107,628
公投第１６案,彰化縣,二林鎮,梅芳里,970,1081,293,186,479,40,519
公投第１６案,彰化縣,二林鎮,華崙里,971,1213,318,215,533,60,593
公投第１６案,彰化縣,二林鎮,華崙里,972,1328,416,247,663,80,743
公投第１６案,彰化縣,二林鎮,華崙里,973,1118,272,177,449,85,534
公投第１６案,彰化縣,二林鎮,萬合里,974,1157,258,206,464,67,531
公投第１６案,彰化縣,二林鎮,東勢里,975,972,249,184,433,44,477
公投第１６案,彰化縣,二林鎮,大永里,976,902,284,155,439,45,484
公投第１６案,彰化縣,二林鎮,原斗里,977,1273,397,323,720,73,793
公投第１６案,彰化縣,二林鎮,西斗里,978,1087,220,291,511,45,556
公投第１６案,彰化縣,二林鎮,東華里,979,987,288,204,492,85,577
公投第１６案,彰化縣,二林鎮,復豐里,980,719,148,133,281,29,310
公投第１６案,彰化縣,大城鄉,山腳村,981,1288,232,135,367,31,398
公投第１６案,彰化縣,大城鄉,潭墘村,982,1104,214,128,342,84,426
公投第１６案,彰化縣,大城鄉,大城村,983,964,290,162,452,85,537
公投第１６案,彰化縣,大城鄉,東城村,984,1312,341,202,543,67,610
公投第１６案,彰化縣,大城鄉,西城村,985,853,173,118,291,75,366
公投第１６案,彰化縣,大城鄉,上山村,986,518,105,54,159,24,183
公投第１６案,彰化縣,大城鄉,上山村,987,574,113,97,210,39,249
公投第１６案,彰化縣,大城鄉,永和村,988,702,122,109,231,37,268
公投第１６案,彰化縣,大城鄉,公館村,989,376,57,41,98,18,116
公投第１６案,彰化縣,大城鄉,公館村,990,693,111,78,189,25,214
公投第１６案,彰化縣,大城鄉,豐美村,991,877,202,128,330,52,382
公投第１６案,彰化縣,大城鄉,三豐村,992,655,99,76,175,13,188
公投第１６案,彰化縣,大城鄉,菜寮村,993,1103,218,146,364,45,409
公投第１６案,彰化縣,大城鄉,東港村,994,1192,224,136,360,50,410
公投第１６案,彰化縣,大城鄉,西港村,995,917,188,132,320,41,361
公投第１６案,彰化縣,大城鄉,頂庄村,996,686,126,66,192,32,224
公投第１６案,彰化縣,大城鄉,臺西村,997,899,161,91,252,30,282
公投第１６案,彰化縣,芳苑鄉,芳苑村,998,940,167,105,272,60,332
公投第１６案,彰化縣,芳苑鄉,芳中村,999,403,70,53,123,30,153
公投第１６案,彰化縣,芳苑鄉,仁愛村,1000,756,194,136,330,43,373
公投第１６案,彰化縣,芳苑鄉,信義村,1001,548,88,60,148,30,178
公投第１６案,彰化縣,芳苑鄉,後寮村,1002,997,293,156,449,66,515
公投第１６案,彰化縣,芳苑鄉,三合村,1003,1300,282,216,498,88,586
公投第１６案,彰化縣,芳苑鄉,三合村,1004,859,217,174,391,51,442
公投第１６案,彰化縣,芳苑鄉,永興村,1005,734,205,116,321,25,346
公投第１６案,彰化縣,芳苑鄉,永興村,1006,636,185,87,272,32,304
公投第１６案,彰化縣,芳苑鄉,新街村,1007,808,173,130,303,72,375
公投第１６案,彰化縣,芳苑鄉,路上村,1008,668,144,98,242,53,295
公投第１６案,彰化縣,芳苑鄉,路平村,1009,744,212,125,337,40,377
公投第１６案,彰化縣,芳苑鄉,三成村,1010,1026,234,146,380,106,486
公投第１６案,彰化縣,芳苑鄉,福榮村,1011,586,131,79,210,10,220
公投第１６案,彰化縣,芳苑鄉,頂廍村,1012,593,168,119,287,27,314
公投第１６案,彰化縣,芳苑鄉,王功村,1013,1071,237,221,458,126,584
公投第１６案,彰化縣,芳苑鄉,王功村,1014,1060,272,191,463,96,559
公投第１６案,彰化縣,芳苑鄉,博愛村,1015,708,173,115,288,31,319
公投第１６案,彰化縣,芳苑鄉,和平村,1016,735,162,112,274,74,348
公投第１６案,彰化縣,芳苑鄉,興仁村,1017,571,163,107,270,61,331
公投第１６案,彰化縣,芳苑鄉,興仁村,1018,729,180,88,268,41,309
公投第１６案,彰化縣,芳苑鄉,民生村,1019,674,169,101,270,76,346
公投第１６案,彰化縣,芳苑鄉,新寶村,1020,846,218,153,371,60,431
公投第１６案,彰化縣,芳苑鄉,新寶村,1021,806,266,148,414,52,466
公投第１６案,彰化縣,芳苑鄉,五俊村,1022,470,87,64,151,16,167
公投第１６案,彰化縣,芳苑鄉,草湖村,1023,1124,352,206,558,63,621
公投第１６案,彰化縣,芳苑鄉,草湖村,1024,317,82,43,125,27,152
公投第１６案,彰化縣,芳苑鄉,建平村,1025,1158,242,184,426,71,497
公投第１６案,彰化縣,芳苑鄉,建平村,1026,967,250,157,407,29,436
公投第１６案,彰化縣,芳苑鄉,崙腳村,1027,762,187,155,342,55,397
公投第１６案,彰化縣,芳苑鄉,文津村,1028,1086,268,162,430,47,477
公投第１６案,彰化縣,芳苑鄉,新生村,1029,747,203,135,338,30,368
公投第１６案,彰化縣,芳苑鄉,新生村,1030,653,162,78,240,26,266
公投第１６案,彰化縣,芳苑鄉,漢寶村,1031,872,257,190,447,67,514
公投第１６案,彰化縣,芳苑鄉,漢寶村,1032,1235,397,278,675,70,745
公投第１６案,彰化縣,芳苑鄉,漢寶村,1033,1102,307,210,517,74,591
公投第１６案,彰化縣,竹塘鄉,竹元村,1034,1168,367,227,594,75,669
公投第１６案,彰化縣,竹塘鄉,竹塘村,1035,965,296,212,508,38,546
公投第１６案,彰化縣,竹塘鄉,竹塘村,1036,960,312,221,533,62,595
公投第１６案,彰化縣,竹塘鄉,小西村,1037,743,232,185,417,66,483
公投第１６案,彰化縣,竹塘鄉,民靖村,1038,751,174,121,295,44,339
公投第１６案,彰化縣,竹塘鄉,五庄村,1039,792,190,132,322,52,374
公投第１６案,彰化縣,竹塘鄉,五庄村,1040,733,171,113,284,22,306
公投第１６案,彰化縣,竹塘鄉,樹腳村,1041,657,188,110,298,49,347
公投第１６案,彰化縣,竹塘鄉,田頭村,1042,1063,307,170,477,55,532
公投第１６案,彰化縣,竹塘鄉,新廣村,1043,1114,338,206,544,91,635
公投第１６案,彰化縣,竹塘鄉,溪墘村,1044,506,154,119,273,67,340
公投第１６案,彰化縣,竹塘鄉,竹林村,1045,823,206,161,367,53,420
公投第１６案,彰化縣,竹塘鄉,土庫村,1046,654,184,101,285,51,336
公投第１６案,彰化縣,竹塘鄉,內新村,1047,577,134,82,216,32,248
公投第１６案,彰化縣,竹塘鄉,長安村,1048,772,219,127,346,62,408
公投第１６案,彰化縣,竹塘鄉,永安村,1049,543,125,73,198,51,249
公投第１６案,南投縣,南投市,龍泉里,1,927,316,208,524,28,552
公投第１６案,南投縣,南投市,康壽里,2,667,241,179,420,34,454
公投第１６案,南投縣,南投市,康壽里,3,773,271,182,453,41,494
公投第１６案,南投縣,南投市,三民里,4,818,282,193,475,41,516
公投第１６案,南投縣,南投市,仁和里,5,525,194,134,328,28,356
公投第１６案,南投縣,南投市,南投里,6,575,206,137,343,41,384
公投第１６案,南投縣,南投市,彰仁里,7,368,150,83,233,21,254
公投第１６案,南投縣,南投市,崇文里,8,956,366,217,583,55,638
公投第１６案,南投縣,南投市,三興里,9,1245,396,230,626,28,654
公投第１６案,南投縣,南投市,三興里,10,1484,512,304,816,40,856
公投第１６案,南投縣,南投市,三興里,11,1191,477,246,723,57,780
公投第１６案,南投縣,南投市,三興里,12,1506,547,314,861,59,920
公投第１６案,南投縣,南投市,三和里,13,1070,375,256,631,44,675
公投第１６案,南投縣,南投市,三和里,14,670,266,126,392,30,422
公投第１６案,南投縣,南投市,三和里,15,1050,424,218,642,53,695
公投第１６案,南投縣,南投市,嘉興里,16,1122,349,210,559,50,609
公投第１６案,南投縣,南投市,嘉興里,17,984,313,200,513,43,556
公投第１６案,南投縣,南投市,嘉和里,18,1062,429,221,650,32,682
公投第１６案,南投縣,南投市,嘉和里,19,1053,363,215,578,71,649
公投第１６案,南投縣,南投市,嘉和里,20,1104,394,262,656,46,702
公投第１６案,南投縣,南投市,嘉和里,21,1192,388,255,643,48,691
公投第１６案,南投縣,南投市,平和里,22,960,310,206,516,37,553
公投第１６案,南投縣,南投市,平和里,23,906,315,202,517,40,557
公投第１６案,南投縣,南投市,平和里,24,957,328,212,540,53,593
公投第１６案,南投縣,南投市,平和里,25,997,347,240,587,65,652
公投第１６案,南投縣,南投市,平和里,26,1008,365,213,578,49,627
公投第１６案,南投縣,南投市,平和里,27,1164,388,262,650,37,687
公投第１６案,南投縣,南投市,振興里,28,587,193,118,311,41,352
公投第１６案,南投縣,南投市,振興里,29,734,227,137,364,41,405
公投第１６案,南投縣,南投市,振興里,30,724,234,143,377,47,424
公投第１６案,南投縣,南投市,千秋里,31,1003,396,169,565,38,603
公投第１６案,南投縣,南投市,軍功里,32,1356,459,278,737,51,788
公投第１６案,南投縣,南投市,軍功里,33,1373,446,244,690,60,750
公投第１６案,南投縣,南投市,軍功里,34,1452,496,279,775,42,817
公投第１６案,南投縣,南投市,軍功里,35,362,118,68,186,13,199
公投第１６案,南投縣,南投市,東山里,36,389,124,84,208,28,236
公投第１６案,南投縣,南投市,營南里,37,1276,469,297,766,64,830
公投第１６案,南投縣,南投市,營南里,38,1089,379,275,654,60,714
公投第１６案,南投縣,南投市,營北里,39,921,341,204,545,48,593
公投第１６案,南投縣,南投市,營北里,40,892,383,208,591,32,623
公投第１６案,南投縣,南投市,營北里,41,1050,450,209,659,37,696
公投第１６案,南投縣,南投市,營北里,42,1078,429,227,656,33,689
公投第１６案,南投縣,南投市,營北里,43,1078,449,195,644,24,668
公投第１６案,南投縣,南投市,營北里,44,861,386,208,594,29,623
公投第１６案,南投縣,南投市,內興里,45,1221,381,261,642,86,728
公投第１６案,南投縣,南投市,內興里,46,1105,397,227,624,34,658
公投第１６案,南投縣,南投市,內興里,47,1230,455,273,728,27,755
公投第１６案,南投縣,南投市,內興里,48,1092,400,230,630,45,675
公投第１６案,南投縣,南投市,內興里,49,1286,542,261,803,20,823
公投第１６案,南投縣,南投市,內興里,50,655,252,154,406,48,454
公投第１６案,南投縣,南投市,內新里,51,719,269,167,436,33,469
公投第１６案,南投縣,南投市,內新里,52,720,248,136,384,33,417
公投第１６案,南投縣,南投市,光輝里,53,509,201,122,323,21,344
公投第１６案,南投縣,南投市,光榮里,54,492,178,83,261,19,280
公投第１６案,南投縣,南投市,光榮里,55,616,266,91,357,25,382
公投第１６案,南投縣,南投市,光明里,56,1010,420,182,602,40,642
公投第１６案,南投縣,南投市,光華里,57,848,350,132,482,24,506
公投第１６案,南投縣,南投市,漳興里,58,1387,524,291,815,76,891
公投第１６案,南投縣,南投市,漳興里,59,1245,485,273,758,47,805
公投第１６案,南投縣,南投市,漳和里,60,1199,404,260,664,34,698
公投第１６案,南投縣,南投市,漳和里,61,1288,451,284,735,51,786
公投第１６案,南投縣,南投市,漳和里,62,1040,331,231,562,59,621
公投第１６案,南投縣,南投市,漳和里,63,1070,372,234,606,57,663
公投第１６案,南投縣,南投市,漳和里,64,1299,490,275,765,51,816
公投第１６案,南投縣,南投市,漳和里,65,1122,361,411,772,47,819
公投第１６案,南投縣,南投市,平山里,66,1414,490,293,783,60,843
公投第１６案,南投縣,南投市,平山里,67,1121,367,245,612,51,663
公投第１６案,南投縣,南投市,平山里,68,1434,467,310,777,40,817
公投第１６案,南投縣,南投市,平山里,69,1393,466,249,715,58,773
公投第１６案,南投縣,南投市,新興里,70,1059,371,200,571,28,599
公投第１６案,南投縣,南投市,新興里,71,1218,397,262,659,43,702
公投第１６案,南投縣,南投市,新興里,72,1293,405,242,647,25,672
公投第１６案,南投縣,南投市,新興里,73,1337,364,266,630,43,673
公投第１６案,南投縣,南投市,永豐里,74,876,308,216,524,32,556
公投第１６案,南投縣,南投市,永豐里,75,971,322,209,531,32,563
公投第１６案,南投縣,南投市,永豐里,76,1012,325,235,560,33,593
公投第１６案,南投縣,南投市,福興里,77,973,314,179,493,46,539
公投第１６案,南投縣,南投市,福興里,78,1002,363,210,573,52,625
公投第１６案,南投縣,南投市,福興里,79,1024,323,232,555,56,611
公投第１６案,南投縣,南投市,鳳山里,80,1122,288,199,487,105,592
公投第１６案,南投縣,南投市,永興里,81,790,214,133,347,50,397
公投第１６案,南投縣,南投市,鳳鳴里,82,647,156,104,260,22,282
公投第１６案,南投縣,南投市,福山里,83,950,300,170,470,67,537
公投第１６案,南投縣,南投市,福山里,84,980,287,185,472,33,505
公投第１６案,南投縣,埔里鎮,東門里,85,828,273,182,455,47,502
公投第１６案,南投縣,埔里鎮,東門里,86,786,275,162,437,54,491
公投第１６案,南投縣,埔里鎮,東門里,87,1062,351,207,558,51,609
公投第１６案,南投縣,埔里鎮,杷城里,88,1201,421,239,660,89,749
公投第１６案,南投縣,埔里鎮,杷城里,89,1415,448,283,731,37,768
公投第１６案,南投縣,埔里鎮,枇杷里,90,1282,429,242,671,38,709
公投第１６案,南投縣,埔里鎮,枇杷里,91,859,270,172,442,57,499
公投第１６案,南投縣,埔里鎮,枇杷里,92,1288,405,247,652,93,745
公投第１６案,南投縣,埔里鎮,枇杷里,93,1330,430,289,719,41,760
公投第１６案,南投縣,埔里鎮,枇杷里,94,1416,435,270,705,62,767
公投第１６案,南投縣,埔里鎮,枇杷里,95,1283,353,242,595,54,649
公投第１６案,南投縣,埔里鎮,水頭里,96,1151,339,261,600,101,701
公投第１６案,南投縣,埔里鎮,水頭里,97,1193,339,256,595,39,634
公投第１６案,南投縣,埔里鎮,水頭里,98,1471,482,266,748,86,834
公投第１６案,南投縣,埔里鎮,麒麟里,99,1044,238,189,427,106,533
公投第１６案,南投縣,埔里鎮,珠格里,100,1122,346,242,588,78,666
公投第１６案,南投縣,埔里鎮,溪南里,101,1129,417,246,663,63,726
公投第１６案,南投縣,埔里鎮,西門里,102,901,283,175,458,27,485
公投第１６案,南投縣,埔里鎮,西門里,103,997,306,188,494,47,541
公投第１６案,南投縣,埔里鎮,西門里,104,1209,294,236,530,45,575
公投第１６案,南投縣,埔里鎮,南門里,105,838,304,219,523,30,553
公投第１６案,南投縣,埔里鎮,北門里,106,1226,339,210,549,63,612
公投第１６案,南投縣,埔里鎮,北門里,107,1263,414,284,698,87,785
公投第１６案,南投縣,埔里鎮,北安里,108,1045,390,216,606,33,639
公投第１６案,南投縣,埔里鎮,北安里,109,1120,400,220,620,60,680
公投第１６案,南投縣,埔里鎮,北安里,110,1062,387,253,640,51,691
公投第１６案,南投縣,埔里鎮,北梅里,111,1022,352,196,548,41,589
公投第１６案,南投縣,埔里鎮,北梅里,112,1051,370,195,565,34,599
公投第１６案,南投縣,埔里鎮,北梅里,113,1106,350,233,583,41,624
公投第１６案,南投縣,埔里鎮,泰安里,114,1098,364,204,568,33,601
公投第１６案,南投縣,埔里鎮,泰安里,115,1067,366,217,583,53,636
公投第１６案,南投縣,埔里鎮,大湳里,116,725,161,216,377,52,429
公投第１６案,南投縣,埔里鎮,大湳里,117,905,343,162,505,33,538
公投第１６案,南投縣,埔里鎮,蜈蚣里,118,1179,363,212,575,69,644
公投第１６案,南投縣,埔里鎮,蜈蚣里,119,944,262,187,449,44,493
公投第１６案,南投縣,埔里鎮,蜈蚣里,120,465,142,91,233,36,269
公投第１６案,南投縣,埔里鎮,同聲里,121,1133,362,220,582,58,640
公投第１６案,南投縣,埔里鎮,同聲里,122,1100,330,194,524,55,579
公投第１６案,南投縣,埔里鎮,清新里,123,1155,385,233,618,58,676
公投第１６案,南投縣,埔里鎮,清新里,124,1254,358,247,605,67,672
公投第１６案,南投縣,埔里鎮,清新里,125,1296,404,221,625,74,699
公投第１６案,南投縣,埔里鎮,薰化里,126,1023,371,247,618,46,664
公投第１６案,南投縣,埔里鎮,大城里,127,964,284,163,447,20,467
公投第１６案,南投縣,埔里鎮,大城里,128,986,323,199,522,48,570
公投第１６案,南投縣,埔里鎮,大城里,129,1016,367,210,577,40,617
公投第１６案,南投縣,埔里鎮,大城里,130,898,290,192,482,54,536
公投第１６案,南投縣,埔里鎮,大城里,131,980,343,211,554,44,598
公投第１６案,南投縣,埔里鎮,大城里,132,933,337,199,536,31,567
公投第１６案,南投縣,埔里鎮,籃城里,133,929,387,208,595,59,654
公投第１６案,南投縣,埔里鎮,桃米里,134,1032,285,202,487,102,589
公投第１６案,南投縣,埔里鎮,成功里,135,315,104,41,145,5,150
公投第１６案,南投縣,埔里鎮,南村里,136,1363,370,268,638,84,722
公投第１６案,南投縣,埔里鎮,愛蘭里,137,725,242,161,403,36,439
公投第１６案,南投縣,埔里鎮,愛蘭里,138,705,212,184,396,32,428
公投第１６案,南投縣,埔里鎮,鐵山里,139,751,285,171,456,33,489
公投第１６案,南投縣,埔里鎮,鐵山里,140,932,317,172,489,45,534
公投第１６案,南投縣,埔里鎮,房里里,141,956,306,224,530,39,569
公投第１６案,南投縣,埔里鎮,房里里,142,376,125,66,191,17,208
公投第１６案,南投縣,埔里鎮,向善里,143,682,205,167,372,36,408
公投第１６案,南投縣,埔里鎮,一新里,144,990,485,100,585,59,644
公投第１６案,南投縣,埔里鎮,合成里,145,1324,318,238,556,116,672
公投第１６案,南投縣,埔里鎮,合成里,146,298,66,63,129,17,146
公投第１６案,南投縣,埔里鎮,廣成里,147,1170,390,186,576,81,657
公投第１６案,南投縣,埔里鎮,史港里,148,604,217,114,331,22,353
公投第１６案,南投縣,埔里鎮,福興里,149,999,298,209,507,47,554
公投第１６案,南投縣,埔里鎮,牛眠里,150,923,267,145,412,38,450
公投第１６案,南投縣,埔里鎮,牛眠里,151,887,314,185,499,39,538
公投第１６案,南投縣,埔里鎮,牛眠里,152,981,297,191,488,31,519
公投第１６案,南投縣,草屯鎮,玉峰里,153,998,407,169,576,35,611
公投第１６案,南投縣,草屯鎮,玉峰里,154,1127,363,229,592,36,628
公投第１６案,南投縣,草屯鎮,明正里,155,1401,439,276,715,29,744
公投第１６案,南投縣,草屯鎮,明正里,156,1110,343,237,580,34,614
公投第１６案,南投縣,草屯鎮,明正里,157,1285,457,264,721,51,772
公投第１６案,南投縣,草屯鎮,炎峰里,158,936,320,175,495,38,533
公投第１６案,南投縣,草屯鎮,炎峰里,159,1141,354,261,615,53,668
公投第１６案,南投縣,草屯鎮,中正里,160,705,264,152,416,29,445
公投第１６案,南投縣,草屯鎮,和平里,161,1121,374,279,653,31,684
公投第１６案,南投縣,草屯鎮,中山里,162,877,347,204,551,31,582
公投第１６案,南投縣,草屯鎮,中山里,163,1401,484,276,760,64,824
公投第１６案,南投縣,草屯鎮,敦和里,164,1267,396,248,644,53,697
公投第１６案,南投縣,草屯鎮,敦和里,165,1214,429,208,637,84,721
公投第１６案,南投縣,草屯鎮,敦和里,166,1259,419,278,697,49,746
公投第１６案,南投縣,草屯鎮,敦和里,167,1442,515,309,824,47,871
公投第１６案,南投縣,草屯鎮,敦和里,168,1273,406,313,719,42,761
公投第１６案,南投縣,草屯鎮,山腳里,169,1145,408,197,605,47,652
公投第１６案,南投縣,草屯鎮,山腳里,170,1279,454,223,677,38,715
公投第１６案,南投縣,草屯鎮,山腳里,171,1158,383,220,603,43,646
公投第１６案,南投縣,草屯鎮,山腳里,172,1335,530,288,818,64,882
公投第１６案,南投縣,草屯鎮,山腳里,173,1178,402,312,714,50,764
公投第１６案,南投縣,草屯鎮,山腳里,174,1327,458,277,735,47,782
公投第１６案,南投縣,草屯鎮,新厝里,175,1000,374,198,572,26,598
公投第１６案,南投縣,草屯鎮,新厝里,176,1257,480,203,683,36,719
公投第１６案,南投縣,草屯鎮,新厝里,177,883,319,193,512,36,548
公投第１６案,南投縣,草屯鎮,上林里,178,1121,341,241,582,37,619
公投第１６案,南投縣,草屯鎮,上林里,179,1043,367,214,581,41,622
公投第１６案,南投縣,草屯鎮,上林里,180,979,357,219,576,30,606
公投第１６案,南投縣,草屯鎮,碧峰里,181,1048,296,202,498,28,526
公投第１６案,南投縣,草屯鎮,碧峰里,182,1009,312,227,539,41,580
公投第１６案,南投縣,草屯鎮,碧峰里,183,1138,368,203,571,34,605
公投第１６案,南投縣,草屯鎮,碧峰里,184,1197,372,252,624,40,664
公投第１６案,南投縣,草屯鎮,碧洲里,185,1364,469,300,769,40,809
公投第１６案,南投縣,草屯鎮,碧洲里,186,1059,390,212,602,48,650
公投第１６案,南投縣,草屯鎮,復興里,187,1108,369,240,609,50,659
公投第１６案,南投縣,草屯鎮,復興里,188,879,308,154,462,43,505
公投第１６案,南投縣,草屯鎮,復興里,189,957,315,186,501,62,563
公投第１６案,南投縣,草屯鎮,御史里,190,1395,391,231,622,39,661
公投第１６案,南投縣,草屯鎮,御史里,191,1101,405,238,643,41,684
公投第１６案,南投縣,草屯鎮,御史里,192,1297,402,260,662,41,703
公投第１６案,南投縣,草屯鎮,御史里,193,877,206,162,368,31,399
公投第１６案,南投縣,草屯鎮,御史里,194,1376,374,229,603,79,682
公投第１６案,南投縣,草屯鎮,新豐里,195,1008,359,244,603,58,661
公投第１６案,南投縣,草屯鎮,新豐里,196,1080,374,235,609,56,665
公投第１６案,南投縣,草屯鎮,新豐里,197,1017,329,190,519,41,560
公投第１６案,南投縣,草屯鎮,新豐里,198,961,341,232,573,40,613
公投第１６案,南投縣,草屯鎮,新庄里,199,1160,406,252,658,51,709
公投第１６案,南投縣,草屯鎮,新庄里,200,1121,371,234,605,43,648
公投第１６案,南投縣,草屯鎮,新庄里,201,1243,396,270,666,45,711
公投第１６案,南投縣,草屯鎮,加老里,202,932,321,195,516,39,555
公投第１６案,南投縣,草屯鎮,加老里,203,1323,497,285,782,76,858
公投第１６案,南投縣,草屯鎮,石川里,204,1518,448,287,735,51,786
公投第１６案,南投縣,草屯鎮,北投里,205,923,318,203,521,52,573
公投第１６案,南投縣,草屯鎮,北投里,206,970,286,194,480,51,531
公投第１６案,南投縣,草屯鎮,北投里,207,1026,332,205,537,36,573
公投第１６案,南投縣,草屯鎮,富寮里,208,1466,440,311,751,73,824
公投第１６案,南投縣,草屯鎮,富寮里,209,1180,392,243,635,42,677
公投第１６案,南投縣,草屯鎮,富寮里,210,1006,350,222,572,42,614
公投第１６案,南投縣,草屯鎮,富寮里,211,1000,291,177,468,39,507
公投第１６案,南投縣,草屯鎮,富寮里,212,1128,293,351,644,42,686
公投第１６案,南投縣,草屯鎮,富寮里,213,623,206,122,328,13,341
公投第１６案,南投縣,草屯鎮,北勢里,214,707,195,162,357,63,420
公投第１６案,南投縣,草屯鎮,北勢里,215,719,214,133,347,40,387
公投第１６案,南投縣,草屯鎮,北勢里,216,527,147,85,232,27,259
公投第１６案,南投縣,草屯鎮,中原里,217,1183,382,258,640,65,705
公投第１６案,南投縣,草屯鎮,中原里,218,869,322,172,494,40,534
公投第１６案,南投縣,草屯鎮,南埔里,219,1132,315,230,545,16,561
公投第１６案,南投縣,草屯鎮,南埔里,220,949,292,223,515,54,569
公投第１６案,南投縣,草屯鎮,南埔里,221,965,333,217,550,40,590
公投第１６案,南投縣,草屯鎮,南埔里,222,1068,335,204,539,34,573
公投第１６案,南投縣,草屯鎮,坪頂里,223,1024,354,216,570,58,628
公投第１６案,南投縣,草屯鎮,土城里,224,642,205,116,321,31,352
公投第１６案,南投縣,草屯鎮,土城里,225,1017,305,195,500,41,541
公投第１６案,南投縣,草屯鎮,平林里,226,1092,384,203,587,38,625
公投第１６案,南投縣,草屯鎮,雙冬里,227,1170,378,208,586,68,654
公投第１６案,南投縣,草屯鎮,雙冬里,228,1106,371,237,608,62,670
公投第１６案,南投縣,竹山鎮,竹山里,229,1170,421,222,643,62,705
公投第１６案,南投縣,竹山鎮,竹山里,230,850,290,178,468,62,530
公投第１６案,南投縣,竹山鎮,中正里,231,621,189,120,309,33,342
公投第１６案,南投縣,竹山鎮,中山里,232,905,292,177,469,36,505
公投第１６案,南投縣,竹山鎮,中山里,233,1099,320,178,498,59,557
公投第１６案,南投縣,竹山鎮,中山里,234,1214,359,222,581,56,637
公投第１６案,南投縣,竹山鎮,中山里,235,1287,451,258,709,69,778
公投第１６案,南投縣,竹山鎮,雲林里,236,1191,398,215,613,62,675
公投第１６案,南投縣,竹山鎮,雲林里,237,1118,335,223,558,77,635
公投第１６案,南投縣,竹山鎮,雲林里,238,1278,397,287,684,44,728
公投第１６案,南投縣,竹山鎮,竹圍里,239,1153,359,249,608,64,672
公投第１６案,南投縣,竹山鎮,竹圍里,240,1243,366,221,587,76,663
公投第１６案,南投縣,竹山鎮,桂林里,241,1308,448,228,676,57,733
公投第１６案,南投縣,竹山鎮,桂林里,242,1358,418,243,661,51,712
公投第１６案,南投縣,竹山鎮,桂林里,243,1044,319,203,522,54,576
公投第１６案,南投縣,竹山鎮,下坪里,244,511,181,110,291,30,321
公投第１６案,南投縣,竹山鎮,下坪里,245,682,215,136,351,15,366
公投第１６案,南投縣,竹山鎮,中和里,246,989,282,169,451,27,478
公投第１６案,南投縣,竹山鎮,中崎里,247,1378,437,263,700,53,753
公投第１６案,南投縣,竹山鎮,秀林里,248,217,60,43,103,8,111
公投第１６案,南投縣,竹山鎮,秀林里,249,479,149,103,252,36,288
公投第１６案,南投縣,竹山鎮,大鞍里,250,430,114,67,181,17,198
公投第１６案,南投縣,竹山鎮,延和里,251,1437,453,292,745,65,810
公投第１６案,南投縣,竹山鎮,延和里,252,1286,443,281,724,50,774
公投第１６案,南投縣,竹山鎮,延和里,253,1080,391,201,592,63,655
公投第１６案,南投縣,竹山鎮,延和里,254,1070,350,196,546,49,595
公投第１６案,南投縣,竹山鎮,延祥里,255,1295,417,270,687,58,745
公投第１６案,南投縣,竹山鎮,延祥里,256,1047,356,186,542,50,592
公投第１６案,南投縣,竹山鎮,延祥里,257,1300,405,257,662,59,721
公投第１６案,南投縣,竹山鎮,延正里,258,908,247,144,391,36,427
公投第１６案,南投縣,竹山鎮,延正里,259,821,209,156,365,55,420
公投第１６案,南投縣,竹山鎮,延平里,260,1320,427,273,700,65,765
公投第１６案,南投縣,竹山鎮,延平里,261,967,281,178,459,30,489
公投第１６案,南投縣,竹山鎮,延平里,262,595,145,106,251,44,295
公投第１６案,南投縣,竹山鎮,延山里,263,859,239,163,402,74,476
公投第１６案,南投縣,竹山鎮,山崇里,264,1196,359,219,578,67,645
公投第１６案,南投縣,竹山鎮,山崇里,265,649,218,108,326,43,369
公投第１６案,南投縣,竹山鎮,社寮里,266,1341,383,292,675,74,749
公投第１６案,南投縣,竹山鎮,中央里,267,1222,344,198,542,80,622
公投第１６案,南投縣,竹山鎮,富州里,268,602,203,117,320,28,348
公投第１６案,南投縣,竹山鎮,田子里,269,617,192,124,316,29,345
公投第１６案,南投縣,竹山鎮,硘磘里,270,793,269,174,443,51,494
公投第１６案,南投縣,竹山鎮,硘磘里,271,922,298,185,483,19,502
公投第１６案,南投縣,竹山鎮,德興里,272,366,115,61,176,18,194
公投第１６案,南投縣,竹山鎮,德興里,273,509,151,61,212,16,228
公投第１６案,南投縣,竹山鎮,福興里,274,193,59,34,93,13,106
公投第１６案,南投縣,竹山鎮,福興里,275,406,148,82,230,21,251
公投第１６案,南投縣,竹山鎮,鯉魚里,276,495,130,93,223,29,252
公投第１６案,南投縣,竹山鎮,鯉魚里,277,307,64,33,97,11,108
公投第１６案,南投縣,竹山鎮,坪頂里,278,440,115,75,190,44,234
公投第１６案,南投縣,竹山鎮,瑞竹里,279,577,178,89,267,46,313
公投第１６案,南投縣,竹山鎮,桶頭里,280,486,95,84,179,33,212
公投第１６案,南投縣,竹山鎮,桶頭里,281,403,82,50,132,16,148
公投第１６案,南投縣,集集鎮,集集里,282,1070,356,242,598,50,648
公投第１６案,南投縣,集集鎮,和平里,283,918,349,172,521,38,559
公投第１６案,南投縣,集集鎮,林尾里,284,581,203,114,317,34,351
公投第１６案,南投縣,集集鎮,田寮里,285,1194,422,231,653,61,714
公投第１６案,南投縣,集集鎮,隘寮里,286,488,119,73,192,28,220
公投第１６案,南投縣,集集鎮,玉映里,287,504,175,96,271,43,314
公投第１６案,南投縣,集集鎮,吳厝里,288,910,247,184,431,132,563
公投第１６案,南投縣,集集鎮,八張里,289,773,277,162,439,43,482
公投第１６案,南投縣,集集鎮,八張里,290,709,217,150,367,36,403
公投第１６案,南投縣,集集鎮,永昌里,291,960,340,164,504,30,534
公投第１６案,南投縣,集集鎮,廣明里,292,503,146,110,256,21,277
公投第１６案,南投縣,集集鎮,廣明里,293,419,109,73,182,29,211
公投第１６案,南投縣,集集鎮,富山里,294,582,131,104,235,30,265
公投第１６案,南投縣,名間鄉,南雅村,295,1050,409,265,674,56,730
公投第１６案,南投縣,名間鄉,中正村,296,920,315,173,488,66,554
公投第１６案,南投縣,名間鄉,中正村,297,727,259,182,441,35,476
公投第１６案,南投縣,名間鄉,中正村,298,861,322,196,518,35,553
公投第１６案,南投縣,名間鄉,中正村,299,897,300,175,475,45,520
公投第１６案,南投縣,名間鄉,中山村,300,1055,359,227,586,61,647
公投第１６案,南投縣,名間鄉,中山村,301,1184,382,247,629,65,694
公投第１６案,南投縣,名間鄉,濁水村,302,783,234,166,400,46,446
公投第１６案,南投縣,名間鄉,濁水村,303,781,272,158,430,59,489
公投第１６案,南投縣,名間鄉,新民村,304,977,325,168,493,49,542
公投第１６案,南投縣,名間鄉,炭寮村,305,1015,323,182,505,62,567
公投第１６案,南投縣,名間鄉,新街村,306,914,323,190,513,41,554
公投第１６案,南投縣,名間鄉,新街村,307,1028,318,229,547,29,576
公投第１６案,南投縣,名間鄉,新街村,308,1018,350,219,569,49,618
公投第１６案,南投縣,名間鄉,新街村,309,1274,429,261,690,62,752
公投第１６案,南投縣,名間鄉,東湖村,310,755,251,155,406,48,454
公投第１６案,南投縣,名間鄉,東湖村,311,895,335,196,531,61,592
公投第１６案,南投縣,名間鄉,仁和村,312,892,329,163,492,30,522
公投第１６案,南投縣,名間鄉,萬丹村,313,951,285,216,501,51,552
公投第１６案,南投縣,名間鄉,田仔村,314,1261,403,248,651,72,723
公投第１６案,南投縣,名間鄉,大坑村,315,768,230,155,385,57,442
公投第１６案,南投縣,名間鄉,大庄村,316,962,352,164,516,62,578
公投第１６案,南投縣,名間鄉,大庄村,317,867,290,171,461,73,534
公投第１６案,南投縣,名間鄉,廍下村,318,930,290,206,496,68,564
公投第１６案,南投縣,名間鄉,赤水村,319,641,184,143,327,61,388
公投第１６案,南投縣,名間鄉,赤水村,320,530,141,108,249,32,281
公投第１６案,南投縣,名間鄉,竹圍村,321,931,311,183,494,62,556
公投第１６案,南投縣,名間鄉,三崙村,322,1127,359,242,601,71,672
公投第１６案,南投縣,名間鄉,三崙村,323,443,145,101,246,48,294
公投第１６案,南投縣,名間鄉,松山村,324,870,303,179,482,50,532
公投第１６案,南投縣,名間鄉,松山村,325,621,196,132,328,62,390
公投第１６案,南投縣,名間鄉,松柏村,326,1179,347,226,573,51,624
公投第１６案,南投縣,名間鄉,崁腳村,327,881,324,179,503,59,562
公投第１６案,南投縣,名間鄉,埔中村,328,876,314,212,526,70,596
公投第１６案,南投縣,名間鄉,新厝村,329,783,274,142,416,59,475
公投第１６案,南投縣,名間鄉,新光村,330,778,239,130,369,50,419
公投第１６案,南投縣,名間鄉,新光村,331,983,286,199,485,56,541
公投第１６案,南投縣,鹿谷鄉,鹿谷村,332,934,250,154,404,80,484
公投第１６案,南投縣,鹿谷鄉,鹿谷村,333,940,311,177,488,49,537
公投第１６案,南投縣,鹿谷鄉,彰雅村,334,852,243,170,413,43,456
公投第１６案,南投縣,鹿谷鄉,彰雅村,335,451,104,67,171,36,207
公投第１６案,南投縣,鹿谷鄉,廣興村,336,810,299,152,451,36,487
公投第１６案,南投縣,鹿谷鄉,廣興村,337,1142,407,238,645,68,713
公投第１６案,南投縣,鹿谷鄉,永隆村,338,766,216,133,349,20,369
公投第１６案,南投縣,鹿谷鄉,永隆村,339,884,281,178,459,58,517
公投第１６案,南投縣,鹿谷鄉,鳳凰村,340,811,240,177,417,44,461
公投第１６案,南投縣,鹿谷鄉,鳳凰村,341,581,149,102,251,26,277
公投第１６案,南投縣,鹿谷鄉,內湖村,342,578,162,103,265,29,294
公投第１６案,南投縣,鹿谷鄉,內湖村,343,467,170,80,250,29,279
公投第１６案,南投縣,鹿谷鄉,和雅村,344,622,197,119,316,30,346
公投第１６案,南投縣,鹿谷鄉,竹林村,345,740,224,123,347,36,383
公投第１６案,南投縣,鹿谷鄉,竹林村,346,767,216,161,377,56,433
公投第１６案,南投縣,鹿谷鄉,竹豐村,347,909,298,173,471,58,529
公投第１６案,南投縣,鹿谷鄉,初鄉村,348,713,225,118,343,28,371
公投第１６案,南投縣,鹿谷鄉,初鄉村,349,717,203,104,307,28,335
公投第１６案,南投縣,鹿谷鄉,秀峰村,350,794,222,133,355,51,406
公投第１６案,南投縣,鹿谷鄉,清水村,351,726,190,118,308,27,335
公投第１６案,南投縣,鹿谷鄉,瑞田村,352,737,186,92,278,39,317
公投第１６案,南投縣,中寮鄉,廣興村,353,822,261,180,441,67,508
公投第１６案,南投縣,中寮鄉,崁頂村,354,253,82,58,140,15,155
公投第１６案,南投縣,中寮鄉,崁頂村,355,221,51,34,85,10,95
公投第１６案,南投縣,中寮鄉,八仙村,356,353,89,66,155,2,157
公投第１６案,南投縣,中寮鄉,八仙村,357,427,124,85,209,28,237
公投第１６案,南投縣,中寮鄉,福盛村,358,406,127,75,202,25,227
公投第１６案,南投縣,中寮鄉,福盛村,359,307,81,56,137,24,161
公投第１６案,南投縣,中寮鄉,和興村,360,661,216,130,346,54,400
公投第１６案,南投縣,中寮鄉,復興村,361,290,108,68,176,17,193
公投第１６案,南投縣,中寮鄉,永平村,362,973,314,217,531,46,577
公投第１６案,南投縣,中寮鄉,永平村,363,754,252,172,424,33,457
公投第１６案,南投縣,中寮鄉,中寮村,364,662,184,144,328,40,368
公投第１６案,南投縣,中寮鄉,廣福村,365,490,144,71,215,14,229
公投第１６案,南投縣,中寮鄉,永福村,366,335,96,58,154,21,175
公投第１６案,南投縣,中寮鄉,永福村,367,990,360,166,526,49,575
公投第１６案,南投縣,中寮鄉,義和村,368,461,162,109,271,21,292
公投第１６案,南投縣,中寮鄉,義和村,369,614,200,154,354,28,382
公投第１６案,南投縣,中寮鄉,清水村,370,895,275,165,440,72,512
公投第１６案,南投縣,中寮鄉,內城村,371,465,124,97,221,44,265
公投第１６案,南投縣,中寮鄉,龍安村,372,682,202,131,333,70,403
公投第１６案,南投縣,中寮鄉,爽文村,373,490,150,112,262,41,303
公投第１６案,南投縣,中寮鄉,龍岩村,374,643,198,138,336,59,395
公投第１６案,南投縣,中寮鄉,永芳村,375,459,158,94,252,32,284
公投第１６案,南投縣,中寮鄉,永和村,376,528,133,101,234,31,265
公投第１６案,南投縣,魚池鄉,魚池村,377,922,287,180,467,62,529
公投第１６案,南投縣,魚池鄉,魚池村,378,1098,353,234,587,63,650
公投第１６案,南投縣,魚池鄉,東池村,379,720,231,116,347,39,386
公投第１６案,南投縣,魚池鄉,東池村,380,860,288,178,466,41,507
公投第１６案,南投縣,魚池鄉,大林村,381,514,136,84,220,41,261
公投第１６案,南投縣,魚池鄉,大林村,382,574,171,95,266,17,283
公投第１６案,南投縣,魚池鄉,東光村,383,1249,405,203,608,67,675
公投第１６案,南投縣,魚池鄉,共和村,384,293,101,70,171,21,192
公投第１６案,南投縣,魚池鄉,共和村,385,513,133,119,252,27,279
公投第１６案,南投縣,魚池鄉,共和村,386,186,54,41,95,7,102
公投第１６案,南投縣,魚池鄉,新城村,387,841,248,158,406,32,438
公投第１６案,南投縣,魚池鄉,新城村,388,270,84,63,147,23,170
公投第１６案,南投縣,魚池鄉,新城村,389,275,85,48,133,20,153
公投第１６案,南投縣,魚池鄉,大雁村,390,282,72,44,116,13,129
公投第１６案,南投縣,魚池鄉,大雁村,391,392,112,65,177,11,188
公投第１６案,南投縣,魚池鄉,五城村,392,556,162,107,269,34,303
公投第１６案,南投縣,魚池鄉,五城村,393,176,55,30,85,11,96
公投第１６案,南投縣,魚池鄉,中明村,394,578,130,108,238,35,273
公投第１６案,南投縣,魚池鄉,中明村,395,439,108,94,202,22,224
公投第１６案,南投縣,魚池鄉,水社村,396,844,296,163,459,37,496
公投第１６案,南投縣,魚池鄉,日月村,397,868,241,182,423,43,466
公投第１６案,南投縣,魚池鄉,頭社村,398,405,122,48,170,20,190
公投第１６案,南投縣,魚池鄉,頭社村,399,537,160,114,274,31,305
公投第１６案,南投縣,魚池鄉,武登村,400,335,104,60,164,18,182
公投第１６案,南投縣,魚池鄉,武登村,401,231,54,32,86,18,104
公投第１６案,南投縣,國姓鄉,國姓村,402,964,338,197,535,66,601
公投第１６案,南投縣,國姓鄉,國姓村,403,736,249,136,385,29,414
公投第１６案,南投縣,國姓鄉,石門村,404,801,256,152,408,66,474
公投第１６案,南投縣,國姓鄉,石門村,405,964,329,175,504,30,534
公投第１６案,南投縣,國姓鄉,大旗村,406,686,218,131,349,36,385
公投第１６案,南投縣,國姓鄉,長流村,407,661,196,125,321,41,362
公投第１６案,南投縣,國姓鄉,長流村,408,730,215,122,337,45,382
公投第１６案,南投縣,國姓鄉,長豐村,409,774,190,189,379,55,434
公投第１６案,南投縣,國姓鄉,長福村,410,706,233,172,405,19,424
公投第１６案,南投縣,國姓鄉,北港村,411,1012,303,219,522,55,577
公投第１６案,南投縣,國姓鄉,北港村,412,868,229,128,357,36,393
公投第１６案,南投縣,國姓鄉,福龜村,413,918,343,175,518,42,560
公投第１６案,南投縣,國姓鄉,福龜村,414,937,282,195,477,59,536
公投第１６案,南投縣,國姓鄉,乾溝村,415,815,232,158,390,60,450
公投第１６案,南投縣,國姓鄉,柑林村,416,1134,382,252,634,49,683
公投第１６案,南投縣,國姓鄉,大石村,417,714,206,132,338,33,371
公投第１６案,南投縣,國姓鄉,北山村,418,1095,347,214,561,60,621
公投第１６案,南投縣,國姓鄉,北山村,419,448,127,87,214,23,237
公投第１６案,南投縣,國姓鄉,南港村,420,1064,321,196,517,55,572
公投第１６案,南投縣,國姓鄉,南港村,421,570,168,103,271,29,300
公投第１６案,南投縣,水里鄉,水里村,422,757,243,143,386,37,423
公投第１６案,南投縣,水里鄉,新城村,423,554,171,102,273,41,314
公投第１６案,南投縣,水里鄉,新城村,424,999,308,224,532,46,578
公投第１６案,南投縣,水里鄉,中央村,425,616,184,104,288,35,323
公投第１６案,南投縣,水里鄉,城中村,426,875,293,184,477,38,515
公投第１６案,南投縣,水里鄉,農富村,427,480,141,128,269,14,283
公投第１６案,南投縣,水里鄉,車埕村,428,450,156,69,225,22,247
公投第１６案,南投縣,水里鄉,新興村,429,643,205,109,314,41,355
公投第１６案,南投縣,水里鄉,北埔村,430,1004,345,214,559,31,590
公投第１６案,南投縣,水里鄉,南光村,431,741,228,132,360,41,401
公投第１６案,南投縣,水里鄉,南光村,432,802,298,149,447,24,471
公投第１６案,南投縣,水里鄉,鉅工村,433,998,359,226,585,57,642
公投第１６案,南投縣,水里鄉,永豐村,434,800,244,135,379,60,439
公投第１６案,南投縣,水里鄉,永豐村,435,589,196,141,337,28,365
公投第１６案,南投縣,水里鄉,民和村,436,887,224,157,381,87,468
公投第１６案,南投縣,水里鄉,頂崁村,437,1217,372,207,579,52,631
公投第１６案,南投縣,水里鄉,新山村,438,205,52,23,75,2,77
公投第１６案,南投縣,水里鄉,郡坑村,439,330,118,66,184,25,209
公投第１６案,南投縣,水里鄉,上安村,440,1100,309,214,523,42,565
公投第１６案,南投縣,水里鄉,興隆村,441,275,45,37,82,10,92
公投第１６案,南投縣,水里鄉,永興村,442,318,75,46,121,10,131
公投第１６案,南投縣,水里鄉,玉峰村,443,818,240,147,387,62,449
公投第１６案,南投縣,信義鄉,明德村,444,1201,336,220,556,124,680
公投第１６案,南投縣,信義鄉,明德村,445,329,95,54,149,17,166
公投第１６案,南投縣,信義鄉,愛國村,446,516,131,98,229,37,266
公投第１６案,南投縣,信義鄉,自強村,447,424,113,54,167,26,193
公投第１６案,南投縣,信義鄉,自強村,448,321,90,55,145,8,153
公投第１６案,南投縣,信義鄉,豐丘村,449,648,221,132,353,31,384
公投第１６案,南投縣,信義鄉,新鄉村,450,584,221,105,326,100,426
公投第１６案,南投縣,信義鄉,羅娜村,451,1376,203,119,322,21,343
公投第１６案,南投縣,信義鄉,望美村,452,979,256,149,405,30,435
公投第１６案,南投縣,信義鄉,望美村,453,530,181,121,302,90,392
公投第１６案,南投縣,信義鄉,同富村,454,961,262,176,438,49,487
公投第１６案,南投縣,信義鄉,同富村,455,464,143,92,235,20,255
公投第１６案,南投縣,信義鄉,神木村,456,517,158,106,264,38,302
公投第１６案,南投縣,信義鄉,神木村,457,149,50,34,84,3,87
公投第１６案,南投縣,信義鄉,東埔村,458,1020,346,239,585,175,760
公投第１６案,南投縣,信義鄉,人和村,459,929,325,150,475,161,636
公投第１６案,南投縣,信義鄉,人和村,460,274,71,39,110,15,125
公投第１６案,南投縣,信義鄉,地利村,461,900,392,155,547,83,630
公投第１６案,南投縣,信義鄉,雙龍村,462,617,256,130,386,65,451
公投第１６案,南投縣,信義鄉,潭南村,463,560,204,100,304,43,347
公投第１６案,南投縣,仁愛鄉,南豐村,464,973,327,174,501,30,531
公投第１６案,南投縣,仁愛鄉,南豐村,465,296,81,50,131,19,150
公投第１６案,南投縣,仁愛鄉,大同村,466,900,237,143,380,25,405
公投第１６案,南投縣,仁愛鄉,大同村,467,460,159,111,270,28,298
公投第１６案,南投縣,仁愛鄉,大同村,468,305,101,74,175,8,183
公投第１６案,南投縣,仁愛鄉,榮興村,469,58,11,7,18,2,20
公投第１６案,南投縣,仁愛鄉,春陽村,470,952,245,119,364,14,378
公投第１６案,南投縣,仁愛鄉,精英村,471,679,159,74,233,6,239
公投第１６案,南投縣,仁愛鄉,都達村,472,623,185,120,305,64,369
公投第１６案,南投縣,仁愛鄉,合作村,473,597,100,64,164,6,170
公投第１６案,南投縣,仁愛鄉,發祥村,474,384,120,94,214,34,248
公投第１６案,南投縣,仁愛鄉,發祥村,475,121,33,23,56,6,62
公投第１６案,南投縣,仁愛鄉,發祥村,476,264,94,37,131,3,134
公投第１６案,南投縣,仁愛鄉,力行村,477,509,229,121,350,27,377
公投第１６案,南投縣,仁愛鄉,翠華村,478,338,95,83,178,29,207
公投第１６案,南投縣,仁愛鄉,翠華村,479,169,49,26,75,0,75
公投第１６案,南投縣,仁愛鄉,親愛村,480,613,176,85,261,32,293
公投第１６案,南投縣,仁愛鄉,親愛村,481,404,98,74,172,18,190
公投第１６案,南投縣,仁愛鄉,親愛村,482,134,34,34,68,9,77
公投第１６案,南投縣,仁愛鄉,萬豐村,483,630,199,134,333,59,392
公投第１６案,南投縣,仁愛鄉,法治村,484,763,183,106,289,11,300
公投第１６案,南投縣,仁愛鄉,中正村,485,889,332,195,527,39,566
公投第１６案,南投縣,仁愛鄉,互助村,486,672,255,129,384,54,438
公投第１６案,南投縣,仁愛鄉,互助村,487,447,149,91,240,32,272
公投第１６案,南投縣,仁愛鄉,新生村,488,409,215,72,287,17,304
公投第１６案,雲林縣,麥寮鄉,麥豐村,1,1497,317,239,556,86,642
公投第１６案,雲林縣,麥寮鄉,麥豐村,2,1738,445,345,790,83,873
公投第１６案,雲林縣,麥寮鄉,麥豐村,3,1921,502,396,898,59,957
公投第１６案,雲林縣,麥寮鄉,麥豐村,4,1832,463,310,773,83,856
公投第１６案,雲林縣,麥寮鄉,麥津村,5,1340,314,216,530,77,607
公投第１６案,雲林縣,麥寮鄉,麥津村,6,1138,283,191,474,79,553
公投第１６案,雲林縣,麥寮鄉,麥津村,7,1551,415,254,669,84,753
公投第１６案,雲林縣,麥寮鄉,瓦磘村,8,715,117,141,258,53,311
公投第１６案,雲林縣,麥寮鄉,瓦磘村,9,1194,250,199,449,45,494
公投第１６案,雲林縣,麥寮鄉,興華村,10,1023,270,177,447,41,488
公投第１６案,雲林縣,麥寮鄉,興華村,11,1558,315,217,532,60,592
公投第１６案,雲林縣,麥寮鄉,海豐村,12,1187,238,189,427,47,474
公投第１６案,雲林縣,麥寮鄉,海豐村,13,983,231,144,375,45,420
公投第１６案,雲林縣,麥寮鄉,後安村,14,1363,383,199,582,59,641
公投第１６案,雲林縣,麥寮鄉,後安村,15,1596,408,248,656,97,753
公投第１６案,雲林縣,麥寮鄉,中興村,16,1469,416,317,733,130,863
公投第１６案,雲林縣,麥寮鄉,三盛村,17,964,231,128,359,63,422
公投第１６案,雲林縣,麥寮鄉,三盛村,18,1038,216,156,372,60,432
公投第１６案,雲林縣,麥寮鄉,崙後村,19,1230,339,203,542,78,620
公投第１６案,雲林縣,麥寮鄉,崙後村,20,1329,349,223,572,66,638
公投第１６案,雲林縣,麥寮鄉,橋頭村,21,1129,299,193,492,112,604
公投第１６案,雲林縣,麥寮鄉,橋頭村,22,1241,347,221,568,128,696
公投第１６案,雲林縣,麥寮鄉,橋頭村,23,1471,433,257,690,111,801
公投第１６案,雲林縣,麥寮鄉,新吉村,24,1107,289,234,523,102,625
公投第１６案,雲林縣,麥寮鄉,施厝村,25,1636,473,332,805,97,902
公投第１６案,雲林縣,麥寮鄉,施厝村,26,1755,488,270,758,78,836
公投第１６案,雲林縣,麥寮鄉,雷厝村,27,1158,367,177,544,56,600
公投第１６案,雲林縣,麥寮鄉,雷厝村,28,956,285,177,462,51,513
公投第１６案,雲林縣,臺西鄉,臺西村,29,1238,363,223,586,91,677
公投第１６案,雲林縣,臺西鄉,海南村,30,1091,276,174,450,63,513
公投第１６案,雲林縣,臺西鄉,海北村,31,1098,320,182,502,78,580
公投第１６案,雲林縣,臺西鄉,海口村,32,1048,239,153,392,47,439
公投第１６案,雲林縣,臺西鄉,海口村,33,1025,241,168,409,83,492
公投第１６案,雲林縣,臺西鄉,山寮村,34,850,235,141,376,54,430
公投第１６案,雲林縣,臺西鄉,溪頂村,35,1460,341,214,555,86,641
公投第１６案,雲林縣,臺西鄉,牛厝村,36,1180,193,140,333,102,435
公投第１６案,雲林縣,臺西鄉,牛厝村,37,710,127,75,202,34,236
公投第１６案,雲林縣,臺西鄉,泉州村,38,620,123,84,207,16,223
公投第１６案,雲林縣,臺西鄉,五榔村,39,449,104,71,175,38,213
公投第１６案,雲林縣,臺西鄉,光華村,40,687,119,92,211,67,278
公投第１６案,雲林縣,臺西鄉,五港村,41,1247,290,188,478,83,561
公投第１６案,雲林縣,臺西鄉,五港村,42,583,119,65,184,23,207
公投第１６案,雲林縣,臺西鄉,富琦村,43,1042,293,157,450,75,525
公投第１６案,雲林縣,臺西鄉,富琦村,44,472,126,64,190,30,220
公投第１６案,雲林縣,臺西鄉,永豐村,45,1409,346,159,505,42,547
公投第１６案,雲林縣,臺西鄉,和豐村,46,1061,271,185,456,103,559
公投第１６案,雲林縣,臺西鄉,和豐村,47,993,211,148,359,44,403
公投第１６案,雲林縣,臺西鄉,和豐村,48,1013,248,153,401,91,492
公投第１６案,雲林縣,臺西鄉,蚊港村,49,1233,346,209,555,55,610
公投第１６案,雲林縣,臺西鄉,蚊港村,50,616,139,96,235,29,264
公投第１６案,雲林縣,東勢鄉,月眉村,51,1207,286,183,469,74,543
公投第１６案,雲林縣,東勢鄉,復興村,52,540,168,113,281,45,326
公投第１６案,雲林縣,東勢鄉,嘉隆村,53,896,203,128,331,41,372
公投第１６案,雲林縣,東勢鄉,嘉隆村,54,728,198,135,333,60,393
公投第１６案,雲林縣,東勢鄉,東南村,55,1533,448,310,758,111,869
公投第１６案,雲林縣,東勢鄉,東北村,56,1203,362,245,607,108,715
公投第１６案,雲林縣,東勢鄉,龍潭村,57,817,177,138,315,76,391
公投第１６案,雲林縣,東勢鄉,程海村,58,546,196,97,293,31,324
公投第１６案,雲林縣,東勢鄉,昌南村,59,853,207,150,357,81,438
公投第１６案,雲林縣,東勢鄉,安南村,60,856,155,147,302,63,365
公投第１６案,雲林縣,東勢鄉,同安村,61,923,222,162,384,61,445
公投第１６案,雲林縣,東勢鄉,同安村,62,1022,264,175,439,53,492
公投第１６案,雲林縣,東勢鄉,四美村,63,634,135,74,209,32,241
公投第１６案,雲林縣,東勢鄉,四美村,64,394,94,49,143,23,166
公投第１６案,雲林縣,東勢鄉,新坤村,65,1087,210,144,354,62,416
公投第１６案,雲林縣,褒忠鄉,中民村,66,923,256,177,433,83,516
公投第１６案,雲林縣,褒忠鄉,中民村,67,993,320,218,538,47,585
公投第１６案,雲林縣,褒忠鄉,埔姜村,68,748,210,139,349,40,389
公投第１６案,雲林縣,褒忠鄉,埔姜村,69,702,186,139,325,24,349
公投第１６案,雲林縣,褒忠鄉,中勝村,70,752,218,123,341,30,371
公投第１６案,雲林縣,褒忠鄉,中勝村,71,756,219,154,373,32,405
公投第１６案,雲林縣,褒忠鄉,馬鳴村,72,490,154,79,233,21,254
公投第１６案,雲林縣,褒忠鄉,馬鳴村,73,1034,243,147,390,50,440
公投第１６案,雲林縣,褒忠鄉,新湖村,74,470,111,91,202,29,231
公投第１６案,雲林縣,褒忠鄉,新湖村,75,737,189,147,336,42,378
公投第１６案,雲林縣,褒忠鄉,有才村,76,878,245,143,388,48,436
公投第１６案,雲林縣,褒忠鄉,田洋村,77,778,215,124,339,51,390
公投第１６案,雲林縣,褒忠鄉,龍岩村,78,1224,301,234,535,60,595
公投第１６案,雲林縣,褒忠鄉,潮厝村,79,896,190,151,341,77,418
公投第１６案,雲林縣,土庫鎮,忠正里,80,809,282,164,446,68,514
公投第１６案,雲林縣,土庫鎮,順天里,81,896,247,222,469,70,539
公投第１６案,雲林縣,土庫鎮,宮北里,82,687,204,139,343,55,398
公投第１６案,雲林縣,土庫鎮,宮北里,83,702,278,150,428,43,471
公投第１６案,雲林縣,土庫鎮,越港里,84,1032,366,215,581,57,638
公投第１６案,雲林縣,土庫鎮,溪邊里,85,697,186,129,315,56,371
公投第１６案,雲林縣,土庫鎮,溪邊里,86,427,100,85,185,39,224
公投第１６案,雲林縣,土庫鎮,石廟里,87,1451,462,295,757,86,843
公投第１６案,雲林縣,土庫鎮,石廟里,88,1283,404,281,685,38,723
公投第１６案,雲林縣,土庫鎮,興新里,89,634,150,109,259,20,279
公投第１６案,雲林縣,土庫鎮,興新里,90,796,231,156,387,41,428
公投第１６案,雲林縣,土庫鎮,奮起里,91,745,150,129,279,54,333
公投第１６案,雲林縣,土庫鎮,奮起里,92,576,143,109,252,38,290
公投第１６案,雲林縣,土庫鎮,埤腳里,93,743,168,124,292,64,356
公投第１６案,雲林縣,土庫鎮,埤腳里,94,534,117,102,219,19,238
公投第１６案,雲林縣,土庫鎮,後埔里,95,1199,268,184,452,92,544
公投第１６案,雲林縣,土庫鎮,後埔里,96,1077,251,212,463,77,540
公投第１６案,雲林縣,土庫鎮,崙內里,97,819,178,112,290,46,336
公投第１６案,雲林縣,土庫鎮,崙內里,98,684,178,141,319,51,370
公投第１６案,雲林縣,土庫鎮,大荖里,99,843,240,153,393,67,460
公投第１６案,雲林縣,土庫鎮,東平里,100,916,239,161,400,87,487
公投第１６案,雲林縣,土庫鎮,東平里,101,948,232,183,415,58,473
公投第１６案,雲林縣,土庫鎮,南平里,102,914,275,153,428,36,464
公投第１６案,雲林縣,土庫鎮,南平里,103,860,234,149,383,83,466
公投第１６案,雲林縣,土庫鎮,西平里,104,929,254,153,407,64,471
公投第１６案,雲林縣,土庫鎮,西平里,105,875,214,141,355,63,418
公投第１６案,雲林縣,土庫鎮,北平里,106,896,204,109,313,52,365
公投第１６案,雲林縣,土庫鎮,新庄里,107,757,165,107,272,70,342
公投第１６案,雲林縣,土庫鎮,新庄里,108,683,162,121,283,45,328
公投第１６案,雲林縣,虎尾鎮,東仁里,109,1347,411,260,671,73,744
公投第１６案,雲林縣,虎尾鎮,東仁里,110,1258,410,284,694,47,741
公投第１６案,雲林縣,虎尾鎮,新興里,111,785,234,176,410,25,435
公投第１６案,雲林縣,虎尾鎮,新興里,112,890,219,170,389,49,438
公投第１６案,雲林縣,虎尾鎮,公安里,113,1413,442,310,752,58,810
公投第１６案,雲林縣,虎尾鎮,公安里,114,1431,499,300,799,67,866
公投第１６案,雲林縣,虎尾鎮,德興里,115,1224,348,234,582,76,658
公投第１６案,雲林縣,虎尾鎮,德興里,116,1325,381,212,593,51,644
公投第１６案,雲林縣,虎尾鎮,中山里,117,941,286,211,497,73,570
公投第１６案,雲林縣,虎尾鎮,西安里,118,1613,517,304,821,40,861
公投第１６案,雲林縣,虎尾鎮,西安里,119,1641,450,331,781,57,838
公投第１６案,雲林縣,虎尾鎮,立仁里,120,1200,410,252,662,53,715
公投第１６案,雲林縣,虎尾鎮,立仁里,121,1294,403,273,676,86,762
公投第１６案,雲林縣,虎尾鎮,立仁里,122,1273,388,271,659,58,717
公投第１６案,雲林縣,虎尾鎮,安慶里,123,1438,512,311,823,44,867
公投第１６案,雲林縣,虎尾鎮,平和里,124,1361,466,278,744,42,786
公投第１６案,雲林縣,虎尾鎮,平和里,125,1444,481,332,813,54,867
公投第１６案,雲林縣,虎尾鎮,平和里,126,1490,542,339,881,49,930
公投第１６案,雲林縣,虎尾鎮,興南里,127,1307,476,305,781,50,831
公投第１６案,雲林縣,虎尾鎮,興南里,128,967,266,186,452,34,486
公投第１６案,雲林縣,虎尾鎮,新吉里,129,1865,538,365,903,47,950
公投第１６案,雲林縣,虎尾鎮,新吉里,130,1880,611,354,965,65,1030
公投第１６案,雲林縣,虎尾鎮,穎川里,131,1099,292,232,524,46,570
公投第１６案,雲林縣,虎尾鎮,穎川里,132,901,272,214,486,21,507
公投第１６案,雲林縣,虎尾鎮,延平里,133,1120,335,208,543,35,578
公投第１６案,雲林縣,虎尾鎮,建國里,134,545,131,101,232,12,244
公投第１６案,雲林縣,虎尾鎮,埒內里,135,1420,383,291,674,79,753
公投第１６案,雲林縣,虎尾鎮,埒內里,136,1248,327,241,568,42,610
公投第１６案,雲林縣,虎尾鎮,堀頭里,137,799,241,145,386,32,418
公投第１６案,雲林縣,虎尾鎮,安溪里,138,836,228,155,383,62,445
公投第１６案,雲林縣,虎尾鎮,安溪里,139,924,214,204,418,55,473
公投第１６案,雲林縣,虎尾鎮,興中里,140,1648,390,257,647,55,702
公投第１６案,雲林縣,虎尾鎮,廉使里,141,1616,391,278,669,113,782
公投第１６案,雲林縣,虎尾鎮,廉使里,142,1546,412,264,676,82,758
公投第１６案,雲林縣,虎尾鎮,惠來里,143,1283,373,216,589,41,630
公投第１６案,雲林縣,虎尾鎮,惠來里,144,1078,293,192,485,42,527
公投第１６案,雲林縣,虎尾鎮,頂溪里,145,1313,327,230,557,52,609
公投第１６案,雲林縣,虎尾鎮,頂溪里,146,1284,310,250,560,48,608
公投第１６案,雲林縣,虎尾鎮,中溪里,147,1356,380,247,627,101,728
公投第１６案,雲林縣,虎尾鎮,下溪里,148,1504,442,285,727,78,805
公投第１６案,雲林縣,虎尾鎮,東屯里,149,1224,308,195,503,43,546
公投第１６案,雲林縣,虎尾鎮,西屯里,150,1509,379,244,623,85,708
公投第１６案,雲林縣,虎尾鎮,芳草里,151,855,145,156,301,66,367
公投第１６案,雲林縣,虎尾鎮,墾地里,152,1549,377,238,615,104,719
公投第１６案,雲林縣,虎尾鎮,北溪里,153,851,220,136,356,37,393
公投第１６案,雲林縣,虎尾鎮,三合里,154,1272,349,209,558,79,637
公投第１６案,雲林縣,四湖鄉,四湖村,155,1082,243,161,404,77,481
公投第１６案,雲林縣,四湖鄉,四湖村,156,676,196,120,316,52,368
公投第１６案,雲林縣,四湖鄉,湖西村,157,862,223,184,407,34,441
公投第１６案,雲林縣,四湖鄉,湖西村,158,477,94,45,139,26,165
公投第１６案,雲林縣,四湖鄉,湖西村,159,952,221,236,457,47,504
公投第１６案,雲林縣,四湖鄉,新庄村,160,650,138,86,224,24,248
公投第１６案,雲林縣,四湖鄉,溪底村,161,969,231,152,383,30,413
公投第１６案,雲林縣,四湖鄉,鹿場村,162,925,174,140,314,58,372
公投第１６案,雲林縣,四湖鄉,蔡厝村,163,914,233,125,358,34,392
公投第１６案,雲林縣,四湖鄉,湖寮村,164,759,114,65,179,61,240
公投第１６案,雲林縣,四湖鄉,施湖村,165,1219,228,159,387,63,450
公投第１６案,雲林縣,四湖鄉,羊調村,166,937,160,104,264,57,321
公投第１６案,雲林縣,四湖鄉,內湖村,167,773,129,75,204,17,221
公投第１６案,雲林縣,四湖鄉,飛東村,168,555,113,66,179,46,225
公投第１６案,雲林縣,四湖鄉,飛沙村,169,876,154,97,251,45,296
公投第１６案,雲林縣,四湖鄉,三姓村,170,360,75,41,116,23,139
公投第１６案,雲林縣,四湖鄉,崙北村,171,885,146,77,223,43,266
公投第１６案,雲林縣,四湖鄉,崙北村,172,833,150,92,242,44,286
公投第１６案,雲林縣,四湖鄉,崙南村,173,785,145,125,270,51,321
公投第１６案,雲林縣,四湖鄉,廣溝村,174,705,165,113,278,57,335
公投第１６案,雲林縣,四湖鄉,箔子村,175,927,154,97,251,41,292
公投第１６案,雲林縣,四湖鄉,箔東村,176,1058,168,116,284,93,377
公投第１６案,雲林縣,四湖鄉,林厝村,177,1071,181,156,337,67,404
公投第１６案,雲林縣,四湖鄉,林東村,178,1022,142,105,247,27,274
公投第１６案,雲林縣,四湖鄉,溪尾村,179,711,131,104,235,43,278
公投第１６案,雲林縣,元長鄉,長南村,180,915,216,177,393,54,447
公投第１６案,雲林縣,元長鄉,長南村,181,1284,321,202,523,49,572
公投第１６案,雲林縣,元長鄉,長南村,182,1150,273,196,469,55,524
公投第１６案,雲林縣,元長鄉,長北村,183,744,165,97,262,61,323
公投第１６案,雲林縣,元長鄉,長北村,184,790,189,137,326,62,388
公投第１６案,雲林縣,元長鄉,子茂村,185,1356,216,242,458,98,556
公投第１６案,雲林縣,元長鄉,後湖村,186,739,189,110,299,57,356
公投第１６案,雲林縣,元長鄉,山內村,187,965,188,138,326,50,376
公投第１６案,雲林縣,元長鄉,合和村,188,1080,211,164,375,89,464
公投第１６案,雲林縣,元長鄉,五塊村,189,948,182,144,326,53,379
公投第１６案,雲林縣,元長鄉,潭西村,190,762,113,85,198,46,244
公投第１６案,雲林縣,元長鄉,潭東村,191,582,139,104,243,25,268
公投第１６案,雲林縣,元長鄉,客厝村,192,865,171,125,296,21,317
公投第１６案,雲林縣,元長鄉,卓運村,193,362,42,25,67,9,76
公投第１６案,雲林縣,元長鄉,頂寮村,194,1162,239,141,380,49,429
公投第１６案,雲林縣,元長鄉,下寮村,195,1527,325,232,557,63,620
公投第１６案,雲林縣,元長鄉,龍岩村,196,1006,242,156,398,89,487
公投第１６案,雲林縣,元長鄉,西莊村,197,855,206,111,317,31,348
公投第１６案,雲林縣,元長鄉,鹿北村,198,1181,276,189,465,93,558
公投第１６案,雲林縣,元長鄉,鹿南村,199,864,183,126,309,50,359
公投第１６案,雲林縣,元長鄉,瓦磘村,200,667,125,96,221,44,265
公投第１６案,雲林縣,元長鄉,瓦磘村,201,878,183,117,300,43,343
公投第１６案,雲林縣,元長鄉,內寮村,202,610,104,61,165,9,174
公投第１６案,雲林縣,元長鄉,崙仔村,203,837,172,135,307,88,395
公投第１６案,雲林縣,元長鄉,新吉村,204,701,199,113,312,46,358
公投第１６案,雲林縣,口湖鄉,口湖村,205,1134,300,215,515,73,588
公投第１６案,雲林縣,口湖鄉,湖東村,206,1225,322,222,544,122,666
公投第１６案,雲林縣,口湖鄉,頂湖村,207,647,139,83,222,51,273
公投第１６案,雲林縣,口湖鄉,埔南村,208,709,198,113,311,28,339
公投第１６案,雲林縣,口湖鄉,埔北村,209,900,190,148,338,88,426
公投第１６案,雲林縣,口湖鄉,謝厝村,210,1011,245,168,413,83,496
公投第１６案,雲林縣,口湖鄉,蚵寮村,211,1437,300,176,476,45,521
公投第１６案,雲林縣,口湖鄉,下崙村,212,848,132,110,242,13,255
公投第１６案,雲林縣,口湖鄉,下崙村,213,1193,244,166,410,51,461
公投第１６案,雲林縣,口湖鄉,崙中村,214,759,149,91,240,48,288
公投第１６案,雲林縣,口湖鄉,崙中村,215,815,204,112,316,51,367
公投第１６案,雲林縣,口湖鄉,崙東村,216,1460,362,248,610,103,713
公投第１６案,雲林縣,口湖鄉,青蚶村,217,556,86,69,155,13,168
公投第１６案,雲林縣,口湖鄉,港東村,218,1532,486,117,603,87,690
公投第１６案,雲林縣,口湖鄉,港西村,219,847,193,157,350,22,372
公投第１６案,雲林縣,口湖鄉,台子村,220,374,97,54,151,31,182
公投第１６案,雲林縣,口湖鄉,台子村,221,1508,346,285,631,198,829
公投第１６案,雲林縣,口湖鄉,成龍村,222,951,268,167,435,89,524
公投第１６案,雲林縣,口湖鄉,梧南村,223,910,251,179,430,100,530
公投第１６案,雲林縣,口湖鄉,梧南村,224,879,274,178,452,54,506
公投第１６案,雲林縣,口湖鄉,梧北村,225,1213,289,164,453,137,590
公投第１６案,雲林縣,口湖鄉,水井村,226,952,258,137,395,64,459
公投第１６案,雲林縣,口湖鄉,後厝村,227,720,190,133,323,65,388
公投第１６案,雲林縣,口湖鄉,湖口村,228,1006,194,148,342,38,380
公投第１６案,雲林縣,口湖鄉,過港村,229,607,111,88,199,14,213
公投第１６案,雲林縣,水林鄉,水北村,230,1355,308,207,515,92,607
公投第１６案,雲林縣,水林鄉,水北村,231,887,204,167,371,31,402
公投第１６案,雲林縣,水林鄉,水南村,232,1234,340,242,582,78,660
公投第１６案,雲林縣,水林鄉,水南村,233,763,183,155,338,19,357
公投第１６案,雲林縣,水林鄉,萬興村,234,721,143,101,244,58,302
公投第１６案,雲林縣,水林鄉,尖山村,235,647,126,84,210,16,226
公投第１６案,雲林縣,水林鄉,大溝村,236,989,218,144,362,69,431
公投第１６案,雲林縣,水林鄉,順興村,237,837,174,99,273,35,308
公投第１６案,雲林縣,水林鄉,大山村,238,1081,240,111,351,28,379
公投第１６案,雲林縣,水林鄉,後寮村,239,704,155,122,277,38,315
公投第１６案,雲林縣,水林鄉,春埔村,240,1006,253,146,399,92,491
公投第１６案,雲林縣,水林鄉,西井村,241,651,136,107,243,18,261
公投第１６案,雲林縣,水林鄉,車港村,242,607,135,80,215,24,239
公投第１６案,雲林縣,水林鄉,蘇秦村,243,1033,210,141,351,79,430
公投第１６案,雲林縣,水林鄉,灣東村,244,631,118,66,184,15,199
公投第１６案,雲林縣,水林鄉,灣西村,245,961,212,113,325,80,405
公投第１６案,雲林縣,水林鄉,蕃薯村,246,951,200,130,330,92,422
公投第１６案,雲林縣,水林鄉,山腳村,247,838,190,130,320,44,364
公投第１６案,雲林縣,水林鄉,松北村,248,1055,236,160,396,104,500
公投第１６案,雲林縣,水林鄉,松中村,249,512,89,52,141,31,172
公投第１６案,雲林縣,水林鄉,松西村,250,671,128,87,215,21,236
公投第１６案,雲林縣,水林鄉,欍埔村,251,693,90,81,171,40,211
公投第１６案,雲林縣,水林鄉,塭底村,252,689,109,77,186,53,239
公投第１６案,雲林縣,水林鄉,海埔村,253,1022,233,172,405,88,493
公投第１６案,雲林縣,水林鄉,土厝村,254,1191,259,167,426,51,477
公投第１６案,雲林縣,水林鄉,溪墘村,255,779,219,144,363,50,413
公投第１６案,雲林縣,北港鎮,東陽里,256,724,215,119,334,90,424
公投第１６案,雲林縣,北港鎮,光民里,257,688,192,156,348,81,429
公投第１６案,雲林縣,北港鎮,東華里,258,452,131,86,217,48,265
公投第１６案,雲林縣,北港鎮,南安里,259,866,238,183,421,86,507
公投第１６案,雲林縣,北港鎮,中和里,260,336,90,63,153,25,178
公投第１６案,雲林縣,北港鎮,義民里,261,395,123,59,182,35,217
公投第１６案,雲林縣,北港鎮,共榮里,262,376,131,78,209,29,238
公投第１６案,雲林縣,北港鎮,西勢里,263,950,284,211,495,54,549
公投第１６案,雲林縣,北港鎮,仁和里,264,512,153,118,271,51,322
公投第１６案,雲林縣,北港鎮,賜福里,265,324,99,57,156,42,198
公投第１６案,雲林縣,北港鎮,公舘里,266,546,152,108,260,39,299
公投第１６案,雲林縣,北港鎮,大同里,267,433,140,94,234,25,259
公投第１６案,雲林縣,北港鎮,大同里,268,751,214,141,355,76,431
公投第１６案,雲林縣,北港鎮,仁安里,269,442,154,87,241,32,273
公投第１６案,雲林縣,北港鎮,華勝里,270,1151,351,227,578,88,666
公投第１６案,雲林縣,北港鎮,華勝里,271,1224,375,272,647,66,713
公投第１６案,雲林縣,北港鎮,華勝里,272,1211,329,265,594,70,664
公投第１６案,雲林縣,北港鎮,華勝里,273,1326,398,250,648,99,747
公投第１６案,雲林縣,北港鎮,光復里,274,744,244,174,418,61,479
公投第１６案,雲林縣,北港鎮,光復里,275,977,323,243,566,61,627
公投第１６案,雲林縣,北港鎮,扶朝里,276,960,256,200,456,74,530
公投第１６案,雲林縣,北港鎮,水埔里,277,494,98,61,159,15,174
公投第１６案,雲林縣,北港鎮,新街里,278,1364,446,266,712,76,788
公投第１６案,雲林縣,北港鎮,新街里,279,1123,399,171,570,84,654
公投第１６案,雲林縣,北港鎮,新街里,280,1451,482,275,757,65,822
公投第１６案,雲林縣,北港鎮,新街里,281,1162,380,240,620,77,697
公投第１６案,雲林縣,北港鎮,新街里,282,1130,311,204,515,68,583
公投第１６案,雲林縣,北港鎮,劉厝里,283,1149,312,205,517,60,577
公投第１６案,雲林縣,北港鎮,後溝里,284,533,106,86,192,48,240
公投第１６案,雲林縣,北港鎮,後溝里,285,433,125,108,233,143,376
公投第１６案,雲林縣,北港鎮,新厝里,286,377,114,46,160,19,179
公投第１６案,雲林縣,北港鎮,府番里,287,809,191,126,317,34,351
公投第１６案,雲林縣,北港鎮,草湖里,288,1397,324,215,539,100,639
公投第１６案,雲林縣,北港鎮,溝皂里,289,1145,262,174,436,96,532
公投第１６案,雲林縣,北港鎮,番溝里,290,828,134,104,238,73,311
公投第１６案,雲林縣,北港鎮,大北里,291,557,124,73,197,25,222
公投第１６案,雲林縣,北港鎮,好收里,292,1060,266,176,442,56,498
公投第１６案,雲林縣,北港鎮,好收里,293,577,160,81,241,37,278
公投第１６案,雲林縣,北港鎮,樹腳里,294,931,196,143,339,72,411
公投第１６案,雲林縣,北港鎮,樹腳里,295,1018,311,182,493,53,546
公投第１６案,雲林縣,北港鎮,樹腳里,296,1032,307,212,519,38,557
公投第１６案,雲林縣,崙背鄉,東明村,297,1176,338,228,566,87,653
公投第１６案,雲林縣,崙背鄉,西榮村,298,1439,381,246,627,73,700
公投第１６案,雲林縣,崙背鄉,南陽村,299,1027,335,212,547,60,607
公投第１６案,雲林縣,崙背鄉,南陽村,300,1259,392,247,639,55,694
公投第１６案,雲林縣,崙背鄉,崙前村,301,1058,269,202,471,49,520
公投第１６案,雲林縣,崙背鄉,崙前村,302,998,243,163,406,40,446
公投第１６案,雲林縣,崙背鄉,羅厝村,303,968,260,164,424,30,454
公投第１６案,雲林縣,崙背鄉,羅厝村,304,1055,296,204,500,56,556
公投第１６案,雲林縣,崙背鄉,港尾村,305,1315,298,215,513,107,620
公投第１６案,雲林縣,崙背鄉,阿勸村,306,1027,155,135,290,37,327
公投第１６案,雲林縣,崙背鄉,阿勸村,307,997,281,192,473,114,587
公投第１６案,雲林縣,崙背鄉,五魁村,308,807,239,137,376,46,422
公投第１６案,雲林縣,崙背鄉,大有村,309,698,132,131,263,22,285
公投第１６案,雲林縣,崙背鄉,大有村,310,804,157,152,309,63,372
公投第１６案,雲林縣,崙背鄉,豐榮村,311,867,227,144,371,33,404
公投第１６案,雲林縣,崙背鄉,豐榮村,312,886,198,113,311,35,346
公投第１６案,雲林縣,崙背鄉,草湖村,313,1476,336,175,511,104,615
公投第１６案,雲林縣,崙背鄉,舊庄村,314,1159,190,134,324,48,372
公投第１６案,雲林縣,崙背鄉,水尾村,315,1220,283,297,580,92,672
公投第１６案,雲林縣,崙背鄉,枋南村,316,814,206,151,357,54,411
公投第１６案,雲林縣,二崙鄉,崙東村,317,1463,324,275,599,52,651
公投第１６案,雲林縣,二崙鄉,崙西村,318,1738,416,286,702,75,777
公投第１６案,雲林縣,二崙鄉,來惠村,319,625,150,100,250,54,304
公投第１６案,雲林縣,二崙鄉,來惠村,320,1018,265,166,431,75,506
公投第１６案,雲林縣,二崙鄉,三和村,321,448,85,77,162,3,165
公投第１６案,雲林縣,二崙鄉,三和村,322,1048,203,142,345,57,402
公投第１６案,雲林縣,二崙鄉,湳仔村,323,1161,315,231,546,86,632
公投第１６案,雲林縣,二崙鄉,田尾村,324,991,260,196,456,52,508
公投第１６案,雲林縣,二崙鄉,田尾村,325,849,215,202,417,81,498
公投第１６案,雲林縣,二崙鄉,定安村,326,890,240,159,399,51,450
公投第１６案,雲林縣,二崙鄉,永定村,327,1427,375,212,587,114,701
公投第１６案,雲林縣,二崙鄉,大華村,328,891,232,148,380,39,419
公投第１６案,雲林縣,二崙鄉,義庄村,329,757,166,109,275,41,316
公投第１６案,雲林縣,二崙鄉,楊賢村,330,1497,357,242,599,132,731
公投第１６案,雲林縣,二崙鄉,港後村,331,1171,269,202,471,81,552
公投第１６案,雲林縣,二崙鄉,港後村,332,686,197,131,328,75,403
公投第１６案,雲林縣,二崙鄉,大義村,333,864,185,113,298,88,386
公投第１６案,雲林縣,二崙鄉,油車村,334,1073,324,192,516,99,615
公投第１６案,雲林縣,二崙鄉,油車村,335,696,148,91,239,37,276
公投第１６案,雲林縣,二崙鄉,大庄村,336,1271,237,154,391,81,472
公投第１６案,雲林縣,二崙鄉,庄西村,337,912,205,137,342,63,405
公投第１６案,雲林縣,二崙鄉,大同村,338,861,190,146,336,47,383
公投第１６案,雲林縣,二崙鄉,復興村,339,1030,219,164,383,67,450
公投第１６案,雲林縣,西螺鎮,振興里,340,1590,432,282,714,83,797
公投第１６案,雲林縣,西螺鎮,大園里,341,1741,517,317,834,114,948
公投第１６案,雲林縣,西螺鎮,廣福里,342,1080,388,233,621,71,692
公投第１６案,雲林縣,西螺鎮,廣福里,343,1040,347,230,577,76,653
公投第１６案,雲林縣,西螺鎮,正興里,344,1346,400,281,681,67,748
公投第１６案,雲林縣,西螺鎮,正興里,345,1625,535,287,822,63,885
公投第１６案,雲林縣,西螺鎮,永安里,346,354,123,80,203,24,227
公投第１６案,雲林縣,西螺鎮,中和里,347,580,155,120,275,43,318
公投第１６案,雲林縣,西螺鎮,福興里,348,591,193,133,326,47,373
公投第１６案,雲林縣,西螺鎮,光華里,349,1050,313,236,549,72,621
公投第１６案,雲林縣,西螺鎮,中興里,350,1147,368,267,635,76,711
公投第１６案,雲林縣,西螺鎮,中興里,351,1602,437,314,751,110,861
公投第１６案,雲林縣,西螺鎮,漢光里,352,1452,445,238,683,82,765
公投第１６案,雲林縣,西螺鎮,漢光里,353,1578,426,336,762,117,879
公投第１６案,雲林縣,西螺鎮,漢光里,354,1305,363,260,623,40,663
公投第１６案,雲林縣,西螺鎮,新安里,355,1327,323,214,537,66,603
公投第１６案,雲林縣,西螺鎮,新豐里,356,1516,436,258,694,92,786
公投第１６案,雲林縣,西螺鎮,大新里,357,828,184,119,303,37,340
公投第１６案,雲林縣,西螺鎮,大新里,358,788,168,103,271,25,296
公投第１６案,雲林縣,西螺鎮,埤頭里,359,863,205,151,356,86,442
公投第１６案,雲林縣,西螺鎮,東興里,360,984,218,183,401,119,520
公投第１６案,雲林縣,西螺鎮,鹿場里,361,1514,357,287,644,66,710
公投第１６案,雲林縣,西螺鎮,廣興里,362,870,211,170,381,82,463
公投第１６案,雲林縣,西螺鎮,頂湳里,363,971,271,179,450,67,517
公投第１６案,雲林縣,西螺鎮,吳厝里,364,1304,309,213,522,63,585
公投第１６案,雲林縣,西螺鎮,九隆里,365,726,193,106,299,51,350
公投第１６案,雲林縣,西螺鎮,下湳里,366,823,211,180,391,59,450
公投第１６案,雲林縣,西螺鎮,七座里,367,886,198,122,320,28,348
公投第１６案,雲林縣,西螺鎮,公舘里,368,1373,363,224,587,99,686
公投第１６案,雲林縣,西螺鎮,詔安里,369,983,282,177,459,78,537
公投第１６案,雲林縣,西螺鎮,河南里,370,1014,280,203,483,61,544
公投第１６案,雲林縣,西螺鎮,安定里,371,939,226,163,389,83,472
公投第１６案,雲林縣,西螺鎮,安定里,372,866,232,154,386,45,431
公投第１６案,雲林縣,西螺鎮,福田里,373,1486,383,248,631,93,724
公投第１６案,雲林縣,莿桐鄉,莿桐村,374,1507,418,332,750,101,851
公投第１６案,雲林縣,莿桐鄉,莿桐村,375,1300,405,250,655,50,705
公投第１６案,雲林縣,莿桐鄉,莿桐村,376,1272,392,249,641,106,747
公投第１６案,雲林縣,莿桐鄉,甘厝村,377,861,191,173,364,94,458
公投第１６案,雲林縣,莿桐鄉,甘西村,378,1565,384,259,643,90,733
公投第１６案,雲林縣,莿桐鄉,興桐村,379,577,162,101,263,26,289
公投第１６案,雲林縣,莿桐鄉,興桐村,380,636,144,110,254,46,300
公投第１６案,雲林縣,莿桐鄉,義和村,381,1110,284,182,466,104,570
公投第１６案,雲林縣,莿桐鄉,埔子村,382,973,305,204,509,78,587
公投第１６案,雲林縣,莿桐鄉,埔子村,383,985,275,188,463,85,548
公投第１６案,雲林縣,莿桐鄉,大美村,384,1707,515,370,885,125,1010
公投第１６案,雲林縣,莿桐鄉,大美村,385,1284,332,279,611,107,718
公投第１６案,雲林縣,莿桐鄉,埔尾村,386,1293,378,285,663,74,737
公投第１６案,雲林縣,莿桐鄉,興貴村,387,900,270,166,436,74,510
公投第１６案,雲林縣,莿桐鄉,興貴村,388,1040,318,205,523,97,620
公投第１６案,雲林縣,莿桐鄉,饒平村,389,1165,316,228,544,44,588
公投第１６案,雲林縣,莿桐鄉,四合村,390,871,255,167,422,71,493
公投第１６案,雲林縣,莿桐鄉,四合村,391,885,285,178,463,72,535
公投第１６案,雲林縣,莿桐鄉,麻園村,392,1489,365,276,641,84,725
公投第１６案,雲林縣,莿桐鄉,五華村,393,1347,470,219,689,106,795
公投第１６案,雲林縣,莿桐鄉,六合村,394,1150,349,235,584,82,666
公投第１６案,雲林縣,莿桐鄉,六合村,395,653,205,129,334,55,389
公投第１６案,雲林縣,林內鄉,林南村,396,1036,333,242,575,81,656
公投第１６案,雲林縣,林內鄉,林中村,397,1490,452,311,763,73,836
公投第１６案,雲林縣,林內鄉,林中村,398,1491,436,272,708,96,804
公投第１６案,雲林縣,林內鄉,林中村,399,671,181,106,287,68,355
公投第１６案,雲林縣,林內鄉,林北村,400,1436,419,307,726,136,862
公投第１６案,雲林縣,林內鄉,林北村,401,751,247,129,376,67,443
公投第１６案,雲林縣,林內鄉,坪頂村,402,535,149,109,258,34,292
公投第１６案,雲林縣,林內鄉,林茂村,403,811,187,139,326,55,381
公投第１６案,雲林縣,林內鄉,九芎村,404,1339,388,250,638,129,767
公投第１６案,雲林縣,林內鄉,九芎村,405,1286,359,233,592,79,671
公投第１６案,雲林縣,林內鄉,湖本村,406,646,187,132,319,39,358
公投第１６案,雲林縣,林內鄉,烏塗村,407,1158,310,246,556,91,647
公投第１６案,雲林縣,林內鄉,烏麻村,408,1090,324,204,528,91,619
公投第１６案,雲林縣,林內鄉,重興村,409,950,290,208,498,82,580
公投第１６案,雲林縣,林內鄉,重興村,410,861,220,176,396,51,447
公投第１６案,雲林縣,斗六市,信義里,411,644,182,141,323,16,339
公投第１６案,雲林縣,斗六市,四維里,412,617,190,117,307,42,349
公投第１６案,雲林縣,斗六市,太平里,413,764,278,187,465,37,502
公投第１６案,雲林縣,斗六市,中和里,414,784,270,180,450,38,488
公投第１６案,雲林縣,斗六市,光興里,415,760,213,177,390,42,432
公投第１６案,雲林縣,斗六市,鎮西里,416,1881,629,421,1050,88,1138
公投第１６案,雲林縣,斗六市,鎮西里,417,1829,553,371,924,70,994
公投第１６案,雲林縣,斗六市,鎮東里,418,1255,433,299,732,51,783
公投第１６案,雲林縣,斗六市,鎮東里,419,1090,434,236,670,33,703
公投第１６案,雲林縣,斗六市,文化里,420,1103,383,239,622,51,673
公投第１６案,雲林縣,斗六市,文化里,421,1176,434,231,665,40,705
公投第１６案,雲林縣,斗六市,三平里,422,1529,483,332,815,39,854
公投第１６案,雲林縣,斗六市,三平里,423,1335,452,274,726,56,782
公投第１６案,雲林縣,斗六市,三平里,424,1770,589,380,969,70,1039
公投第１６案,雲林縣,斗六市,明德里,425,1308,400,299,699,51,750
公投第１６案,雲林縣,斗六市,明德里,426,2171,671,412,1083,91,1174
公投第１６案,雲林縣,斗六市,鎮北里,427,1193,404,268,672,58,730
公投第１６案,雲林縣,斗六市,鎮北里,428,1572,583,332,915,66,981
公投第１６案,雲林縣,斗六市,公誠里,429,1009,326,203,529,31,560
公投第１６案,雲林縣,斗六市,公誠里,430,1195,437,245,682,63,745
公投第１６案,雲林縣,斗六市,忠孝里,431,1415,507,281,788,81,869
公投第１６案,雲林縣,斗六市,仁愛里,432,1101,352,276,628,49,677
公投第１６案,雲林縣,斗六市,八德里,433,1648,488,338,826,58,884
公投第１６案,雲林縣,斗六市,八德里,434,1588,477,283,760,41,801
公投第１６案,雲林縣,斗六市,公正里,435,1392,475,302,777,44,821
公投第１６案,雲林縣,斗六市,公正里,436,1422,475,298,773,54,827
公投第１６案,雲林縣,斗六市,重光里,437,1187,352,180,532,47,579
公投第１６案,雲林縣,斗六市,重光里,438,1142,322,213,535,54,589
公投第１６案,雲林縣,斗六市,林頭里,439,1421,504,324,828,46,874
公投第１６案,雲林縣,斗六市,林頭里,440,1261,400,283,683,35,718
公投第１６案,雲林縣,斗六市,林頭里,441,1506,443,300,743,42,785
公投第１６案,雲林縣,斗六市,成功里,442,1214,415,306,721,40,761
公投第１６案,雲林縣,斗六市,成功里,443,1362,484,315,799,72,871
公投第１６案,雲林縣,斗六市,鎮南里,444,1097,346,216,562,35,597
公投第１６案,雲林縣,斗六市,鎮南里,445,1262,415,258,673,48,721
公投第１６案,雲林縣,斗六市,鎮南里,446,1154,380,219,599,36,635
公投第１６案,雲林縣,斗六市,社口里,447,847,306,172,478,33,511
公投第１６案,雲林縣,斗六市,社口里,448,1439,480,246,726,47,773
公投第１６案,雲林縣,斗六市,龍潭里,449,1747,590,401,991,74,1065
公投第１６案,雲林縣,斗六市,嘉東里,450,1418,485,275,760,52,812
公投第１６案,雲林縣,斗六市,崙峰里,451,1112,362,217,579,54,633
公投第１６案,雲林縣,斗六市,崙峰里,452,1302,424,263,687,61,748
公投第１６案,雲林縣,斗六市,溝埧里,453,669,217,183,400,25,425
公投第１６案,雲林縣,斗六市,江厝里,454,752,248,141,389,47,436
公投第１６案,雲林縣,斗六市,江厝里,455,1450,433,278,711,54,765
公投第１６案,雲林縣,斗六市,三光里,456,555,168,107,275,46,321
公投第１６案,雲林縣,斗六市,久安里,457,1470,438,261,699,69,768
公投第１６案,雲林縣,斗六市,久安里,458,927,313,204,517,36,553
公投第１６案,雲林縣,斗六市,虎溪里,459,1893,654,379,1033,72,1105
公投第１６案,雲林縣,斗六市,虎溪里,460,1708,493,386,879,107,986
公投第１６案,雲林縣,斗六市,虎溪里,461,1773,506,245,751,82,833
公投第１６案,雲林縣,斗六市,保庄里,462,1412,500,295,795,49,844
公投第１６案,雲林縣,斗六市,保庄里,463,1354,501,302,803,33,836
公投第１６案,雲林縣,斗六市,保庄里,464,1267,395,264,659,40,699
公投第１６案,雲林縣,斗六市,保庄里,465,1273,387,258,645,38,683
公投第１６案,雲林縣,斗六市,長平里,466,1748,522,285,807,97,904
公投第１６案,雲林縣,斗六市,榴中里,467,1238,395,253,648,79,727
公投第１６案,雲林縣,斗六市,榴中里,468,1648,493,310,803,88,891
公投第１６案,雲林縣,斗六市,榴中里,469,1520,524,324,848,69,917
公投第１６案,雲林縣,斗六市,榴北里,470,1087,317,202,519,40,559
公投第１６案,雲林縣,斗六市,榴南里,471,1904,632,364,996,87,1083
公投第１６案,雲林縣,斗六市,梅林里,472,702,229,156,385,39,424
公投第１６案,雲林縣,斗六市,梅林里,473,1111,314,269,583,64,647
公投第１６案,雲林縣,斗六市,湖山里,474,1123,290,207,497,46,543
公投第１６案,雲林縣,斗六市,長安里,475,1146,339,202,541,50,591
公投第１６案,雲林縣,斗六市,長安里,476,1786,555,342,897,45,942
公投第１６案,雲林縣,斗六市,溪洲里,477,1023,280,237,517,69,586
公投第１６案,雲林縣,斗六市,溪洲里,478,2072,611,427,1038,109,1147
公投第１６案,雲林縣,斗六市,十三里,479,1128,326,230,556,30,586
公投第１６案,雲林縣,大埤鄉,北和村,480,750,212,140,352,49,401
公投第１６案,雲林縣,大埤鄉,吉田村,481,719,200,124,324,32,356
公投第１６案,雲林縣,大埤鄉,豐岡村,482,603,179,104,283,29,312
公投第１６案,雲林縣,大埤鄉,聯美村,483,1106,236,213,449,76,525
公投第１６案,雲林縣,大埤鄉,南和村,484,1495,438,297,735,47,782
公投第１６案,雲林縣,大埤鄉,南和村,485,600,188,132,320,38,358
公投第１６案,雲林縣,大埤鄉,大德村,486,1004,312,218,530,67,597
公投第１６案,雲林縣,大埤鄉,松竹村,487,948,199,139,338,35,373
公投第１６案,雲林縣,大埤鄉,豐田村,488,1539,464,266,730,101,831
公投第１６案,雲林縣,大埤鄉,尚義村,489,1430,371,237,608,81,689
公投第１６案,雲林縣,大埤鄉,尚義村,490,465,109,89,198,37,235
公投第１６案,雲林縣,大埤鄉,嘉興村,491,1307,324,253,577,64,641
公投第１６案,雲林縣,大埤鄉,嘉興村,492,474,107,104,211,30,241
公投第１６案,雲林縣,大埤鄉,三結村,493,1220,354,262,616,106,722
公投第１６案,雲林縣,大埤鄉,怡然村,494,733,192,125,317,30,347
公投第１６案,雲林縣,大埤鄉,北鎮村,495,681,194,132,326,46,372
公投第１６案,雲林縣,大埤鄉,興安村,496,712,151,107,258,42,300
公投第１６案,雲林縣,大埤鄉,西鎮村,497,723,181,113,294,54,348
公投第１６案,雲林縣,斗南鎮,東仁里,498,1166,338,276,614,60,674
公投第１６案,雲林縣,斗南鎮,西岐里,499,1135,366,280,646,42,688
公投第１６案,雲林縣,斗南鎮,西岐里,500,975,323,238,561,44,605
公投第１６案,雲林縣,斗南鎮,大同里,501,1459,507,298,805,58,863
公投第１６案,雲林縣,斗南鎮,大同里,502,1351,441,295,736,58,794
公投第１６案,雲林縣,斗南鎮,南昌里,503,1321,458,217,675,66,741
公投第１６案,雲林縣,斗南鎮,南昌里,504,907,263,185,448,51,499
公投第１６案,雲林縣,斗南鎮,北銘里,505,1473,528,334,862,68,930
公投第１６案,雲林縣,斗南鎮,中天里,506,1277,392,336,728,75,803
公投第１６案,雲林縣,斗南鎮,林子里,507,1333,351,291,642,113,755
公投第１６案,雲林縣,斗南鎮,石龜里,508,777,219,151,370,40,410
公投第１６案,雲林縣,斗南鎮,石溪里,509,877,226,197,423,53,476
公投第１６案,雲林縣,斗南鎮,靖興里,510,899,267,161,428,65,493
公投第１６案,雲林縣,斗南鎮,新南里,511,688,151,113,264,50,314
公投第１６案,雲林縣,斗南鎮,阿丹里,512,1147,307,302,609,41,650
公投第１６案,雲林縣,斗南鎮,將軍里,513,1709,506,328,834,111,945
公投第１６案,雲林縣,斗南鎮,舊社里,514,1042,335,242,577,56,633
公投第１６案,雲林縣,斗南鎮,舊社里,515,1631,453,327,780,99,879
公投第１６案,雲林縣,斗南鎮,明昌里,516,1702,367,547,914,100,1014
公投第１６案,雲林縣,斗南鎮,明昌里,517,1564,498,349,847,68,915
公投第１６案,雲林縣,斗南鎮,僑真里,518,910,241,144,385,16,401
公投第１６案,雲林縣,斗南鎮,僑真里,519,1276,436,287,723,59,782
公投第１６案,雲林縣,斗南鎮,大東里,520,897,228,137,365,24,389
公投第１６案,雲林縣,斗南鎮,埤麻里,521,803,231,150,381,44,425
公投第１６案,雲林縣,斗南鎮,西伯里,522,866,276,171,447,57,504
公投第１６案,雲林縣,斗南鎮,新崙里,523,852,261,167,428,76,504
公投第１６案,雲林縣,斗南鎮,新崙里,524,671,178,148,326,55,381
公投第１６案,雲林縣,斗南鎮,東明里,525,981,289,190,479,37,516
公投第１６案,雲林縣,斗南鎮,新光里,526,1129,279,207,486,35,521
公投第１６案,雲林縣,斗南鎮,新光里,527,1586,496,314,810,122,932
公投第１６案,雲林縣,斗南鎮,田頭里,528,1243,429,237,666,92,758
公投第１６案,雲林縣,斗南鎮,田頭里,529,984,251,185,436,36,472
公投第１６案,雲林縣,斗南鎮,小東里,530,1507,431,307,738,97,835
公投第１６案,雲林縣,古坑鄉,棋盤村,531,1126,346,215,561,61,622
公投第１６案,雲林縣,古坑鄉,棋盤村,532,994,281,179,460,64,524
公投第１６案,雲林縣,古坑鄉,新庄村,533,1517,399,269,668,94,762
公投第１６案,雲林縣,古坑鄉,東和村,534,1302,402,230,632,65,697
公投第１６案,雲林縣,古坑鄉,東和村,535,1772,482,322,804,69,873
公投第１６案,雲林縣,古坑鄉,荷苞村,536,1122,345,195,540,104,644
公投第１６案,雲林縣,古坑鄉,荷苞村,537,304,57,31,88,8,96
公投第１６案,雲林縣,古坑鄉,高林村,538,1169,327,246,573,107,680
公投第１６案,雲林縣,古坑鄉,水碓村,539,1255,312,227,539,111,650
公投第１６案,雲林縣,古坑鄉,田心村,540,1078,357,229,586,66,652
公投第１６案,雲林縣,古坑鄉,古坑村,541,943,248,145,393,45,438
公投第１６案,雲林縣,古坑鄉,古坑村,542,1300,342,244,586,83,669
公投第１６案,雲林縣,古坑鄉,朝陽村,543,964,251,178,429,54,483
公投第１６案,雲林縣,古坑鄉,朝陽村,544,1144,334,234,568,55,623
公投第１６案,雲林縣,古坑鄉,西平村,545,1482,433,271,704,84,788
公投第１６案,雲林縣,古坑鄉,湳仔村,546,688,220,120,340,46,386
公投第１６案,雲林縣,古坑鄉,永光村,547,998,257,164,421,66,487
公投第１６案,雲林縣,古坑鄉,永光村,548,1140,360,227,587,63,650
公投第１６案,雲林縣,古坑鄉,永昌村,549,1102,320,199,519,70,589
公投第１６案,雲林縣,古坑鄉,永昌村,550,956,267,186,453,44,497
公投第１６案,雲林縣,古坑鄉,麻園村,551,695,189,140,329,38,367
公投第１６案,雲林縣,古坑鄉,崁腳村,552,1233,472,114,586,9,595
公投第１６案,雲林縣,古坑鄉,華南村,553,285,49,42,91,11,102
公投第１６案,雲林縣,古坑鄉,華山村,554,734,160,103,263,15,278
公投第１６案,雲林縣,古坑鄉,桂林村,555,1150,296,265,561,73,634
公投第１６案,雲林縣,古坑鄉,樟湖村,556,453,110,94,204,26,230
公投第１６案,雲林縣,古坑鄉,草嶺村,557,571,131,105,236,41,277
公投第１６案,嘉義縣,太保市,太保里,1,1210,335,259,594,85,679
公投第１６案,嘉義縣,太保市,太保里,2,1076,319,213,532,44,576
公投第１６案,嘉義縣,太保市,後庄里,3,488,138,66,204,30,234
公投第１６案,嘉義縣,太保市,前潭里,4,1475,334,304,638,78,716
公投第１６案,嘉義縣,太保市,後潭里,5,790,192,129,321,37,358
公投第１６案,嘉義縣,太保市,後潭里,6,883,232,156,388,53,441
公投第１６案,嘉義縣,太保市,梅埔里,7,758,197,131,328,56,384
公投第１６案,嘉義縣,太保市,梅埔里,8,389,102,49,151,7,158
公投第１６案,嘉義縣,太保市,春珠里,9,1101,245,208,453,59,512
公投第１６案,嘉義縣,太保市,崙頂里,10,853,237,163,400,20,420
公投第１６案,嘉義縣,太保市,安仁里,11,224,44,33,77,15,92
公投第１６案,嘉義縣,太保市,安仁里,12,662,167,88,255,64,319
公投第１６案,嘉義縣,太保市,安仁里,13,1630,592,320,912,49,961
公投第１６案,嘉義縣,太保市,東勢里,14,913,217,175,392,32,424
公投第１６案,嘉義縣,太保市,東勢里,15,779,246,167,413,20,433
公投第１６案,嘉義縣,太保市,新埤里,16,1278,335,258,593,112,705
公投第１６案,嘉義縣,太保市,舊埤里,17,819,218,138,356,34,390
公投第１６案,嘉義縣,太保市,舊埤里,18,1573,441,296,737,43,780
公投第１６案,嘉義縣,太保市,田尾里,19,481,123,105,228,32,260
公投第１６案,嘉義縣,太保市,田尾里,20,245,87,49,136,6,142
公投第１６案,嘉義縣,太保市,港尾里,21,317,84,68,152,19,171
公投第１６案,嘉義縣,太保市,港尾里,22,258,63,46,109,7,116
公投第１６案,嘉義縣,太保市,過溝里,23,611,177,95,272,61,333
公投第１６案,嘉義縣,太保市,過溝里,24,1526,446,331,777,64,841
公投第１６案,嘉義縣,太保市,過溝里,25,1196,358,262,620,36,656
公投第１６案,嘉義縣,太保市,麻寮里,26,1536,403,325,728,111,839
公投第１６案,嘉義縣,太保市,麻寮里,27,1481,428,315,743,79,822
公投第１６案,嘉義縣,太保市,麻寮里,28,1450,457,276,733,58,791
公投第１６案,嘉義縣,太保市,南新里,29,840,214,151,365,26,391
公投第１６案,嘉義縣,太保市,南新里,30,989,290,190,480,29,509
公投第１６案,嘉義縣,太保市,北新里,31,1529,436,320,756,110,866
公投第１６案,嘉義縣,太保市,北新里,32,1511,458,306,764,84,848
公投第１６案,嘉義縣,太保市,埤鄉里,33,697,163,114,277,50,327
公投第１６案,嘉義縣,鹿草鄉,後寮村,34,522,110,83,193,48,241
公投第１６案,嘉義縣,鹿草鄉,鹿東村,35,563,163,93,256,43,299
公投第１６案,嘉義縣,鹿草鄉,鹿草村,36,1304,327,216,543,94,637
公投第１６案,嘉義縣,鹿草鄉,西井村,37,1312,355,236,591,72,663
公投第１６案,嘉義縣,鹿草鄉,豊稠村,38,320,79,46,125,4,129
公投第１６案,嘉義縣,鹿草鄉,豊稠村,39,418,61,44,105,5,110
公投第１６案,嘉義縣,鹿草鄉,重寮村,40,1025,235,137,372,71,443
公投第１６案,嘉義縣,鹿草鄉,施家村,41,451,95,69,164,22,186
公投第１６案,嘉義縣,鹿草鄉,下潭村,42,830,206,134,340,102,442
公投第１６案,嘉義縣,鹿草鄉,光潭村,43,1050,219,185,404,86,490
公投第１６案,嘉義縣,鹿草鄉,碧潭村,44,972,183,147,330,70,400
公投第１６案,嘉義縣,鹿草鄉,松竹村,45,962,245,145,390,54,444
公投第１６案,嘉義縣,鹿草鄉,竹山村,46,678,166,131,297,55,352
公投第１６案,嘉義縣,鹿草鄉,竹山村,47,262,58,57,115,22,137
公投第１６案,嘉義縣,鹿草鄉,後堀村,48,906,174,155,329,62,391
公投第１６案,嘉義縣,鹿草鄉,後堀村,49,306,54,40,94,13,107
公投第１６案,嘉義縣,鹿草鄉,三角村,50,1062,287,182,469,83,552
公投第１６案,嘉義縣,鹿草鄉,三角村,51,373,96,76,172,29,201
公投第１６案,嘉義縣,鹿草鄉,下麻村,52,324,90,54,144,31,175
公投第１６案,嘉義縣,鹿草鄉,下麻村,53,297,79,50,129,18,147
公投第１６案,嘉義縣,水上鄉,水上村,54,1024,257,197,454,44,498
公投第１６案,嘉義縣,水上鄉,水上村,55,1015,292,249,541,72,613
公投第１６案,嘉義縣,水上鄉,水上村,56,1932,501,339,840,103,943
公投第１６案,嘉義縣,水上鄉,水頭村,57,1170,476,153,629,51,680
公投第１６案,嘉義縣,水上鄉,水頭村,58,1305,393,296,689,76,765
公投第１６案,嘉義縣,水上鄉,粗溪村,59,1242,327,218,545,74,619
公投第１６案,嘉義縣,水上鄉,粗溪村,60,324,79,59,138,25,163
公投第１６案,嘉義縣,水上鄉,下寮村,61,622,165,134,299,27,326
公投第１６案,嘉義縣,水上鄉,下寮村,62,1216,320,201,521,96,617
公投第１６案,嘉義縣,水上鄉,三和村,63,1020,315,207,522,36,558
公投第１６案,嘉義縣,水上鄉,三和村,64,771,237,202,439,42,481
公投第１６案,嘉義縣,水上鄉,回歸村,65,441,155,96,251,25,276
公投第１６案,嘉義縣,水上鄉,大堀村,66,626,207,153,360,48,408
公投第１６案,嘉義縣,水上鄉,大堀村,67,570,186,116,302,35,337
公投第１６案,嘉義縣,水上鄉,大堀村,68,368,94,73,167,25,192
公投第１６案,嘉義縣,水上鄉,大崙村,69,1037,257,181,438,99,537
公投第１６案,嘉義縣,水上鄉,大崙村,70,1065,286,214,500,73,573
公投第１６案,嘉義縣,水上鄉,塗溝村,71,802,244,177,421,86,507
公投第１６案,嘉義縣,水上鄉,龍德村,72,1948,542,336,878,45,923
公投第１６案,嘉義縣,水上鄉,溪洲村,73,1028,279,173,452,73,525
公投第１６案,嘉義縣,水上鄉,三鎮村,74,641,213,125,338,33,371
公投第１６案,嘉義縣,水上鄉,靖和村,75,408,121,97,218,10,228
公投第１６案,嘉義縣,水上鄉,南和村,76,794,236,163,399,59,458
公投第１６案,嘉義縣,水上鄉,南和村,77,569,137,104,241,30,271
公投第１６案,嘉義縣,水上鄉,柳新村,78,806,241,166,407,45,452
公投第１６案,嘉義縣,水上鄉,柳新村,79,960,305,186,491,63,554
公投第１６案,嘉義縣,水上鄉,柳林村,80,2035,577,433,1010,99,1109
公投第１６案,嘉義縣,水上鄉,柳鄉村,81,1987,511,386,897,119,1016
公投第１６案,嘉義縣,水上鄉,內溪村,82,1154,341,222,563,43,606
公投第１６案,嘉義縣,水上鄉,寬士村,83,2208,604,411,1015,92,1107
公投第１６案,嘉義縣,水上鄉,寬士村,84,2102,526,323,849,89,938
公投第１６案,嘉義縣,水上鄉,民生村,85,1309,357,226,583,70,653
公投第１６案,嘉義縣,水上鄉,民生村,86,1671,441,349,790,117,907
公投第１６案,嘉義縣,水上鄉,義興村,87,822,238,154,392,47,439
公投第１６案,嘉義縣,水上鄉,中庄村,88,1772,408,353,761,86,847
公投第１６案,嘉義縣,水上鄉,忠和村,89,1919,514,386,900,103,1003
公投第１６案,嘉義縣,水上鄉,南鄉村,90,912,216,142,358,20,378
公投第１６案,嘉義縣,水上鄉,三界村,91,992,273,165,438,36,474
公投第１６案,嘉義縣,水上鄉,國姓村,92,1270,284,218,502,61,563
公投第１６案,嘉義縣,民雄鄉,東榮村,93,1267,360,308,668,66,734
公投第１６案,嘉義縣,民雄鄉,東榮村,94,1030,284,198,482,42,524
公投第１６案,嘉義縣,民雄鄉,中樂村,95,1590,472,351,823,119,942
公投第１６案,嘉義縣,民雄鄉,西安村,96,1673,463,318,781,52,833
公投第１６案,嘉義縣,民雄鄉,西安村,97,1718,484,407,891,87,978
公投第１６案,嘉義縣,民雄鄉,寮頂村,98,1040,325,215,540,74,614
公投第１６案,嘉義縣,民雄鄉,寮頂村,99,1100,307,219,526,71,597
公投第１６案,嘉義縣,民雄鄉,福權村,100,1559,406,305,711,89,800
公投第１６案,嘉義縣,民雄鄉,東湖村,101,1862,497,355,852,86,938
公投第１６案,嘉義縣,民雄鄉,頂崙村,102,1435,409,312,721,88,809
公投第１６案,嘉義縣,民雄鄉,菁埔村,103,1751,409,129,538,379,917
公投第１６案,嘉義縣,民雄鄉,中和村,104,933,268,191,459,67,526
公投第１６案,嘉義縣,民雄鄉,平和村,105,827,225,237,462,55,517
公投第１６案,嘉義縣,民雄鄉,西昌村,106,843,190,145,335,59,394
公投第１６案,嘉義縣,民雄鄉,豊收村,107,1774,482,358,840,97,937
公投第１６案,嘉義縣,民雄鄉,豊收村,108,385,86,70,156,26,182
公投第１６案,嘉義縣,民雄鄉,三興村,109,1306,400,297,697,46,743
公投第１６案,嘉義縣,民雄鄉,東興村,110,535,151,113,264,56,320
公投第１６案,嘉義縣,民雄鄉,鎮北村,111,1055,305,221,526,90,616
公投第１６案,嘉義縣,民雄鄉,北斗村,112,1476,424,316,740,58,798
公投第１６案,嘉義縣,民雄鄉,北斗村,113,1583,443,278,721,74,795
公投第１６案,嘉義縣,民雄鄉,北斗村,114,758,191,117,308,36,344
公投第１６案,嘉義縣,民雄鄉,北斗村,115,1354,358,262,620,54,674
公投第１６案,嘉義縣,民雄鄉,双福村,116,1202,305,261,566,117,683
公投第１６案,嘉義縣,民雄鄉,双福村,117,1175,335,254,589,57,646
公投第１６案,嘉義縣,民雄鄉,福樂村,118,1423,386,287,673,56,729
公投第１６案,嘉義縣,民雄鄉,福樂村,119,1612,492,293,785,62,847
公投第１６案,嘉義縣,民雄鄉,福樂村,120,1695,521,357,878,47,925
公投第１６案,嘉義縣,民雄鄉,福樂村,121,1665,400,299,699,54,753
公投第１６案,嘉義縣,民雄鄉,大崎村,122,1019,260,163,423,68,491
公投第１６案,嘉義縣,民雄鄉,大崎村,123,1352,351,274,625,80,705
公投第１６案,嘉義縣,民雄鄉,秀林村,124,1620,472,334,806,87,893
公投第１６案,嘉義縣,民雄鄉,秀林村,125,943,254,165,419,53,472
公投第１６案,嘉義縣,民雄鄉,松山村,126,1720,391,331,722,75,797
公投第１６案,嘉義縣,民雄鄉,興中村,127,1875,478,371,849,109,958
公投第１６案,嘉義縣,民雄鄉,興南村,128,1305,398,260,658,73,731
公投第１６案,嘉義縣,民雄鄉,興南村,129,1441,365,293,658,80,738
公投第１６案,嘉義縣,民雄鄉,金興村,130,1413,384,289,673,83,756
公投第１６案,嘉義縣,民雄鄉,金興村,131,1560,425,300,725,93,818
公投第１６案,嘉義縣,民雄鄉,福興村,132,2004,558,426,984,129,1113
公投第１６案,嘉義縣,民雄鄉,文隆村,133,1354,440,278,718,80,798
公投第１６案,嘉義縣,民雄鄉,文隆村,134,1076,298,245,543,55,598
公投第１６案,嘉義縣,民雄鄉,山中村,135,1629,408,348,756,157,913
公投第１６案,嘉義縣,民雄鄉,山中村,136,1977,499,409,908,94,1002
公投第１６案,嘉義縣,民雄鄉,中央村,137,1295,299,280,579,103,682
公投第１６案,嘉義縣,新港鄉,宮前村,138,1087,313,212,525,43,568
公投第１６案,嘉義縣,新港鄉,宮前村,139,1116,403,253,656,78,734
公投第１６案,嘉義縣,新港鄉,宮後村,140,740,201,152,353,58,411
公投第１６案,嘉義縣,新港鄉,宮後村,141,827,185,174,359,79,438
公投第１６案,嘉義縣,新港鄉,大興村,142,704,225,151,376,55,431
公投第１６案,嘉義縣,新港鄉,大興村,143,768,226,186,412,60,472
公投第１６案,嘉義縣,新港鄉,福德村,144,761,222,183,405,50,455
公投第１６案,嘉義縣,新港鄉,福德村,145,850,211,149,360,71,431
公投第１６案,嘉義縣,新港鄉,古民村,146,1327,345,266,611,89,700
公投第１６案,嘉義縣,新港鄉,中庄村,147,756,208,151,359,60,419
公投第１６案,嘉義縣,新港鄉,中庄村,148,816,233,135,368,94,462
公投第１６案,嘉義縣,新港鄉,大潭村,149,667,162,97,259,47,306
公投第１６案,嘉義縣,新港鄉,大潭村,150,942,249,171,420,63,483
公投第１６案,嘉義縣,新港鄉,西庄村,151,918,210,151,361,77,438
公投第１６案,嘉義縣,新港鄉,埤子村,152,554,133,70,203,17,220
公投第１６案,嘉義縣,新港鄉,南崙村,153,929,233,149,382,59,441
公投第１６案,嘉義縣,新港鄉,北崙村,154,487,85,70,155,49,204
公投第１６案,嘉義縣,新港鄉,海瀛村,155,487,133,83,216,53,269
公投第１６案,嘉義縣,新港鄉,月眉村,156,836,174,167,341,58,399
公投第１６案,嘉義縣,新港鄉,月眉村,157,845,202,180,382,82,464
公投第１６案,嘉義縣,新港鄉,月潭村,158,834,235,151,386,67,453
公投第１６案,嘉義縣,新港鄉,月潭村,159,753,219,149,368,57,425
公投第１６案,嘉義縣,新港鄉,溪北村,160,1328,322,298,620,82,702
公投第１６案,嘉義縣,新港鄉,菜公村,161,969,282,212,494,62,556
公投第１６案,嘉義縣,新港鄉,中洋村,162,1043,309,218,527,90,617
公投第１６案,嘉義縣,新港鄉,三間村,163,1400,453,305,758,83,841
公投第１６案,嘉義縣,新港鄉,安和村,164,1017,183,118,301,39,340
公投第１６案,嘉義縣,新港鄉,潭大村,165,1132,281,173,454,60,514
公投第１６案,嘉義縣,新港鄉,南港村,166,1037,273,181,454,84,538
公投第１６案,嘉義縣,新港鄉,板頭村,167,563,146,123,269,62,331
公投第１６案,嘉義縣,新港鄉,共和村,168,849,230,157,387,22,409
公投第１６案,嘉義縣,大林鎮,東林里,169,483,119,112,231,33,264
公投第１６案,嘉義縣,大林鎮,西林里,170,1823,530,413,943,77,1020
公投第１６案,嘉義縣,大林鎮,吉林里,171,955,271,214,485,25,510
公投第１６案,嘉義縣,大林鎮,平林里,172,1436,372,299,671,51,722
公投第１６案,嘉義縣,大林鎮,平林里,173,1390,372,305,677,75,752
公投第１６案,嘉義縣,大林鎮,平林里,174,1512,454,317,771,78,849
公投第１６案,嘉義縣,大林鎮,平林里,175,1536,459,335,794,70,864
公投第１６案,嘉義縣,大林鎮,明華里,176,1165,297,192,489,56,545
公投第１６案,嘉義縣,大林鎮,明和里,177,1730,557,375,932,78,1010
公投第１６案,嘉義縣,大林鎮,排路里,178,602,113,113,226,19,245
公投第１６案,嘉義縣,大林鎮,西結里,179,716,154,138,292,65,357
公投第１６案,嘉義縣,大林鎮,湖北里,180,625,102,100,202,11,213
公投第１６案,嘉義縣,大林鎮,大糖里,181,193,38,29,67,2,69
公投第１６案,嘉義縣,大林鎮,大美里,182,1642,389,281,670,77,747
公投第１６案,嘉義縣,大林鎮,過溪里,183,1465,387,291,678,82,760
公投第１６案,嘉義縣,大林鎮,中坑里,184,928,211,160,371,40,411
公投第１６案,嘉義縣,大林鎮,中坑里,185,361,84,50,134,25,159
公投第１６案,嘉義縣,大林鎮,上林里,186,814,200,135,335,20,355
公投第１６案,嘉義縣,大林鎮,中林里,187,1579,398,286,684,44,728
公投第１６案,嘉義縣,大林鎮,三和里,188,2041,558,376,934,106,1040
公投第１６案,嘉義縣,大林鎮,溝背里,189,931,248,172,420,55,475
公投第１６案,嘉義縣,大林鎮,義和里,190,675,185,114,299,46,345
公投第１６案,嘉義縣,大林鎮,內林里,191,655,168,116,284,33,317
公投第１６案,嘉義縣,大林鎮,三角里,192,833,217,141,358,52,410
公投第１６案,嘉義縣,大林鎮,三村里,193,832,240,205,445,55,500
公投第１６案,嘉義縣,溪口鄉,溪東村,194,1318,365,270,635,115,750
公投第１６案,嘉義縣,溪口鄉,溪西村,195,677,215,130,345,48,393
公投第１６案,嘉義縣,溪口鄉,溪北村,196,417,98,80,178,20,198
公投第１６案,嘉義縣,溪口鄉,溪北村,197,273,72,60,132,14,146
公投第１６案,嘉義縣,溪口鄉,柳溝村,198,908,277,177,454,73,527
公投第１６案,嘉義縣,溪口鄉,柳溝村,199,386,90,59,149,13,162
公投第１６案,嘉義縣,溪口鄉,疊溪村,200,1039,277,235,512,65,577
公投第１６案,嘉義縣,溪口鄉,妙崙村,201,708,161,122,283,48,331
公投第１６案,嘉義縣,溪口鄉,坪頂村,202,909,216,165,381,18,399
公投第１６案,嘉義縣,溪口鄉,柴林村,203,786,146,233,379,52,431
公投第１６案,嘉義縣,溪口鄉,林腳村,204,807,196,138,334,50,384
公投第１６案,嘉義縣,溪口鄉,美南村,205,1168,261,152,413,27,440
公投第１６案,嘉義縣,溪口鄉,美北村,206,1052,275,230,505,81,586
公投第１６案,嘉義縣,溪口鄉,本厝村,207,565,129,102,231,54,285
公投第１６案,嘉義縣,溪口鄉,本厝村,208,388,121,53,174,31,205
公投第１６案,嘉義縣,溪口鄉,游西村,209,701,155,104,259,26,285
公投第１６案,嘉義縣,溪口鄉,游東村,210,1003,206,154,360,50,410
公投第１６案,嘉義縣,梅山鄉,梅東村,211,1041,277,212,489,33,522
公投第１６案,嘉義縣,梅山鄉,梅東村,212,1245,352,274,626,117,743
公投第１６案,嘉義縣,梅山鄉,梅南村,213,917,298,203,501,61,562
公投第１６案,嘉義縣,梅山鄉,梅北村,214,1189,330,243,573,56,629
公投第１６案,嘉義縣,梅山鄉,梅北村,215,1388,419,273,692,89,781
公投第１６案,嘉義縣,梅山鄉,梅北村,216,1827,502,372,874,79,953
公投第１６案,嘉義縣,梅山鄉,過山村,217,545,168,123,291,54,345
公投第１６案,嘉義縣,梅山鄉,圳南村,218,407,87,60,147,36,183
公投第１６案,嘉義縣,梅山鄉,圳北村,219,636,159,134,293,44,337
公投第１６案,嘉義縣,梅山鄉,双溪村,220,576,159,116,275,55,330
公投第１６案,嘉義縣,梅山鄉,大南村,221,1674,483,334,817,95,912
公投第１６案,嘉義縣,梅山鄉,安靖村,222,858,200,146,346,18,364
公投第１６案,嘉義縣,梅山鄉,永興村,223,526,154,136,290,41,331
公投第１６案,嘉義縣,梅山鄉,半天村,224,372,79,69,148,33,181
公投第１６案,嘉義縣,梅山鄉,太平村,225,506,131,90,221,32,253
公投第１６案,嘉義縣,梅山鄉,太興村,226,433,156,95,251,50,301
公投第１６案,嘉義縣,梅山鄉,龍眼村,227,404,92,55,147,19,166
公投第１６案,嘉義縣,梅山鄉,碧湖村,228,293,74,54,128,18,146
公投第１６案,嘉義縣,梅山鄉,瑞峯村,229,712,232,128,360,89,449
公投第１６案,嘉義縣,梅山鄉,瑞里村,230,602,191,141,332,41,373
公投第１６案,嘉義縣,梅山鄉,太和村,231,515,129,94,223,26,249
公投第１６案,嘉義縣,梅山鄉,太和村,232,417,85,61,146,18,164
公投第１６案,嘉義縣,朴子市,安福里,233,1183,359,229,588,54,642
公投第１６案,嘉義縣,朴子市,安福里,234,755,216,154,370,44,414
公投第１６案,嘉義縣,朴子市,平和里,235,1253,374,258,632,42,674
公投第１６案,嘉義縣,朴子市,平和里,236,1078,256,326,582,65,647
公投第１６案,嘉義縣,朴子市,內厝里,237,1117,318,280,598,87,685
公投第１６案,嘉義縣,朴子市,開元里,238,387,125,85,210,20,230
公投第１６案,嘉義縣,朴子市,順天里,239,633,172,143,315,44,359
公投第１６案,嘉義縣,朴子市,中正里,240,650,190,137,327,38,365
公投第１６案,嘉義縣,朴子市,博厚里,241,825,272,180,452,66,518
公投第１６案,嘉義縣,朴子市,文化里,242,810,249,146,395,52,447
公投第１６案,嘉義縣,朴子市,文化里,243,940,318,179,497,53,550
公投第１６案,嘉義縣,朴子市,永和里,244,905,233,183,416,62,478
公投第１６案,嘉義縣,朴子市,永和里,245,1605,387,321,708,59,767
公投第１６案,嘉義縣,朴子市,竹圍里,246,1479,469,314,783,65,848
公投第１６案,嘉義縣,朴子市,竹圍里,247,1218,377,258,635,65,700
公投第１６案,嘉義縣,朴子市,竹圍里,248,1496,463,319,782,75,857
公投第１６案,嘉義縣,朴子市,新寮里,249,667,177,132,309,49,358
公投第１６案,嘉義縣,朴子市,双溪里,250,627,118,98,216,31,247
公投第１６案,嘉義縣,朴子市,溪口里,251,791,206,130,336,61,397
公投第１６案,嘉義縣,朴子市,德興里,252,1034,286,180,466,107,573
公投第１６案,嘉義縣,朴子市,仁和里,253,1710,448,317,765,35,800
公投第１６案,嘉義縣,朴子市,大鄉里,254,1671,420,292,712,61,773
公投第１６案,嘉義縣,朴子市,大鄉里,255,1547,338,225,563,56,619
公投第１６案,嘉義縣,朴子市,大葛里,256,1602,304,265,569,77,646
公投第１６案,嘉義縣,朴子市,大葛里,257,1302,435,264,699,40,739
公投第１６案,嘉義縣,朴子市,佳禾里,258,740,198,122,320,57,377
公投第１６案,嘉義縣,朴子市,竹村里,259,1054,343,203,546,72,618
公投第１６案,嘉義縣,朴子市,崁前里,260,907,185,140,325,21,346
公投第１６案,嘉義縣,朴子市,崁後里,261,720,158,118,276,32,308
公投第１６案,嘉義縣,朴子市,順安里,262,251,69,46,115,31,146
公投第１６案,嘉義縣,朴子市,德家里,263,767,163,122,285,49,334
公投第１６案,嘉義縣,朴子市,新庄里,264,702,198,148,346,43,389
公投第１６案,嘉義縣,朴子市,梅華里,265,1038,247,174,421,64,485
公投第１６案,嘉義縣,朴子市,松華里,266,1228,218,146,364,30,394
公投第１６案,嘉義縣,朴子市,南竹里,267,499,118,83,201,56,257
公投第１６案,嘉義縣,六腳鄉,蒜頭村,268,1165,268,173,441,46,487
公投第１６案,嘉義縣,六腳鄉,蒜東村,269,825,158,84,242,26,268
公投第１６案,嘉義縣,六腳鄉,蒜南村,270,850,189,136,325,37,362
公投第１６案,嘉義縣,六腳鄉,工廠村,271,222,52,55,107,24,131
公投第１６案,嘉義縣,六腳鄉,灣南村,272,1216,242,275,517,73,590
公投第１６案,嘉義縣,六腳鄉,灣北村,273,1200,235,149,384,58,442
公投第１６案,嘉義縣,六腳鄉,雙涵村,274,877,227,128,355,54,409
公投第１６案,嘉義縣,六腳鄉,塗師村,275,644,138,88,226,48,274
公投第１６案,嘉義縣,六腳鄉,三義村,276,594,111,72,183,26,209
公投第１６案,嘉義縣,六腳鄉,三義村,277,167,26,14,40,1,41
公投第１６案,嘉義縣,六腳鄉,正義村,278,204,27,40,67,2,69
公投第１６案,嘉義縣,六腳鄉,正義村,279,234,32,50,82,7,89
公投第１６案,嘉義縣,六腳鄉,正義村,280,361,76,39,115,11,126
公投第１６案,嘉義縣,六腳鄉,正義村,281,592,155,104,259,69,328
公投第１６案,嘉義縣,六腳鄉,溪厝村,282,619,153,106,259,49,308
公投第１６案,嘉義縣,六腳鄉,港美村,283,714,141,79,220,53,273
公投第１６案,嘉義縣,六腳鄉,豐美村,284,1051,248,179,427,65,492
公投第１６案,嘉義縣,六腳鄉,六斗村,285,934,236,167,403,79,482
公投第１６案,嘉義縣,六腳鄉,崙陽村,286,1044,273,173,446,66,512
公投第１６案,嘉義縣,六腳鄉,蘇厝村,287,1476,318,227,545,38,583
公投第１６案,嘉義縣,六腳鄉,竹本村,288,618,115,73,188,26,214
公投第１６案,嘉義縣,六腳鄉,永賢村,289,478,80,35,115,47,162
公投第１６案,嘉義縣,六腳鄉,魚寮村,290,642,105,82,187,45,232
公投第１６案,嘉義縣,六腳鄉,潭墘村,291,883,138,103,241,19,260
公投第１６案,嘉義縣,六腳鄉,六腳村,292,739,131,66,197,8,205
公投第１６案,嘉義縣,六腳鄉,六南村,293,554,102,80,182,33,215
公投第１６案,嘉義縣,六腳鄉,崩山村,294,649,97,83,180,23,203
公投第１６案,嘉義縣,六腳鄉,古林村,295,689,145,64,209,23,232
公投第１６案,嘉義縣,六腳鄉,更寮村,296,455,81,67,148,24,172
公投第１６案,嘉義縣,六腳鄉,更寮村,297,125,12,19,31,6,37
公投第１６案,嘉義縣,東石鄉,東石村,298,1915,398,294,692,119,811
公投第１６案,嘉義縣,東石鄉,猿樹村,299,938,185,122,307,63,370
公投第１６案,嘉義縣,東石鄉,型厝村,300,1366,184,161,345,36,381
公投第１６案,嘉義縣,東石鄉,塭港村,301,1676,347,216,563,6,569
公投第１６案,嘉義縣,東石鄉,三家村,302,1151,224,144,368,97,465
公投第１６案,嘉義縣,東石鄉,永屯村,303,716,142,93,235,86,321
公投第１６案,嘉義縣,東石鄉,海埔村,304,387,61,49,110,13,123
公投第１６案,嘉義縣,東石鄉,龍港村,305,864,141,77,218,15,233
公投第１６案,嘉義縣,東石鄉,副瀨村,306,910,143,113,256,24,280
公投第１６案,嘉義縣,東石鄉,下揖村,307,760,140,80,220,18,238
公投第１６案,嘉義縣,東石鄉,頂揖村,308,166,44,27,71,15,86
公投第１６案,嘉義縣,東石鄉,頂揖村,309,212,32,28,60,17,77
公投第１６案,嘉義縣,東石鄉,溪下村,310,993,176,106,282,50,332
公投第１６案,嘉義縣,東石鄉,港口村,311,306,72,27,99,13,112
公投第１６案,嘉義縣,東石鄉,鰲鼓村,312,1046,189,123,312,99,411
公投第１６案,嘉義縣,東石鄉,鰲鼓村,313,235,40,25,65,25,90
公投第１６案,嘉義縣,東石鄉,港墘村,314,1226,267,184,451,104,555
公投第１６案,嘉義縣,東石鄉,蔦松村,315,843,172,126,298,66,364
公投第１６案,嘉義縣,東石鄉,圍潭村,316,693,149,97,246,38,284
公投第１６案,嘉義縣,東石鄉,洲仔村,317,839,198,147,345,67,412
公投第１６案,嘉義縣,東石鄉,東崙村,318,363,86,43,129,18,147
公投第１６案,嘉義縣,東石鄉,東崙村,319,321,71,27,98,11,109
公投第１６案,嘉義縣,東石鄉,西崙村,320,1083,337,194,531,66,597
公投第１６案,嘉義縣,東石鄉,塭仔村,321,901,209,138,347,65,412
公投第１６案,嘉義縣,東石鄉,網寮村,322,1216,196,129,325,40,365
公投第１６案,嘉義縣,東石鄉,掌潭村,323,418,117,86,203,46,249
公投第１６案,嘉義縣,東石鄉,掌潭村,324,371,82,58,140,15,155
公投第１６案,嘉義縣,布袋鎮,岱江里,325,614,165,96,261,37,298
公投第１６案,嘉義縣,布袋鎮,九龍里,326,372,92,58,150,18,168
公投第１６案,嘉義縣,布袋鎮,岑海里,327,914,244,160,404,101,505
公投第１６案,嘉義縣,布袋鎮,岑海里,328,1198,320,209,529,105,634
公投第１６案,嘉義縣,布袋鎮,興中里,329,1113,277,170,447,78,525
公投第１６案,嘉義縣,布袋鎮,光復里,330,992,292,176,468,67,535
公投第１６案,嘉義縣,布袋鎮,光復里,331,689,196,123,319,15,334
公投第１６案,嘉義縣,布袋鎮,見龍里,332,882,215,166,381,82,463
公投第１６案,嘉義縣,布袋鎮,新厝里,333,731,203,129,332,47,379
公投第１６案,嘉義縣,布袋鎮,龍江里,334,779,252,124,376,41,417
公投第１６案,嘉義縣,布袋鎮,振寮里,335,762,182,120,302,39,341
公投第１６案,嘉義縣,布袋鎮,西安里,336,1184,289,170,459,66,525
公投第１６案,嘉義縣,布袋鎮,中安里,337,1423,286,199,485,76,561
公投第１６案,嘉義縣,布袋鎮,東安里,338,1351,302,169,471,63,534
公投第１６案,嘉義縣,布袋鎮,樹林里,339,275,57,41,98,7,105
公投第１６案,嘉義縣,布袋鎮,樹林里,340,243,48,46,94,16,110
公投第１６案,嘉義縣,布袋鎮,貴舍里,341,661,151,122,273,90,363
公投第１６案,嘉義縣,布袋鎮,永安里,342,1145,301,178,479,55,534
公投第１６案,嘉義縣,布袋鎮,東港里,343,936,217,172,389,34,423
公投第１６案,嘉義縣,布袋鎮,東港里,344,958,227,179,406,48,454
公投第１６案,嘉義縣,布袋鎮,江山里,345,298,65,51,116,17,133
公投第１６案,嘉義縣,布袋鎮,菜舖里,346,428,136,72,208,36,244
公投第１６案,嘉義縣,布袋鎮,考試里,347,121,33,16,49,3,52
公投第１６案,嘉義縣,布袋鎮,考試里,348,174,27,19,46,4,50
公投第１６案,嘉義縣,布袋鎮,新岑里,349,953,229,158,387,64,451
公投第１６案,嘉義縣,布袋鎮,新民里,350,1292,374,243,617,75,692
公投第１６案,嘉義縣,布袋鎮,復興里,351,1127,435,97,532,69,601
公投第１６案,嘉義縣,布袋鎮,復興里,352,1244,330,203,533,52,585
公投第１６案,嘉義縣,布袋鎮,好美里,353,1106,257,193,450,28,478
公投第１６案,嘉義縣,義竹鄉,岸腳村,354,482,120,80,200,28,228
公投第１６案,嘉義縣,義竹鄉,岸腳村,355,223,66,42,108,22,130
公投第１６案,嘉義縣,義竹鄉,義竹村,356,1529,452,272,724,94,818
公投第１６案,嘉義縣,義竹鄉,六桂村,357,1175,368,213,581,73,654
公投第１６案,嘉義縣,義竹鄉,仁里村,358,886,284,201,485,59,544
公投第１６案,嘉義縣,義竹鄉,傳芳村,359,743,173,116,289,46,335
公投第１６案,嘉義縣,義竹鄉,頭竹村,360,1236,362,221,583,92,675
公投第１６案,嘉義縣,義竹鄉,五厝村,361,377,105,64,169,25,194
公投第１６案,嘉義縣,義竹鄉,中平村,362,338,80,52,132,21,153
公投第１６案,嘉義縣,義竹鄉,中平村,363,102,38,17,55,4,59
公投第１６案,嘉義縣,義竹鄉,埤前村,364,763,181,118,299,35,334
公投第１６案,嘉義縣,義竹鄉,平溪村,365,429,118,85,203,36,239
公投第１６案,嘉義縣,義竹鄉,後鎮村,366,427,110,73,183,24,207
公投第１６案,嘉義縣,義竹鄉,北華村,367,607,159,125,284,46,330
公投第１６案,嘉義縣,義竹鄉,新店村,368,1486,364,253,617,51,668
公投第１６案,嘉義縣,義竹鄉,東過村,369,835,245,139,384,92,476
公投第１６案,嘉義縣,義竹鄉,西過村,370,816,171,106,277,77,354
公投第１６案,嘉義縣,義竹鄉,官和村,371,833,194,119,313,68,381
公投第１６案,嘉義縣,義竹鄉,官順村,372,433,93,87,180,31,211
公投第１６案,嘉義縣,義竹鄉,新富村,373,558,151,80,231,8,239
公投第１６案,嘉義縣,義竹鄉,東光村,374,602,149,112,261,52,313
公投第１６案,嘉義縣,義竹鄉,東光村,375,140,33,17,50,2,52
公投第１６案,嘉義縣,義竹鄉,東榮村,376,393,97,51,148,30,178
公投第１６案,嘉義縣,義竹鄉,龍蛟村,377,585,153,111,264,23,287
公投第１６案,嘉義縣,義竹鄉,溪洲村,378,526,96,58,154,12,166
公投第１６案,嘉義縣,義竹鄉,溪洲村,379,123,29,33,62,9,71
公投第１６案,嘉義縣,中埔鄉,富收村,380,1046,222,157,379,24,403
公投第１６案,嘉義縣,中埔鄉,富收村,381,1788,408,330,738,102,840
公投第１６案,嘉義縣,中埔鄉,和睦村,382,1730,405,313,718,63,781
公投第１６案,嘉義縣,中埔鄉,和睦村,383,1581,407,288,695,76,771
公投第１６案,嘉義縣,中埔鄉,和美村,384,1594,354,254,608,67,675
公投第１６案,嘉義縣,中埔鄉,和美村,385,1801,456,381,837,62,899
公投第１６案,嘉義縣,中埔鄉,和美村,386,1862,492,325,817,85,902
公投第１６案,嘉義縣,中埔鄉,和美村,387,1803,434,315,749,35,784
公投第１６案,嘉義縣,中埔鄉,和興村,388,1481,442,252,694,74,768
公投第１６案,嘉義縣,中埔鄉,和興村,389,1366,375,279,654,64,718
公投第１６案,嘉義縣,中埔鄉,和興村,390,1599,345,285,630,81,711
公投第１６案,嘉義縣,中埔鄉,和興村,391,1196,331,213,544,46,590
公投第１６案,嘉義縣,中埔鄉,中埔村,392,1809,401,315,716,105,821
公投第１６案,嘉義縣,中埔鄉,塩舘村,393,953,255,172,427,26,453
公投第１６案,嘉義縣,中埔鄉,金蘭村,394,1441,352,243,595,75,670
公投第１６案,嘉義縣,中埔鄉,隆興村,395,1882,453,327,780,87,867
公投第１６案,嘉義縣,中埔鄉,義仁村,396,1470,275,206,481,36,517
公投第１６案,嘉義縣,中埔鄉,社口村,397,1699,393,266,659,94,753
公投第１６案,嘉義縣,中埔鄉,社口村,398,422,97,59,156,17,173
公投第１６案,嘉義縣,中埔鄉,灣潭村,399,1030,270,168,438,74,512
公投第１６案,嘉義縣,中埔鄉,裕民村,400,879,206,149,355,52,407
公投第１６案,嘉義縣,中埔鄉,龍門村,401,828,161,145,306,25,331
公投第１６案,嘉義縣,中埔鄉,石硦村,402,881,265,164,429,68,497
公投第１６案,嘉義縣,中埔鄉,石硦村,403,296,72,53,125,23,148
公投第１６案,嘉義縣,中埔鄉,頂埔村,404,979,185,190,375,104,479
公投第１６案,嘉義縣,中埔鄉,同仁村,405,1268,272,208,480,48,528
公投第１６案,嘉義縣,中埔鄉,同仁村,406,670,113,74,187,8,195
公投第１６案,嘉義縣,中埔鄉,深坑村,407,754,211,147,358,73,431
公投第１６案,嘉義縣,中埔鄉,三層村,408,648,175,125,300,51,351
公投第１６案,嘉義縣,中埔鄉,瑞豐村,409,741,152,118,270,24,294
公投第１６案,嘉義縣,中埔鄉,沄水村,410,518,124,80,204,5,209
公投第１６案,嘉義縣,中埔鄉,沄水村,411,482,120,81,201,40,241
公投第１６案,嘉義縣,中埔鄉,東興村,412,348,73,58,131,12,143
公投第１６案,嘉義縣,中埔鄉,中崙村,413,294,80,57,137,10,147
公投第１６案,嘉義縣,竹崎鄉,竹崎村,414,1312,347,269,616,39,655
公投第１６案,嘉義縣,竹崎鄉,竹崎村,415,1210,360,244,604,31,635
公投第１６案,嘉義縣,竹崎鄉,和平村,416,991,302,197,499,53,552
公投第１６案,嘉義縣,竹崎鄉,和平村,417,1207,326,234,560,48,608
公投第１６案,嘉義縣,竹崎鄉,坑頭村,418,752,150,134,284,21,305
公投第１６案,嘉義縣,竹崎鄉,沙坑村,419,833,228,185,413,71,484
公投第１６案,嘉義縣,竹崎鄉,獅埜村,420,1220,186,411,597,93,690
公投第１６案,嘉義縣,竹崎鄉,義和村,421,616,194,126,320,22,342
公投第１６案,嘉義縣,竹崎鄉,義仁村,422,1031,271,195,466,62,528
公投第１６案,嘉義縣,竹崎鄉,灣橋村,423,1292,357,235,592,76,668
公投第１６案,嘉義縣,竹崎鄉,灣橋村,424,1995,595,415,1010,85,1095
公投第１６案,嘉義縣,竹崎鄉,灣橋村,425,1996,503,351,854,38,892
公投第１６案,嘉義縣,竹崎鄉,鹿滿村,426,1449,383,282,665,93,758
公投第１６案,嘉義縣,竹崎鄉,紫雲村,427,1420,409,236,645,45,690
公投第１６案,嘉義縣,竹崎鄉,內埔村,428,1590,427,354,781,65,846
公投第１６案,嘉義縣,竹崎鄉,昇平村,429,771,204,148,352,38,390
公投第１６案,嘉義縣,竹崎鄉,昇平村,430,1014,220,208,428,51,479
公投第１６案,嘉義縣,竹崎鄉,桃源村,431,327,60,37,97,11,108
公投第１６案,嘉義縣,竹崎鄉,桃源村,432,687,202,127,329,31,360
公投第１６案,嘉義縣,竹崎鄉,白杞村,433,641,152,112,264,30,294
公投第１６案,嘉義縣,竹崎鄉,塘興村,434,474,117,99,216,11,227
公投第１６案,嘉義縣,竹崎鄉,塘興村,435,383,97,69,166,22,188
公投第１６案,嘉義縣,竹崎鄉,義隆村,436,619,181,143,324,51,375
公投第１６案,嘉義縣,竹崎鄉,龍山村,437,214,51,37,88,11,99
公投第１６案,嘉義縣,竹崎鄉,龍山村,438,1568,414,287,701,115,816
公投第１６案,嘉義縣,竹崎鄉,文峯村,439,658,136,109,245,51,296
公投第１６案,嘉義縣,竹崎鄉,金獅村,440,434,108,111,219,36,255
公投第１６案,嘉義縣,竹崎鄉,復金村,441,917,263,168,431,64,495
公投第１６案,嘉義縣,竹崎鄉,復金村,442,981,231,175,406,65,471
公投第１６案,嘉義縣,竹崎鄉,緞繻村,443,789,168,140,308,28,336
公投第１６案,嘉義縣,竹崎鄉,緞繻村,444,108,15,12,27,2,29
公投第１６案,嘉義縣,竹崎鄉,仁壽村,445,235,29,22,51,3,54
公投第１６案,嘉義縣,竹崎鄉,中和村,446,331,85,46,131,7,138
公投第１６案,嘉義縣,竹崎鄉,中和村,447,450,140,118,258,17,275
公投第１６案,嘉義縣,竹崎鄉,光華村,448,462,114,49,163,10,173
公投第１６案,嘉義縣,竹崎鄉,光華村,449,251,63,27,90,16,106
公投第１６案,嘉義縣,番路鄉,江西村,450,1174,354,271,625,82,707
公投第１６案,嘉義縣,番路鄉,內甕村,451,449,141,104,245,16,261
公投第１６案,嘉義縣,番路鄉,新福村,452,753,256,136,392,51,443
公投第１６案,嘉義縣,番路鄉,新福村,453,551,145,83,228,32,260
公投第１６案,嘉義縣,番路鄉,下坑村,454,1791,534,365,899,104,1003
公投第１６案,嘉義縣,番路鄉,番路村,455,849,232,239,471,67,538
公投第１６案,嘉義縣,番路鄉,民和村,456,866,158,279,437,55,492
公投第１６案,嘉義縣,番路鄉,觸口村,457,800,257,145,402,37,439
公投第１６案,嘉義縣,番路鄉,觸口村,458,444,124,99,223,28,251
公投第１６案,嘉義縣,番路鄉,大湖村,459,635,136,94,230,19,249
公投第１６案,嘉義縣,番路鄉,公田村,460,319,77,50,127,16,143
公投第１６案,嘉義縣,番路鄉,公田村,461,642,231,104,335,40,375
公投第１６案,嘉義縣,番路鄉,公興村,462,509,127,67,194,34,228
公投第１６案,嘉義縣,番路鄉,草山村,463,162,26,65,91,1,92
公投第１６案,嘉義縣,番路鄉,草山村,464,212,51,53,104,12,116
公投第１６案,嘉義縣,大埔鄉,大埔村,465,1468,437,282,719,84,803
公投第１６案,嘉義縣,大埔鄉,和平村,466,320,68,31,99,9,108
公投第１６案,嘉義縣,大埔鄉,和平村,467,304,94,66,160,8,168
公投第１６案,嘉義縣,大埔鄉,永樂村,468,184,46,45,91,2,93
公投第１６案,嘉義縣,大埔鄉,永樂村,469,234,67,74,141,14,155
公投第１６案,嘉義縣,大埔鄉,茄苳村,470,495,134,94,228,9,237
公投第１６案,嘉義縣,大埔鄉,茄苳村,471,199,59,44,103,4,107
公投第１６案,嘉義縣,大埔鄉,茄苳村,472,226,54,37,91,14,105
公投第１６案,嘉義縣,大埔鄉,西興村,473,569,206,116,322,27,349
公投第１６案,嘉義縣,阿里山鄉,中山村,474,371,95,71,166,8,174
公投第１６案,嘉義縣,阿里山鄉,中正村,475,197,53,25,78,6,84
公投第１６案,嘉義縣,阿里山鄉,香林村,476,152,37,31,68,2,70
公投第１６案,嘉義縣,阿里山鄉,十字村,477,231,36,33,69,8,77
公投第１６案,嘉義縣,阿里山鄉,十字村,478,72,17,4,21,0,21
公投第１６案,嘉義縣,阿里山鄉,豐山村,479,311,69,48,117,1,118
公投第１６案,嘉義縣,阿里山鄉,來吉村,480,306,92,60,152,11,163
公投第１６案,嘉義縣,阿里山鄉,樂野村,481,970,234,171,405,9,414
公投第１６案,嘉義縣,阿里山鄉,達邦村,482,827,248,173,421,33,454
公投第１６案,嘉義縣,阿里山鄉,里佳村,483,238,59,49,108,2,110
公投第１６案,嘉義縣,阿里山鄉,山美村,484,479,60,47,107,11,118
公投第１６案,嘉義縣,阿里山鄉,新美村,485,291,53,40,93,6,99
公投第１６案,嘉義縣,阿里山鄉,茶山村,486,246,84,57,141,16,157
公投第１６案,屏東縣,屏東市,端正里,1,237,69,53,122,6,128
公投第１６案,屏東縣,屏東市,武廟里,2,294,74,68,142,23,165
公投第１６案,屏東縣,屏東市,大同里,3,582,157,128,285,20,305
公投第１６案,屏東縣,屏東市,光榮里,4,713,211,158,369,28,397
公投第１６案,屏東縣,屏東市,民權里,5,572,167,123,290,25,315
公投第１６案,屏東縣,屏東市,泰安里,6,455,148,116,264,15,279
公投第１６案,屏東縣,屏東市,文明里,7,249,78,67,145,0,145
公投第１６案,屏東縣,屏東市,維新里,8,1315,322,220,542,41,583
公投第１６案,屏東縣,屏東市,維新里,9,1373,330,258,588,54,642
公投第１６案,屏東縣,屏東市,大埔里,10,713,223,168,391,49,440
公投第１６案,屏東縣,屏東市,必信里,11,573,200,122,322,46,368
公投第１６案,屏東縣,屏東市,崇禮里,12,297,90,86,176,22,198
公投第１６案,屏東縣,屏東市,崇智里,13,409,173,85,258,23,281
公投第１６案,屏東縣,屏東市,慶春里,14,286,81,64,145,15,160
公投第１６案,屏東縣,屏東市,楠樹里,15,421,118,99,217,14,231
公投第１６案,屏東縣,屏東市,扶風里,16,569,187,126,313,18,331
公投第１６案,屏東縣,屏東市,安樂里,17,459,122,113,235,15,250
公投第１６案,屏東縣,屏東市,平和里,18,672,205,191,396,29,425
公投第１６案,屏東縣,屏東市,金泉里,19,668,189,181,370,54,424
公投第１６案,屏東縣,屏東市,勝豐里,20,411,115,105,220,13,233
公投第１６案,屏東縣,屏東市,橋南里,21,768,219,177,396,46,442
公投第１６案,屏東縣,屏東市,橋南里,22,786,245,161,406,31,437
公投第１６案,屏東縣,屏東市,橋北里,23,890,287,187,474,47,521
公投第１６案,屏東縣,屏東市,大連里,24,1353,437,276,713,48,761
公投第１６案,屏東縣,屏東市,大連里,25,1386,403,293,696,39,735
公投第１６案,屏東縣,屏東市,大連里,26,1413,442,278,720,41,761
公投第１６案,屏東縣,屏東市,大連里,27,1272,371,280,651,39,690
公投第１６案,屏東縣,屏東市,大連里,28,1287,411,259,670,32,702
公投第１６案,屏東縣,屏東市,大連里,29,1311,432,276,708,46,754
公投第１６案,屏東縣,屏東市,大連里,30,1285,372,293,665,33,698
公投第１６案,屏東縣,屏東市,豐田里,31,1297,412,281,693,53,746
公投第１６案,屏東縣,屏東市,豐田里,32,1361,423,267,690,34,724
公投第１６案,屏東縣,屏東市,豐田里,33,1381,361,299,660,52,712
公投第１６案,屏東縣,屏東市,豐榮里,34,1258,393,284,677,64,741
公投第１６案,屏東縣,屏東市,豐榮里,35,1259,381,275,656,57,713
公投第１６案,屏東縣,屏東市,豐源里,36,1076,312,233,545,40,585
公投第１６案,屏東縣,屏東市,豐源里,37,1162,376,249,625,42,667
公投第１６案,屏東縣,屏東市,豐源里,38,1318,401,311,712,43,755
公投第１６案,屏東縣,屏東市,長春里,39,939,291,191,482,43,525
公投第１６案,屏東縣,屏東市,長春里,40,972,331,197,528,33,561
公投第１６案,屏東縣,屏東市,瑞光里,41,1535,508,308,816,45,861
公投第１６案,屏東縣,屏東市,瑞光里,42,1419,386,256,642,48,690
公投第１６案,屏東縣,屏東市,瑞光里,43,1398,371,270,641,32,673
公投第１６案,屏東縣,屏東市,瑞光里,44,1405,426,249,675,71,746
公投第１６案,屏東縣,屏東市,瑞光里,45,1486,464,311,775,37,812
公投第１６案,屏東縣,屏東市,湖南里,46,1061,301,235,536,57,593
公投第１６案,屏東縣,屏東市,湖西里,47,1540,416,227,643,103,746
公投第１６案,屏東縣,屏東市,歸心里,48,1141,284,219,503,25,528
公投第１６案,屏東縣,屏東市,清溪里,49,1247,329,240,569,43,612
公投第１６案,屏東縣,屏東市,清溪里,50,1446,404,285,689,44,733
公投第１６案,屏東縣,屏東市,清溪里,51,1303,409,285,694,50,744
公投第１６案,屏東縣,屏東市,大武里,52,1253,321,323,644,44,688
公投第１６案,屏東縣,屏東市,大武里,53,1315,413,259,672,43,715
公投第１６案,屏東縣,屏東市,大武里,54,1425,382,290,672,55,727
公投第１６案,屏東縣,屏東市,大武里,55,1423,384,293,677,39,716
公投第１６案,屏東縣,屏東市,大武里,56,1400,453,282,735,45,780
公投第１６案,屏東縣,屏東市,大武里,57,1359,396,345,741,47,788
公投第１６案,屏東縣,屏東市,崇武里,58,1328,446,217,663,52,715
公投第１６案,屏東縣,屏東市,崇武里,59,1539,479,286,765,41,806
公投第１６案,屏東縣,屏東市,凌雲里,60,391,74,53,127,7,134
公投第１６案,屏東縣,屏東市,永昌里,61,200,57,48,105,12,117
公投第１６案,屏東縣,屏東市,永順里,62,328,88,49,137,28,165
公投第１６案,屏東縣,屏東市,鵬程里,63,231,70,47,117,4,121
公投第１６案,屏東縣,屏東市,安鎮里,64,945,278,184,462,56,518
公投第１６案,屏東縣,屏東市,安鎮里,65,1053,287,210,497,56,553
公投第１６案,屏東縣,屏東市,永光里,66,1043,269,199,468,61,529
公投第１６案,屏東縣,屏東市,長安里,67,1061,287,193,480,79,559
公投第１６案,屏東縣,屏東市,長安里,68,876,237,174,411,41,452
公投第１６案,屏東縣,屏東市,前進里,69,1468,440,267,707,102,809
公投第１６案,屏東縣,屏東市,前進里,70,1454,385,249,634,79,713
公投第１６案,屏東縣,屏東市,大洲里,71,1205,350,242,592,39,631
公投第１６案,屏東縣,屏東市,新興里,72,1284,340,295,635,0,635
公投第１６案,屏東縣,屏東市,新興里,73,1219,340,241,581,37,618
公投第１６案,屏東縣,屏東市,公館里,74,1544,450,333,783,89,872
公投第１６案,屏東縣,屏東市,新生里,75,1485,414,290,704,104,808
公投第１６案,屏東縣,屏東市,新生里,76,1387,426,274,700,69,769
公投第１６案,屏東縣,屏東市,新生里,77,953,268,183,451,28,479
公投第１６案,屏東縣,屏東市,新生里,78,1603,431,394,825,49,874
公投第１６案,屏東縣,屏東市,頂宅里,79,535,153,98,251,36,287
公投第１６案,屏東縣,屏東市,頂柳里,80,1119,345,197,542,46,588
公投第１６案,屏東縣,屏東市,大湖里,81,847,278,154,432,39,471
公投第１６案,屏東縣,屏東市,大湖里,82,923,273,200,473,73,546
公投第１６案,屏東縣,屏東市,龍華里,83,1227,323,246,569,46,615
公投第１６案,屏東縣,屏東市,龍華里,84,1039,301,210,511,57,568
公投第１６案,屏東縣,屏東市,玉成里,85,1485,371,319,690,104,794
公投第１６案,屏東縣,屏東市,擇仁里,86,867,251,175,426,62,488
公投第１６案,屏東縣,屏東市,建國里,87,918,288,191,479,43,522
公投第１６案,屏東縣,屏東市,萬年里,88,663,175,116,291,52,343
公投第１６案,屏東縣,屏東市,厚生里,89,1215,311,206,517,30,547
公投第１６案,屏東縣,屏東市,厚生里,90,1628,412,300,712,96,808
公投第１６案,屏東縣,屏東市,一心里,91,1209,369,252,621,51,672
公投第１６案,屏東縣,屏東市,義勇里,92,1110,414,262,676,24,700
公投第１６案,屏東縣,屏東市,光華里,93,684,159,140,299,22,321
公投第１６案,屏東縣,屏東市,永安里,94,1349,330,216,546,37,583
公投第１６案,屏東縣,屏東市,永安里,95,1457,402,249,651,63,714
公投第１６案,屏東縣,屏東市,永安里,96,1447,440,352,792,47,839
公投第１６案,屏東縣,屏東市,永安里,97,1354,382,256,638,31,669
公投第１６案,屏東縣,屏東市,永安里,98,1583,484,324,808,76,884
公投第１６案,屏東縣,屏東市,崇蘭里,99,1707,558,287,845,24,869
公投第１６案,屏東縣,屏東市,崇蘭里,100,1637,436,303,739,44,783
公投第１６案,屏東縣,屏東市,崇蘭里,101,1459,422,265,687,45,732
公投第１６案,屏東縣,屏東市,崇蘭里,102,1759,567,324,891,43,934
公投第１６案,屏東縣,屏東市,崇蘭里,103,1950,635,317,952,51,1003
公投第１６案,屏東縣,屏東市,崇蘭里,104,1729,543,317,860,63,923
公投第１６案,屏東縣,屏東市,崇蘭里,105,1592,462,283,745,43,788
公投第１６案,屏東縣,屏東市,潭墘里,106,1437,425,254,679,41,720
公投第１６案,屏東縣,屏東市,潭墘里,107,1204,355,214,569,33,602
公投第１６案,屏東縣,屏東市,潭墘里,108,1340,441,252,693,39,732
公投第１６案,屏東縣,屏東市,潭墘里,109,1322,391,284,675,42,717
公投第１６案,屏東縣,屏東市,潭墘里,110,1462,439,256,695,33,728
公投第１６案,屏東縣,屏東市,潭墘里,111,3241,988,539,1527,64,1591
公投第１６案,屏東縣,屏東市,潭墘里,112,1477,471,225,696,23,719
公投第１６案,屏東縣,屏東市,永城里,113,821,213,150,363,34,397
公投第１６案,屏東縣,屏東市,永城里,114,1099,254,187,441,27,468
公投第１６案,屏東縣,屏東市,空翔里,115,1688,536,274,810,58,868
公投第１６案,屏東縣,屏東市,廣興里,116,1167,299,234,533,48,581
公投第１６案,屏東縣,屏東市,廣興里,117,915,247,190,437,52,489
公投第１６案,屏東縣,屏東市,勝利里,118,1683,281,199,480,43,523
公投第１６案,屏東縣,屏東市,勝利里,119,1497,447,279,726,20,746
公投第１６案,屏東縣,屏東市,勝利里,120,1129,281,258,539,31,570
公投第１６案,屏東縣,屏東市,勝利里,121,1232,394,235,629,38,667
公投第１６案,屏東縣,屏東市,斯文里,122,853,255,180,435,29,464
公投第１６案,屏東縣,屏東市,斯文里,123,869,288,193,481,24,505
公投第１６案,屏東縣,屏東市,華山里,124,1169,379,241,620,49,669
公投第１６案,屏東縣,屏東市,華山里,125,1058,334,217,551,37,588
公投第１６案,屏東縣,屏東市,華山里,126,1344,382,246,628,44,672
公投第１６案,屏東縣,屏東市,華山里,127,1299,459,259,718,29,747
公投第１６案,屏東縣,屏東市,溝美里,128,1204,313,219,532,47,579
公投第１６案,屏東縣,屏東市,溝美里,129,1123,326,225,551,38,589
公投第１６案,屏東縣,屏東市,三山里,130,1318,328,211,539,45,584
公投第１６案,屏東縣,屏東市,海豐里,131,865,278,182,460,57,517
公投第１６案,屏東縣,屏東市,仁義里,132,1100,257,186,443,32,475
公投第１６案,屏東縣,屏東市,北興里,133,1215,351,208,559,16,575
公投第１６案,屏東縣,屏東市,北興里,134,1370,401,286,687,39,726
公投第１６案,屏東縣,屏東市,北興里,135,1240,365,245,610,19,629
公投第１６案,屏東縣,屏東市,北興里,136,1168,391,232,623,44,667
公投第１６案,屏東縣,屏東市,北興里,137,1079,331,222,553,30,583
公投第１６案,屏東縣,屏東市,北勢里,138,1289,413,265,678,61,739
公投第１６案,屏東縣,屏東市,北勢里,139,1115,324,216,540,44,584
公投第１６案,屏東縣,屏東市,中正里,140,1491,572,216,788,52,840
公投第１６案,屏東縣,屏東市,中正里,141,1411,400,224,624,55,679
公投第１６案,屏東縣,屏東市,中正里,142,1803,547,316,863,33,896
公投第１６案,屏東縣,屏東市,興樂里,143,744,234,158,392,34,426
公投第１６案,屏東縣,屏東市,明正里,144,678,198,140,338,29,367
公投第１６案,屏東縣,屏東市,太平里,145,681,206,166,372,28,400
公投第１６案,屏東縣,屏東市,信和里,146,1535,346,272,618,45,663
公投第１６案,屏東縣,屏東市,和興里,147,954,280,187,467,72,539
公投第１６案,屏東縣,屏東市,仁愛里,148,1018,320,239,559,56,615
公投第１６案,屏東縣,屏東市,仁愛里,149,1154,349,265,614,37,651
公投第１６案,屏東縣,潮州鎮,潮州里,150,504,153,114,267,38,305
公投第１６案,屏東縣,潮州鎮,光華里,151,1711,448,304,752,57,809
公投第１６案,屏東縣,潮州鎮,光華里,152,1634,503,310,813,34,847
公投第１６案,屏東縣,潮州鎮,光華里,153,1414,365,253,618,39,657
公投第１６案,屏東縣,潮州鎮,同榮里,154,603,180,146,326,50,376
公投第１６案,屏東縣,潮州鎮,彭城里,155,896,254,161,415,73,488
公投第１６案,屏東縣,潮州鎮,三星里,156,1285,354,259,613,63,676
公投第１６案,屏東縣,潮州鎮,三星里,157,1744,477,326,803,66,869
公投第１６案,屏東縣,潮州鎮,三星里,158,1071,326,241,567,48,615
公投第１６案,屏東縣,潮州鎮,三星里,159,1209,375,267,642,63,705
公投第１６案,屏東縣,潮州鎮,三共里,160,1159,327,229,556,55,611
公投第１６案,屏東縣,潮州鎮,三共里,161,1296,348,253,601,58,659
公投第１６案,屏東縣,潮州鎮,三共里,162,1466,446,289,735,53,788
公投第１６案,屏東縣,潮州鎮,三共里,163,1130,292,292,584,62,646
公投第１６案,屏東縣,潮州鎮,三共里,164,1439,436,275,711,58,769
公投第１６案,屏東縣,潮州鎮,三和里,165,897,266,218,484,47,531
公投第１６案,屏東縣,潮州鎮,三和里,166,1225,444,200,644,50,694
公投第１６案,屏東縣,潮州鎮,九塊里,167,1158,328,202,530,55,585
公投第１６案,屏東縣,潮州鎮,九塊里,168,481,100,75,175,42,217
公投第１６案,屏東縣,潮州鎮,新生里,169,972,260,242,502,47,549
公投第１６案,屏東縣,潮州鎮,新榮里,170,1245,363,319,682,2,684
公投第１６案,屏東縣,潮州鎮,五魁里,171,1415,412,273,685,65,750
公投第１６案,屏東縣,潮州鎮,蓬萊里,172,1255,290,244,534,25,559
公投第１６案,屏東縣,潮州鎮,蓬萊里,173,1058,243,139,382,30,412
公投第１６案,屏東縣,潮州鎮,八爺里,174,1187,328,245,573,40,613
公投第１６案,屏東縣,潮州鎮,八爺里,175,1083,308,228,536,75,611
公投第１６案,屏東縣,潮州鎮,永春里,176,1590,392,314,706,47,753
公投第１６案,屏東縣,潮州鎮,永春里,177,1543,467,296,763,77,840
公投第１６案,屏東縣,潮州鎮,永春里,178,1631,452,293,745,67,812
公投第１６案,屏東縣,潮州鎮,永春里,179,1159,394,226,620,41,661
公投第１６案,屏東縣,潮州鎮,永春里,180,1099,338,240,578,36,614
公投第１６案,屏東縣,潮州鎮,富春里,181,1200,331,213,544,51,595
公投第１６案,屏東縣,潮州鎮,光春里,182,1391,388,245,633,71,704
公投第１６案,屏東縣,潮州鎮,興美里,183,881,254,183,437,65,502
公投第１６案,屏東縣,潮州鎮,檨子里,184,454,106,67,173,25,198
公投第１６案,屏東縣,潮州鎮,泗林里,185,1658,422,357,779,101,880
公投第１６案,屏東縣,潮州鎮,四春里,186,822,212,136,348,42,390
公投第１６案,屏東縣,潮州鎮,四春里,187,948,229,157,386,18,404
公投第１６案,屏東縣,潮州鎮,崙東里,188,1194,250,195,445,36,481
公投第１６案,屏東縣,潮州鎮,崙東里,189,337,84,64,148,43,191
公投第１６案,屏東縣,東港鎮,新勝里,190,981,294,233,527,69,596
公投第１６案,屏東縣,東港鎮,新勝里,191,1070,313,258,571,62,633
公投第１６案,屏東縣,東港鎮,頂新里,192,527,177,112,289,54,343
公投第１６案,屏東縣,東港鎮,頂中里,193,395,109,99,208,31,239
公投第１６案,屏東縣,東港鎮,東和里,194,659,151,139,290,48,338
公投第１６案,屏東縣,東港鎮,興台里,195,513,140,107,247,31,278
公投第１６案,屏東縣,東港鎮,興東里,196,1732,488,318,806,80,886
公投第１６案,屏東縣,東港鎮,興東里,197,1779,484,400,884,64,948
公投第１６案,屏東縣,東港鎮,興東里,198,1270,360,228,588,58,646
公投第１６案,屏東縣,東港鎮,興東里,199,1327,348,269,617,79,696
公投第１６案,屏東縣,東港鎮,興東里,200,1242,319,297,616,78,694
公投第１６案,屏東縣,東港鎮,興東里,201,1607,441,334,775,108,883
公投第１６案,屏東縣,東港鎮,興農里,202,1305,336,239,575,53,628
公投第１６案,屏東縣,東港鎮,中興里,203,695,199,149,348,45,393
公投第１６案,屏東縣,東港鎮,朝安里,204,1076,318,225,543,117,660
公投第１６案,屏東縣,東港鎮,朝安里,205,567,136,116,252,41,293
公投第１６案,屏東縣,東港鎮,八德里,206,806,220,150,370,47,417
公投第１６案,屏東縣,東港鎮,東隆里,207,1227,336,259,595,88,683
公投第１６案,屏東縣,東港鎮,豐漁里,208,599,151,118,269,55,324
公投第１６案,屏東縣,東港鎮,盛漁里,209,1354,301,192,493,59,552
公投第１６案,屏東縣,東港鎮,興漁里,210,734,187,140,327,62,389
公投第１６案,屏東縣,東港鎮,興漁里,211,1107,281,211,492,143,635
公投第１６案,屏東縣,東港鎮,鎮海里,212,1198,300,188,488,103,591
公投第１６案,屏東縣,東港鎮,鎮海里,213,1614,407,276,683,135,818
公投第１６案,屏東縣,東港鎮,嘉蓮里,214,826,195,175,370,53,423
公投第１６案,屏東縣,東港鎮,嘉蓮里,215,912,185,250,435,80,515
公投第１６案,屏東縣,東港鎮,南平里,216,432,85,96,181,42,223
公投第１６案,屏東縣,東港鎮,南平里,217,1204,346,219,565,119,684
公投第１６案,屏東縣,東港鎮,船頭里,218,1304,370,271,641,83,724
公投第１６案,屏東縣,東港鎮,船頭里,219,1317,404,282,686,82,768
公投第１６案,屏東縣,東港鎮,船頭里,220,1387,382,273,655,49,704
公投第１６案,屏東縣,東港鎮,船頭里,221,1310,312,242,554,40,594
公投第１６案,屏東縣,東港鎮,下廍里,222,1228,318,217,535,62,597
公投第１６案,屏東縣,東港鎮,下廍里,223,766,181,138,319,55,374
公投第１６案,屏東縣,東港鎮,大潭里,224,823,226,175,401,73,474
公投第１６案,屏東縣,東港鎮,大潭里,225,755,158,87,245,28,273
公投第１６案,屏東縣,東港鎮,興和里,226,1094,292,217,509,112,621
公投第１６案,屏東縣,東港鎮,共和里,227,753,218,122,340,31,371
公投第１６案,屏東縣,恆春鎮,城南里,228,902,196,205,401,37,438
公投第１６案,屏東縣,恆春鎮,城北里,229,969,273,244,517,37,554
公投第１６案,屏東縣,恆春鎮,城北里,230,1280,334,249,583,46,629
公投第１６案,屏東縣,恆春鎮,城西里,231,1133,340,232,572,35,607
公投第１６案,屏東縣,恆春鎮,網紗里,232,1552,374,231,605,22,627
公投第１６案,屏東縣,恆春鎮,網紗里,233,1485,306,252,558,61,619
公投第１６案,屏東縣,恆春鎮,仁壽里,234,896,244,201,445,35,480
公投第１６案,屏東縣,恆春鎮,茄湖里,235,531,132,86,218,29,247
公投第１６案,屏東縣,恆春鎮,頭溝里,236,478,116,84,200,13,213
公投第１６案,屏東縣,恆春鎮,四溝里,237,1020,267,183,450,39,489
公投第１６案,屏東縣,恆春鎮,德和里,238,924,220,196,416,24,440
公投第１６案,屏東縣,恆春鎮,龍水里,239,1079,254,174,428,21,449
公投第１６案,屏東縣,恆春鎮,山海里,240,775,150,109,259,29,288
公投第１６案,屏東縣,恆春鎮,山海里,241,813,239,138,377,59,436
公投第１６案,屏東縣,恆春鎮,大光里,242,1104,276,192,468,53,521
公投第１６案,屏東縣,恆春鎮,大光里,243,1110,240,193,433,59,492
公投第１６案,屏東縣,恆春鎮,水泉里,244,692,127,99,226,71,297
公投第１６案,屏東縣,恆春鎮,水泉里,245,708,132,99,231,10,241
公投第１６案,屏東縣,恆春鎮,山腳里,246,1505,377,290,667,40,707
公投第１６案,屏東縣,恆春鎮,山腳里,247,1111,279,197,476,41,517
公投第１６案,屏東縣,恆春鎮,山腳里,248,1543,367,283,650,53,703
公投第１６案,屏東縣,恆春鎮,南灣里,249,828,180,126,306,22,328
公投第１６案,屏東縣,恆春鎮,南灣里,250,844,227,181,408,33,441
公投第１６案,屏東縣,恆春鎮,墾丁里,251,1253,311,249,560,48,608
公投第１６案,屏東縣,恆春鎮,鵝鑾里,252,1126,265,205,470,43,513
公投第１６案,屏東縣,萬丹鄉,香社村,253,1527,351,249,600,52,652
公投第１６案,屏東縣,萬丹鄉,新庄村,254,1147,300,202,502,67,569
公投第１６案,屏東縣,萬丹鄉,新庄村,255,949,207,191,398,52,450
公投第１６案,屏東縣,萬丹鄉,新鐘村,256,990,261,181,442,36,478
公投第１６案,屏東縣,萬丹鄉,新鐘村,257,1022,224,186,410,24,434
公投第１６案,屏東縣,萬丹鄉,水仙村,258,545,175,125,300,67,367
公投第１６案,屏東縣,萬丹鄉,興全村,259,1159,357,212,569,110,679
公投第１６案,屏東縣,萬丹鄉,興安村,260,837,238,172,410,84,494
公投第１６案,屏東縣,萬丹鄉,甘棠村,261,392,120,58,178,18,196
公投第１６案,屏東縣,萬丹鄉,萬惠村,262,847,247,193,440,46,486
公投第１６案,屏東縣,萬丹鄉,萬全村,263,1149,307,218,525,56,581
公投第１６案,屏東縣,萬丹鄉,萬全村,264,1131,317,234,551,54,605
公投第１６案,屏東縣,萬丹鄉,萬全村,265,1178,329,223,552,57,609
公投第１６案,屏東縣,萬丹鄉,萬後村,266,711,196,194,390,36,426
公投第１６案,屏東縣,萬丹鄉,萬安村,267,595,203,128,331,27,358
公投第１６案,屏東縣,萬丹鄉,萬生村,268,1403,255,487,742,63,805
公投第１６案,屏東縣,萬丹鄉,寶厝村,269,1094,291,214,505,35,540
公投第１６案,屏東縣,萬丹鄉,寶厝村,270,1158,318,265,583,58,641
公投第１６案,屏東縣,萬丹鄉,四維村,271,963,290,225,515,83,598
公投第１６案,屏東縣,萬丹鄉,四維村,272,1062,272,235,507,58,565
公投第１６案,屏東縣,萬丹鄉,竹林村,273,1684,453,335,788,99,887
公投第１６案,屏東縣,萬丹鄉,水泉村,274,1702,466,290,756,44,800
公投第１６案,屏東縣,萬丹鄉,田厝村,275,976,251,218,469,56,525
公投第１６案,屏東縣,萬丹鄉,崙頂村,276,1013,289,199,488,67,555
公投第１６案,屏東縣,萬丹鄉,崙頂村,277,847,151,192,343,39,382
公投第１６案,屏東縣,萬丹鄉,厦北村,278,1570,469,298,767,145,912
公投第１６案,屏東縣,萬丹鄉,厦南村,279,1411,363,236,599,93,692
公投第１６案,屏東縣,萬丹鄉,後村村,280,1046,303,210,513,90,603
公投第１６案,屏東縣,萬丹鄉,灣內村,281,1385,346,257,603,48,651
公投第１６案,屏東縣,萬丹鄉,上村村,282,804,221,160,381,65,446
公投第１６案,屏東縣,萬丹鄉,加興村,283,1284,343,250,593,103,696
公投第１６案,屏東縣,萬丹鄉,社口村,284,1430,378,258,636,65,701
公投第１６案,屏東縣,萬丹鄉,磚寮村,285,960,319,195,514,82,596
公投第１６案,屏東縣,萬丹鄉,社皮村,286,786,237,181,418,57,475
公投第１６案,屏東縣,萬丹鄉,社皮村,287,1158,297,265,562,87,649
公投第１６案,屏東縣,萬丹鄉,社中村,288,1647,358,265,623,80,703
公投第１６案,屏東縣,萬丹鄉,社上村,289,1666,413,266,679,94,773
公投第１６案,屏東縣,萬丹鄉,廣安村,290,1023,322,213,535,89,624
公投第１６案,屏東縣,萬丹鄉,廣安村,291,1227,381,256,637,77,714
公投第１６案,屏東縣,長治鄉,進興村,292,1018,291,204,495,71,566
公投第１６案,屏東縣,長治鄉,進興村,293,1614,465,325,790,86,876
公投第１６案,屏東縣,長治鄉,新潭村,294,1848,559,385,944,100,1044
公投第１６案,屏東縣,長治鄉,新潭村,295,1707,622,224,846,74,920
公投第１６案,屏東縣,長治鄉,潭頭村,296,972,319,195,514,34,548
公投第１６案,屏東縣,長治鄉,潭頭村,297,989,187,312,499,64,563
公投第１６案,屏東縣,長治鄉,香楊村,298,735,212,170,382,62,444
公投第１６案,屏東縣,長治鄉,香楊村,299,1813,472,351,823,70,893
公投第１６案,屏東縣,長治鄉,長興村,300,1073,348,248,596,55,651
公投第１６案,屏東縣,長治鄉,崙上村,301,1654,528,268,796,83,879
公投第１６案,屏東縣,長治鄉,德榮村,302,1205,335,268,603,72,675
公投第１６案,屏東縣,長治鄉,德和村,303,758,226,158,384,48,432
公投第１６案,屏東縣,長治鄉,復興村,304,1492,413,296,709,99,808
公投第１６案,屏東縣,長治鄉,德成村,305,884,262,177,439,65,504
公投第１６案,屏東縣,長治鄉,德協村,306,1090,292,244,536,75,611
公投第１６案,屏東縣,長治鄉,繁榮村,307,1422,356,215,571,114,685
公投第１６案,屏東縣,長治鄉,繁昌村,308,845,233,163,396,67,463
公投第１６案,屏東縣,長治鄉,繁昌村,309,925,239,169,408,123,531
公投第１６案,屏東縣,長治鄉,繁隆村,310,1138,304,206,510,106,616
公投第１６案,屏東縣,長治鄉,繁華村,311,1242,307,272,579,119,698
公投第１６案,屏東縣,長治鄉,繁華村,312,1159,259,187,446,25,471
公投第１６案,屏東縣,長治鄉,榮華村,313,673,215,148,363,39,402
公投第１６案,屏東縣,麟洛鄉,新田村,314,788,217,177,394,51,445
公投第１６案,屏東縣,麟洛鄉,新田村,315,1386,454,313,767,33,800
公投第１６案,屏東縣,麟洛鄉,麟頂村,316,957,304,222,526,58,584
公投第１６案,屏東縣,麟洛鄉,麟蹄村,317,731,219,181,400,46,446
公投第１６案,屏東縣,麟洛鄉,麟蹄村,318,806,253,194,447,57,504
公投第１６案,屏東縣,麟洛鄉,麟趾村,319,1207,302,246,548,23,571
公投第１６案,屏東縣,麟洛鄉,麟趾村,320,1340,409,327,736,80,816
公投第１６案,屏東縣,麟洛鄉,田中村,321,1221,367,275,642,66,708
公投第１６案,屏東縣,麟洛鄉,田心村,322,851,237,168,405,22,427
公投第１６案,屏東縣,麟洛鄉,田道村,323,683,173,136,309,14,323
公投第１６案,屏東縣,九如鄉,九清村,324,1491,342,400,742,100,842
公投第１６案,屏東縣,九如鄉,九塊村,325,1375,380,276,656,81,737
公投第１６案,屏東縣,九如鄉,九明村,326,1678,427,303,730,69,799
公投第１６案,屏東縣,九如鄉,大坵村,327,1166,333,257,590,89,679
公投第１６案,屏東縣,九如鄉,玉水村,328,1276,296,211,507,46,553
公投第１６案,屏東縣,九如鄉,玉泉村,329,1033,273,236,509,74,583
公投第１６案,屏東縣,九如鄉,玉泉村,330,577,212,141,353,44,397
公投第１６案,屏東縣,九如鄉,東寧村,331,649,190,139,329,74,403
公投第１６案,屏東縣,九如鄉,東寧村,332,1999,553,367,920,172,1092
公投第１６案,屏東縣,九如鄉,東寧村,333,1766,480,328,808,107,915
公投第１６案,屏東縣,九如鄉,三塊村,334,1600,401,319,720,108,828
公投第１６案,屏東縣,九如鄉,耆老村,335,1248,328,263,591,90,681
公投第１６案,屏東縣,九如鄉,後庄村,336,1792,448,402,850,188,1038
公投第１６案,屏東縣,九如鄉,洽興村,337,1482,433,261,694,123,817
公投第１６案,屏東縣,里港鄉,玉田村,338,1552,492,334,826,90,916
公投第１６案,屏東縣,里港鄉,玉田村,339,1480,404,287,691,97,788
公投第１６案,屏東縣,里港鄉,塔樓村,340,1534,324,300,624,61,685
公投第１６案,屏東縣,里港鄉,潮厝村,341,1578,413,308,721,131,852
公投第１６案,屏東縣,里港鄉,大平村,342,1127,300,295,595,72,667
公投第１６案,屏東縣,里港鄉,永春村,343,845,249,192,441,57,498
公投第１６案,屏東縣,里港鄉,春林村,344,1282,360,257,617,68,685
公投第１６案,屏東縣,里港鄉,過江村,345,981,281,209,490,79,569
公投第１６案,屏東縣,里港鄉,過江村,346,1031,295,226,521,78,599
公投第１６案,屏東縣,里港鄉,鐵店村,347,1423,390,279,669,125,794
公投第１６案,屏東縣,里港鄉,茄苳村,348,363,73,64,137,29,166
公投第１６案,屏東縣,里港鄉,茄苳村,349,1203,312,313,625,75,700
公投第１６案,屏東縣,里港鄉,載興村,350,1027,294,260,554,83,637
公投第１６案,屏東縣,里港鄉,載興村,351,1384,340,246,586,76,662
公投第１６案,屏東縣,里港鄉,土庫村,352,1512,406,282,688,96,784
公投第１６案,屏東縣,里港鄉,土庫村,353,522,175,111,286,22,308
公投第１６案,屏東縣,里港鄉,三廍村,354,822,210,178,388,71,459
公投第１６案,屏東縣,里港鄉,三廍村,355,1007,234,198,432,96,528
公投第１６案,屏東縣,里港鄉,中和村,356,956,244,216,460,77,537
公投第１６案,屏東縣,里港鄉,瀰力村,357,499,149,101,250,32,282
公投第１６案,屏東縣,鹽埔鄉,鹽北村,358,951,266,175,441,42,483
公投第１６案,屏東縣,鹽埔鄉,鹽北村,359,899,229,157,386,36,422
公投第１６案,屏東縣,鹽埔鄉,鹽中村,360,1116,264,190,454,35,489
公投第１６案,屏東縣,鹽埔鄉,鹽中村,361,1241,332,240,572,50,622
公投第１６案,屏東縣,鹽埔鄉,鹽南村,362,770,210,128,338,50,388
公投第１６案,屏東縣,鹽埔鄉,鹽南村,363,962,301,155,456,47,503
公投第１６案,屏東縣,鹽埔鄉,仕絨村,364,1041,323,246,569,62,631
公投第１６案,屏東縣,鹽埔鄉,高朗村,365,1367,408,267,675,35,710
公投第１６案,屏東縣,鹽埔鄉,高朗村,366,1465,368,220,588,73,661
公投第１６案,屏東縣,鹽埔鄉,振興村,367,894,218,147,365,53,418
公投第１６案,屏東縣,鹽埔鄉,振興村,368,958,234,157,391,3,394
公投第１６案,屏東縣,鹽埔鄉,久愛村,369,924,224,107,331,107,438
公投第１６案,屏東縣,鹽埔鄉,新圍村,370,1598,359,280,639,50,689
公投第１６案,屏東縣,鹽埔鄉,新圍村,371,1550,377,324,701,128,829
公投第１６案,屏東縣,鹽埔鄉,新二村,372,1127,299,213,512,90,602
公投第１６案,屏東縣,鹽埔鄉,新二村,373,1150,352,226,578,91,669
公投第１６案,屏東縣,鹽埔鄉,新二村,374,1233,351,253,604,69,673
公投第１６案,屏東縣,鹽埔鄉,彭厝村,375,984,309,184,493,99,592
公投第１６案,屏東縣,鹽埔鄉,洛陽村,376,1619,457,325,782,76,858
公投第１６案,屏東縣,鹽埔鄉,永隆村,377,553,165,108,273,35,308
公投第１６案,屏東縣,高樹鄉,高樹村,378,883,229,223,452,92,544
公投第１６案,屏東縣,高樹鄉,高樹村,379,1255,255,178,433,36,469
公投第１６案,屏東縣,高樹鄉,長榮村,380,1278,432,174,606,39,645
公投第１６案,屏東縣,高樹鄉,東興村,381,738,169,124,293,31,324
公投第１６案,屏東縣,高樹鄉,東振村,382,585,123,110,233,16,249
公投第１６案,屏東縣,高樹鄉,源泉村,383,1012,250,235,485,108,593
公投第１６案,屏東縣,高樹鄉,建興村,384,1148,293,181,474,93,567
公投第１６案,屏東縣,高樹鄉,大埔村,385,591,151,109,260,35,295
公投第１６案,屏東縣,高樹鄉,菜寮村,386,786,159,141,300,53,353
公投第１６案,屏東縣,高樹鄉,司馬村,387,649,151,99,250,31,281
公投第１６案,屏東縣,高樹鄉,舊寮村,388,1229,258,172,430,75,505
公投第１６案,屏東縣,高樹鄉,新豐村,389,1446,296,239,535,64,599
公投第１６案,屏東縣,高樹鄉,泰山村,390,899,188,141,329,20,349
公投第１６案,屏東縣,高樹鄉,泰山村,391,922,243,166,409,63,472
公投第１６案,屏東縣,高樹鄉,南華村,392,1259,304,198,502,85,587
公投第１６案,屏東縣,高樹鄉,廣福村,393,1056,205,160,365,32,397
公投第１６案,屏東縣,高樹鄉,廣興村,394,1116,317,222,539,75,614
公投第１６案,屏東縣,高樹鄉,舊庄村,395,1020,289,198,487,82,569
公投第１６案,屏東縣,高樹鄉,田子村,396,1055,276,203,479,93,572
公投第１６案,屏東縣,高樹鄉,鹽樹村,397,738,217,163,380,55,435
公投第１６案,屏東縣,高樹鄉,鹽樹村,398,493,117,78,195,32,227
公投第１６案,屏東縣,高樹鄉,新南村,399,1539,421,329,750,120,870
公投第１６案,屏東縣,萬巒鄉,萬巒村,400,1239,297,236,533,45,578
公投第１６案,屏東縣,萬巒鄉,萬全村,401,759,188,181,369,62,431
公投第１６案,屏東縣,萬巒鄉,萬和村,402,932,258,191,449,106,555
公投第１６案,屏東縣,萬巒鄉,萬和村,403,769,208,189,397,68,465
公投第１６案,屏東縣,萬巒鄉,鹿寮村,404,920,222,192,414,87,501
公投第１６案,屏東縣,萬巒鄉,硫黃村,405,560,144,126,270,52,322
公投第１６案,屏東縣,萬巒鄉,泗溝村,406,1120,289,174,463,36,499
公投第１６案,屏東縣,萬巒鄉,五溝村,407,1048,297,157,454,40,494
公投第１６案,屏東縣,萬巒鄉,成德村,408,1438,331,234,565,58,623
公投第１６案,屏東縣,萬巒鄉,赤山村,409,834,205,141,346,69,415
公投第１６案,屏東縣,萬巒鄉,赤山村,410,813,193,153,346,77,423
公投第１６案,屏東縣,萬巒鄉,萬金村,411,1020,237,148,385,47,432
公投第１６案,屏東縣,萬巒鄉,萬金村,412,1007,289,209,498,80,578
公投第１６案,屏東縣,萬巒鄉,佳佐村,413,1648,352,278,630,99,729
公投第１６案,屏東縣,萬巒鄉,佳和村,414,1437,346,283,629,86,715
公投第１６案,屏東縣,萬巒鄉,新厝村,415,1228,277,195,472,33,505
公投第１６案,屏東縣,萬巒鄉,新置村,416,597,214,84,298,62,360
公投第１６案,屏東縣,萬巒鄉,新置村,417,576,130,129,259,54,313
公投第１６案,屏東縣,內埔鄉,內埔村,418,1305,311,242,553,43,596
公投第１６案,屏東縣,內埔鄉,內埔村,419,1287,327,218,545,42,587
公投第１６案,屏東縣,內埔鄉,內埔村,420,1387,342,262,604,19,623
公投第１６案,屏東縣,內埔鄉,內田村,421,1540,379,273,652,67,719
公投第１６案,屏東縣,內埔鄉,內田村,422,1605,384,304,688,62,750
公投第１６案,屏東縣,內埔鄉,興南村,423,1326,349,228,577,78,655
公投第１６案,屏東縣,內埔鄉,義亭村,424,591,147,125,272,63,335
公投第１６案,屏東縣,內埔鄉,美和村,425,1123,296,171,467,64,531
公投第１６案,屏東縣,內埔鄉,美和村,426,1079,302,189,491,23,514
公投第１６案,屏東縣,內埔鄉,和興村,427,1485,396,295,691,76,767
公投第１６案,屏東縣,內埔鄉,和興村,428,1248,407,246,653,45,698
公投第１６案,屏東縣,內埔鄉,東寧村,429,1569,229,301,530,64,594
公投第１６案,屏東縣,內埔鄉,東寧村,430,1493,377,269,646,67,713
公投第１６案,屏東縣,內埔鄉,東寧村,431,1420,347,246,593,22,615
公投第１６案,屏東縣,內埔鄉,豐田村,432,1334,352,265,617,78,695
公投第１６案,屏東縣,內埔鄉,豐田村,433,1519,400,255,655,81,736
公投第１６案,屏東縣,內埔鄉,振豐村,434,784,221,150,371,50,421
公投第１６案,屏東縣,內埔鄉,振豐村,435,888,249,178,427,73,500
公投第１６案,屏東縣,內埔鄉,富田村,436,747,149,100,249,16,265
公投第１６案,屏東縣,內埔鄉,富田村,437,1168,253,183,436,27,463
公投第１６案,屏東縣,內埔鄉,竹圍村,438,546,145,124,269,42,311
公投第１６案,屏東縣,內埔鄉,竹圍村,439,1278,332,249,581,56,637
公投第１６案,屏東縣,內埔鄉,東勢村,440,1348,289,225,514,67,581
公投第１６案,屏東縣,內埔鄉,東勢村,441,1550,329,234,563,84,647
公投第１６案,屏東縣,內埔鄉,東片村,442,947,284,215,499,78,577
公投第１６案,屏東縣,內埔鄉,上樹村,443,1097,290,189,479,83,562
公投第１６案,屏東縣,內埔鄉,老埤村,444,1128,229,178,407,65,472
公投第１６案,屏東縣,內埔鄉,老埤村,445,1253,196,177,373,35,408
公投第１６案,屏東縣,內埔鄉,中林村,446,1525,272,267,539,31,570
公投第１６案,屏東縣,內埔鄉,龍泉村,447,1215,316,239,555,78,633
公投第１６案,屏東縣,內埔鄉,龍泉村,448,1216,260,201,461,34,495
公投第１６案,屏東縣,內埔鄉,龍潭村,449,1353,353,204,557,32,589
公投第１６案,屏東縣,內埔鄉,龍潭村,450,1026,257,194,451,41,492
公投第１６案,屏東縣,內埔鄉,建興村,451,862,209,135,344,41,385
公投第１６案,屏東縣,內埔鄉,大新村,452,921,172,139,311,40,351
公投第１６案,屏東縣,內埔鄉,大新村,453,854,199,176,375,29,404
公投第１６案,屏東縣,內埔鄉,黎明村,454,1230,277,197,474,52,526
公投第１６案,屏東縣,內埔鄉,黎明村,455,1204,253,192,445,36,481
公投第１６案,屏東縣,內埔鄉,隘寮村,456,1301,291,203,494,49,543
公投第１６案,屏東縣,內埔鄉,水門村,457,806,236,162,398,52,450
公投第１６案,屏東縣,竹田鄉,竹田村,458,1503,429,327,756,82,838
公投第１６案,屏東縣,竹田鄉,竹南村,459,899,283,212,495,56,551
公投第１６案,屏東縣,竹田鄉,糶糴村,460,716,229,171,400,51,451
公投第１６案,屏東縣,竹田鄉,履豐村,461,581,163,178,341,42,383
公投第１６案,屏東縣,竹田鄉,頭崙村,462,1327,382,247,629,111,740
公投第１６案,屏東縣,竹田鄉,二崙村,463,997,250,269,519,102,621
公投第１６案,屏東縣,竹田鄉,美崙村,464,649,183,134,317,32,349
公投第１６案,屏東縣,竹田鄉,南勢村,465,476,195,120,315,32,347
公投第１６案,屏東縣,竹田鄉,西勢村,466,1259,379,285,664,73,737
公投第１６案,屏東縣,竹田鄉,西勢村,467,1227,364,210,574,69,643
公投第１６案,屏東縣,竹田鄉,福田村,468,504,163,114,277,47,324
公投第１６案,屏東縣,竹田鄉,永豐村,469,860,233,174,407,55,462
公投第１６案,屏東縣,竹田鄉,六巷村,470,800,223,155,378,32,410
公投第１６案,屏東縣,竹田鄉,泗洲村,471,1134,312,262,574,79,653
公投第１６案,屏東縣,竹田鄉,大湖村,472,1229,349,247,596,67,663
公投第１６案,屏東縣,竹田鄉,鳳明村,473,1192,329,214,543,81,624
公投第１６案,屏東縣,新埤鄉,新埤村,474,1712,411,328,739,55,794
公投第１６案,屏東縣,新埤鄉,新埤村,475,314,74,57,131,43,174
公投第１６案,屏東縣,新埤鄉,建功村,476,752,194,165,359,47,406
公投第１６案,屏東縣,新埤鄉,建功村,477,334,90,64,154,30,184
公投第１６案,屏東縣,新埤鄉,打鐵村,478,957,261,203,464,67,531
公投第１６案,屏東縣,新埤鄉,南豐村,479,764,215,172,387,64,451
公投第１６案,屏東縣,新埤鄉,萬隆村,480,373,98,77,175,38,213
公投第１６案,屏東縣,新埤鄉,萬隆村,481,678,161,118,279,39,318
公投第１６案,屏東縣,新埤鄉,萬隆村,482,701,168,111,279,34,313
公投第１６案,屏東縣,新埤鄉,餉潭村,483,1323,273,193,466,69,535
公投第１６案,屏東縣,新埤鄉,箕湖村,484,541,154,109,263,48,311
公投第１６案,屏東縣,新埤鄉,箕湖村,485,584,154,73,227,36,263
公投第１６案,屏東縣,枋寮鄉,枋寮村,486,1213,349,251,600,80,680
公投第１６案,屏東縣,枋寮鄉,新龍村,487,891,224,211,435,77,512
公投第１６案,屏東縣,枋寮鄉,保生村,488,970,229,166,395,100,495
公投第１６案,屏東縣,枋寮鄉,中寮村,489,629,193,104,297,39,336
公投第１６案,屏東縣,枋寮鄉,安樂村,490,840,256,163,419,60,479
公投第１６案,屏東縣,枋寮鄉,安樂村,491,774,228,169,397,49,446
公投第１６案,屏東縣,枋寮鄉,隆山村,492,1379,376,251,627,86,713
公投第１６案,屏東縣,枋寮鄉,隆山村,493,1502,462,295,757,70,827
公投第１６案,屏東縣,枋寮鄉,隆山村,494,1276,319,236,555,94,649
公投第１６案,屏東縣,枋寮鄉,天時村,495,964,251,171,422,90,512
公投第１６案,屏東縣,枋寮鄉,天時村,496,1005,318,191,509,98,607
公投第１６案,屏東縣,枋寮鄉,地利村,497,734,201,103,304,31,335
公投第１６案,屏東縣,枋寮鄉,地利村,498,725,196,149,345,63,408
公投第１６案,屏東縣,枋寮鄉,人和村,499,1046,272,175,447,71,518
公投第１６案,屏東縣,枋寮鄉,人和村,500,1067,313,224,537,72,609
公投第１６案,屏東縣,枋寮鄉,內寮村,501,718,133,80,213,65,278
公投第１６案,屏東縣,枋寮鄉,新開村,502,903,196,170,366,58,424
公投第１６案,屏東縣,枋寮鄉,東海村,503,1387,353,249,602,94,696
公投第１６案,屏東縣,枋寮鄉,東海村,504,1367,368,276,644,96,740
公投第１６案,屏東縣,枋寮鄉,大庄村,505,618,178,149,327,59,386
公投第１６案,屏東縣,枋寮鄉,太源村,506,959,204,141,345,45,390
公投第１６案,屏東縣,枋寮鄉,玉泉村,507,427,128,73,201,35,236
公投第１６案,屏東縣,新園鄉,瓦磘村,508,820,215,193,408,64,472
公投第１６案,屏東縣,新園鄉,瓦磘村,509,843,282,154,436,72,508
公投第１６案,屏東縣,新園鄉,仙吉村,510,1242,328,247,575,68,643
公投第１６案,屏東縣,新園鄉,仙吉村,511,1290,416,254,670,70,740
公投第１６案,屏東縣,新園鄉,田洋村,512,1073,310,199,509,59,568
公投第１６案,屏東縣,新園鄉,田洋村,513,1088,294,235,529,116,645
公投第１６案,屏東縣,新園鄉,港墘村,514,845,225,146,371,50,421
公投第１６案,屏東縣,新園鄉,內庄村,515,862,221,190,411,54,465
公投第１６案,屏東縣,新園鄉,新東村,516,1183,285,219,504,84,588
公投第１６案,屏東縣,新園鄉,新東村,517,1109,305,206,511,100,611
公投第１６案,屏東縣,新園鄉,新園村,518,1119,279,199,478,17,495
公投第１６案,屏東縣,新園鄉,新園村,519,1152,302,223,525,40,565
公投第１６案,屏東縣,新園鄉,港西村,520,1030,327,182,509,65,574
公投第１６案,屏東縣,新園鄉,港西村,521,1104,312,187,499,87,586
公投第１６案,屏東縣,新園鄉,烏龍村,522,1240,295,225,520,0,520
公投第１６案,屏東縣,新園鄉,興龍村,523,1120,223,176,399,32,431
公投第１６案,屏東縣,新園鄉,興龍村,524,1074,317,233,550,74,624
公投第１６案,屏東縣,新園鄉,中洲村,525,849,195,159,354,42,396
公投第１６案,屏東縣,新園鄉,中洲村,526,749,182,161,343,69,412
公投第１６案,屏東縣,新園鄉,南龍村,527,1416,370,262,632,85,717
公投第１６案,屏東縣,新園鄉,五房村,528,895,233,170,403,75,478
公投第１６案,屏東縣,新園鄉,五房村,529,933,281,167,448,72,520
公投第１６案,屏東縣,新園鄉,五房村,530,972,272,181,453,61,514
公投第１６案,屏東縣,新園鄉,鹽埔村,531,1454,304,223,527,87,614
公投第１６案,屏東縣,新園鄉,鹽埔村,532,1653,473,324,797,168,965
公投第１６案,屏東縣,新園鄉,鹽埔村,533,1270,302,210,512,121,633
公投第１６案,屏東縣,新園鄉,共和村,534,1123,311,231,542,150,692
公投第１６案,屏東縣,新園鄉,共和村,535,1198,293,193,486,127,613
公投第１６案,屏東縣,崁頂鄉,崁頂村,536,1190,310,206,516,62,578
公投第１６案,屏東縣,崁頂鄉,崁頂村,537,1044,303,232,535,58,593
公投第１６案,屏東縣,崁頂鄉,園寮村,538,818,224,182,406,46,452
公投第１６案,屏東縣,崁頂鄉,園寮村,539,1214,348,228,576,53,629
公投第１６案,屏東縣,崁頂鄉,力社村,540,1325,331,237,568,42,610
公投第１６案,屏東縣,崁頂鄉,圍內村,541,1253,387,256,643,64,707
公投第１６案,屏東縣,崁頂鄉,洲子村,542,1039,295,172,467,59,526
公投第１６案,屏東縣,崁頂鄉,北勢村,543,813,179,156,335,53,388
公投第１６案,屏東縣,崁頂鄉,北勢村,544,736,177,129,306,36,342
公投第１６案,屏東縣,崁頂鄉,越溪村,545,934,288,189,477,46,523
公投第１６案,屏東縣,崁頂鄉,港東村,546,900,219,178,397,75,472
公投第１６案,屏東縣,崁頂鄉,港東村,547,1004,296,183,479,48,527
公投第１６案,屏東縣,林邊鄉,林邊村,548,1458,425,305,730,128,858
公投第１６案,屏東縣,林邊鄉,光林村,549,891,249,204,453,63,516
公投第１６案,屏東縣,林邊鄉,光林村,550,695,237,139,376,43,419
公投第１６案,屏東縣,林邊鄉,永樂村,551,1015,287,250,537,70,607
公投第１６案,屏東縣,林邊鄉,永樂村,552,1171,385,233,618,54,672
公投第１６案,屏東縣,林邊鄉,永樂村,553,1003,262,217,479,48,527
公投第１６案,屏東縣,林邊鄉,中林村,554,725,212,202,414,48,462
公投第１６案,屏東縣,林邊鄉,仁和村,555,841,227,190,417,78,495
公投第１６案,屏東縣,林邊鄉,仁和村,556,793,242,171,413,60,473
公投第１６案,屏東縣,林邊鄉,田厝村,557,919,278,204,482,65,547
公投第１６案,屏東縣,林邊鄉,崎峯村,558,1283,344,239,583,65,648
公投第１６案,屏東縣,林邊鄉,水利村,559,783,191,143,334,40,374
公投第１６案,屏東縣,林邊鄉,水利村,560,1033,261,142,403,58,461
公投第１６案,屏東縣,林邊鄉,竹林村,561,1186,299,232,531,108,639
公投第１６案,屏東縣,林邊鄉,竹林村,562,773,199,152,351,72,423
公投第１６案,屏東縣,林邊鄉,鎮安村,563,1122,269,201,470,44,514
公投第１６案,屏東縣,南州鄉,溪洲村,564,872,221,133,354,79,433
公投第１６案,屏東縣,南州鄉,溪洲村,565,794,214,164,378,59,437
公投第１６案,屏東縣,南州鄉,溪南村,566,962,288,208,496,60,556
公投第１６案,屏東縣,南州鄉,七塊村,567,1033,278,220,498,77,575
公投第１６案,屏東縣,南州鄉,萬華村,568,1007,256,210,466,52,518
公投第１６案,屏東縣,南州鄉,仁里村,569,466,140,102,242,31,273
公投第１６案,屏東縣,南州鄉,溪北村,570,708,216,156,372,45,417
公投第１６案,屏東縣,南州鄉,米崙村,571,1044,265,244,509,82,591
公投第１６案,屏東縣,南州鄉,壽元村,572,1071,230,167,397,40,437
公投第１６案,屏東縣,南州鄉,同安村,573,979,240,186,426,31,457
公投第１６案,屏東縣,南州鄉,南安村,574,543,155,81,236,39,275
公投第１６案,屏東縣,佳冬鄉,佳冬村,575,1472,364,253,617,70,687
公投第１６案,屏東縣,佳冬鄉,六根村,576,1360,285,233,518,88,606
公投第１６案,屏東縣,佳冬鄉,賴家村,577,804,228,147,375,87,462
公投第１６案,屏東縣,佳冬鄉,萬建村,578,925,218,182,400,84,484
公投第１６案,屏東縣,佳冬鄉,萬建村,579,855,198,149,347,16,363
公投第１６案,屏東縣,佳冬鄉,石光村,580,981,263,154,417,41,458
公投第１６案,屏東縣,佳冬鄉,石光村,581,1007,276,158,434,62,496
公投第１６案,屏東縣,佳冬鄉,玉光村,582,872,204,143,347,62,409
公投第１６案,屏東縣,佳冬鄉,玉光村,583,1255,306,182,488,80,568
公投第１６案,屏東縣,佳冬鄉,昌隆村,584,995,277,180,457,89,546
公投第１６案,屏東縣,佳冬鄉,豐隆村,585,734,136,116,252,29,281
公投第１６案,屏東縣,佳冬鄉,大同村,586,1178,250,216,466,34,500
公投第１６案,屏東縣,佳冬鄉,羌園村,587,1095,245,182,427,28,455
公投第１６案,屏東縣,佳冬鄉,燄溫村,588,1097,280,222,502,141,643
公投第１６案,屏東縣,佳冬鄉,塭豐村,589,1273,326,244,570,81,651
公投第１６案,屏東縣,佳冬鄉,塭豐村,590,1160,338,244,582,71,653
公投第１６案,屏東縣,琉球鄉,本福村,591,1111,239,156,395,51,446
公投第１６案,屏東縣,琉球鄉,本福村,592,972,240,136,376,55,431
公投第１６案,屏東縣,琉球鄉,中福村,593,1278,363,199,562,88,650
公投第１６案,屏東縣,琉球鄉,漁福村,594,976,242,160,402,93,495
公投第１６案,屏東縣,琉球鄉,大福村,595,1658,429,269,698,90,788
公投第１６案,屏東縣,琉球鄉,南福村,596,1146,226,154,380,61,441
公投第１６案,屏東縣,琉球鄉,天福村,597,1079,232,130,362,55,417
公投第１６案,屏東縣,琉球鄉,上福村,598,1613,300,160,460,51,511
公投第１６案,屏東縣,琉球鄉,杉福村,599,873,236,157,393,58,451
公投第１６案,屏東縣,車城鄉,海口村,600,737,154,111,265,44,309
公投第１６案,屏東縣,車城鄉,田中村,601,647,113,87,200,41,241
公投第１６案,屏東縣,車城鄉,福興村,602,491,106,97,203,22,225
公投第１６案,屏東縣,車城鄉,福興村,603,856,194,163,357,39,396
公投第１６案,屏東縣,車城鄉,福安村,604,554,119,98,217,10,227
公投第１６案,屏東縣,車城鄉,統埔村,605,388,83,51,134,6,140
公投第１６案,屏東縣,車城鄉,溫泉村,606,922,186,133,319,50,369
公投第１６案,屏東縣,車城鄉,保力村,607,597,96,75,171,11,182
公投第１６案,屏東縣,車城鄉,保力村,608,623,87,88,175,10,185
公投第１６案,屏東縣,車城鄉,新街村,609,425,97,69,166,25,191
公投第１６案,屏東縣,車城鄉,埔墘村,610,428,122,72,194,22,216
公投第１６案,屏東縣,車城鄉,射寮村,611,504,97,63,160,11,171
公投第１６案,屏東縣,車城鄉,後灣村,612,423,108,79,187,24,211
公投第１６案,屏東縣,滿州鄉,滿州村,613,1575,389,291,680,54,734
公投第１６案,屏東縣,滿州鄉,里德村,614,420,102,74,176,11,187
公投第１６案,屏東縣,滿州鄉,响林村,615,602,171,147,318,31,349
公投第１６案,屏東縣,滿州鄉,永靖村,616,1302,261,178,439,26,465
公投第１６案,屏東縣,滿州鄉,港口村,617,1314,326,217,543,64,607
公投第１６案,屏東縣,滿州鄉,長樂村,618,1308,210,149,359,34,393
公投第１６案,屏東縣,滿州鄉,九棚村,619,367,59,57,116,16,132
公投第１６案,屏東縣,滿州鄉,港仔村,620,318,93,52,145,21,166
公投第１６案,屏東縣,枋山鄉,枋山村,621,604,197,135,332,34,366
公投第１６案,屏東縣,枋山鄉,枋山村,622,428,130,91,221,37,258
公投第１６案,屏東縣,枋山鄉,加祿村,623,928,319,173,492,90,582
公投第１６案,屏東縣,枋山鄉,加祿村,624,972,266,174,440,25,465
公投第１６案,屏東縣,枋山鄉,楓港村,625,1041,217,172,389,71,460
公投第１６案,屏東縣,枋山鄉,善餘村,626,883,154,124,278,25,303
公投第１６案,屏東縣,三地門鄉,大社村,627,616,135,107,242,31,273
公投第１６案,屏東縣,三地門鄉,德文村,628,572,137,117,254,91,345
公投第１６案,屏東縣,三地門鄉,達來村,629,323,76,44,120,27,147
公投第１６案,屏東縣,三地門鄉,三地村,630,1448,446,292,738,66,804
公投第１６案,屏東縣,三地門鄉,賽嘉村,631,726,131,77,208,8,216
公投第１６案,屏東縣,三地門鄉,口社村,632,554,142,117,259,28,287
公投第１６案,屏東縣,三地門鄉,馬兒村,633,346,94,74,168,16,184
公投第１６案,屏東縣,三地門鄉,安坡村,634,458,79,74,153,3,156
公投第１６案,屏東縣,三地門鄉,青山村,635,692,219,115,334,27,361
公投第１６案,屏東縣,三地門鄉,青葉村,636,638,253,138,391,73,464
公投第１６案,屏東縣,霧臺鄉,霧台村,637,346,133,104,237,30,267
公投第１６案,屏東縣,霧臺鄉,霧台村,638,677,193,135,328,19,347
公投第１６案,屏東縣,霧臺鄉,霧台村,639,162,38,12,50,0,50
公投第１６案,屏東縣,霧臺鄉,吉露村,640,189,55,35,90,6,96
公投第１６案,屏東縣,霧臺鄉,阿禮村,641,296,98,76,174,36,210
公投第１６案,屏東縣,霧臺鄉,好茶村,642,483,141,121,262,14,276
公投第１６案,屏東縣,霧臺鄉,佳暮村,643,347,71,69,140,2,142
公投第１６案,屏東縣,霧臺鄉,大武村,644,450,94,74,168,27,195
公投第１６案,屏東縣,瑪家鄉,瑪家村,645,455,122,88,210,4,214
公投第１６案,屏東縣,瑪家鄉,北葉村,646,821,268,216,484,52,536
公投第１６案,屏東縣,瑪家鄉,三和村,647,635,233,147,380,81,461
公投第１６案,屏東縣,瑪家鄉,三和村,648,695,333,143,476,40,516
公投第１６案,屏東縣,瑪家鄉,三和村,649,671,256,140,396,36,432
公投第１６案,屏東縣,瑪家鄉,凉山村,650,1057,248,163,411,20,431
公投第１６案,屏東縣,瑪家鄉,佳義村,651,900,290,162,452,32,484
公投第１６案,屏東縣,瑪家鄉,排灣村,652,429,123,75,198,11,209
公投第１６案,屏東縣,泰武鄉,佳平村,653,669,192,140,332,23,355
公投第１６案,屏東縣,泰武鄉,佳平村,654,190,52,28,80,15,95
公投第１６案,屏東縣,泰武鄉,武潭村,655,922,300,225,525,82,607
公投第１６案,屏東縣,泰武鄉,平和村,656,598,229,141,370,75,445
公投第１６案,屏東縣,泰武鄉,萬安村,657,771,311,133,444,59,503
公投第１６案,屏東縣,泰武鄉,佳興村,658,414,136,113,249,53,302
公投第１６案,屏東縣,泰武鄉,泰武村,659,780,190,163,353,43,396
公投第１６案,屏東縣,來義鄉,來義村,660,917,341,142,483,118,601
公投第１６案,屏東縣,來義鄉,義林村,661,361,105,61,166,19,185
公投第１６案,屏東縣,來義鄉,義林村,662,216,40,35,75,3,78
公投第１６案,屏東縣,來義鄉,丹林村,663,445,214,93,307,29,336
公投第１６案,屏東縣,來義鄉,丹林村,664,280,89,62,151,31,182
公投第１６案,屏東縣,來義鄉,古樓村,665,1097,430,160,590,59,649
公投第１６案,屏東縣,來義鄉,文樂村,666,840,345,140,485,74,559
公投第１６案,屏東縣,來義鄉,望嘉村,667,889,243,151,394,27,421
公投第１６案,屏東縣,來義鄉,南和村,668,1212,317,193,510,65,575
公投第１６案,屏東縣,春日鄉,春日村,669,909,100,84,184,6,190
公投第１６案,屏東縣,春日鄉,古華村,670,663,89,82,171,26,197
公投第１６案,屏東縣,春日鄉,士文村,671,304,28,10,38,2,40
公投第１６案,屏東縣,春日鄉,七佳村,672,928,178,123,301,31,332
公投第１６案,屏東縣,春日鄉,歸崇村,673,641,83,78,161,11,172
公投第１６案,屏東縣,春日鄉,力里村,674,478,68,32,100,5,105
公投第１６案,屏東縣,獅子鄉,楓林村,675,751,219,123,342,20,362
公投第１６案,屏東縣,獅子鄉,丹路村,676,776,202,121,323,39,362
公投第１６案,屏東縣,獅子鄉,草埔村,677,711,170,90,260,16,276
公投第１６案,屏東縣,獅子鄉,內文村,678,243,62,85,147,36,183
公投第１６案,屏東縣,獅子鄉,竹坑村,679,325,85,79,164,13,177
公投第１６案,屏東縣,獅子鄉,獅子村,680,476,79,51,130,7,137
公投第１６案,屏東縣,獅子鄉,內獅村,681,602,141,82,223,13,236
公投第１６案,屏東縣,獅子鄉,南世村,682,346,69,45,114,10,124
公投第１６案,屏東縣,牡丹鄉,石門村,683,342,60,75,135,8,143
公投第１６案,屏東縣,牡丹鄉,石門村,684,1306,381,226,607,56,663
公投第１６案,屏東縣,牡丹鄉,牡丹村,685,693,94,60,154,10,164
公投第１６案,屏東縣,牡丹鄉,東源村,686,437,76,69,145,19,164
公投第１６案,屏東縣,牡丹鄉,旭海村,687,392,110,76,186,8,194
公投第１６案,屏東縣,牡丹鄉,高士村,688,593,150,122,272,9,281
公投第１６案,屏東縣,牡丹鄉,四林村,689,551,86,39,125,7,132
公投第１６案,臺東縣,臺東市,文化里,1,874,237,158,395,37,432
公投第１６案,臺東縣,臺東市,民族里,2,1469,517,328,845,60,905
公投第１６案,臺東縣,臺東市,自強里,3,1259,414,244,658,39,697
公投第１６案,臺東縣,臺東市,自強里,4,1399,441,292,733,40,773
公投第１６案,臺東縣,臺東市,自強里,5,1363,502,293,795,46,841
公投第１６案,臺東縣,臺東市,民生里,6,1651,525,326,851,45,896
公投第１６案,臺東縣,臺東市,民生里,7,1490,555,326,881,48,929
公投第１６案,臺東縣,臺東市,寶桑里,8,859,252,160,412,38,450
公投第１６案,臺東縣,臺東市,民權里,9,890,279,220,499,36,535
公投第１６案,臺東縣,臺東市,四維里,10,651,188,142,330,46,376
公投第１６案,臺東縣,臺東市,中華里,11,1650,459,306,765,66,831
公投第１６案,臺東縣,臺東市,仁愛里,12,724,243,178,421,29,450
公投第１６案,臺東縣,臺東市,強國里,13,632,206,145,351,30,381
公投第１６案,臺東縣,臺東市,大同里,14,771,251,168,419,44,463
公投第１６案,臺東縣,臺東市,成功里,15,798,234,145,379,28,407
公投第１６案,臺東縣,臺東市,建國里,16,1299,360,264,624,96,720
公投第１６案,臺東縣,臺東市,中正里,17,811,256,216,472,25,497
公投第１６案,臺東縣,臺東市,中山里,18,764,265,186,451,40,491
公投第１６案,臺東縣,臺東市,興國里,19,784,219,166,385,17,402
公投第１６案,臺東縣,臺東市,鐵花里,20,427,110,89,199,13,212
公投第１６案,臺東縣,臺東市,東海里,21,1292,372,244,616,34,650
公投第１６案,臺東縣,臺東市,東海里,22,1501,513,306,819,24,843
公投第１６案,臺東縣,臺東市,復國里,23,601,161,126,287,15,302
公投第１６案,臺東縣,臺東市,復興里,24,417,119,72,191,12,203
公投第１６案,臺東縣,臺東市,新興里,25,1001,329,180,509,50,559
公投第１６案,臺東縣,臺東市,新生里,26,1638,583,318,901,49,950
公投第１６案,臺東縣,臺東市,新生里,27,1576,527,287,814,57,871
公投第１６案,臺東縣,臺東市,新生里,28,1595,519,319,838,66,904
公投第１６案,臺東縣,臺東市,新生里,29,1734,621,290,911,57,968
公投第１６案,臺東縣,臺東市,中心里,30,1476,491,298,789,56,845
公投第１６案,臺東縣,臺東市,中心里,31,1545,561,319,880,48,928
公投第１６案,臺東縣,臺東市,馬蘭里,32,1313,455,291,746,46,792
公投第１６案,臺東縣,臺東市,馬蘭里,33,1338,491,279,770,46,816
公投第１６案,臺東縣,臺東市,光明里,34,1312,424,258,682,35,717
公投第１６案,臺東縣,臺東市,光明里,35,1265,412,269,681,54,735
公投第１６案,臺東縣,臺東市,豐年里,36,1407,348,259,607,69,676
公投第１６案,臺東縣,臺東市,豐年里,37,1552,438,268,706,51,757
公投第１６案,臺東縣,臺東市,豐樂里,38,1445,477,268,745,80,825
公投第１６案,臺東縣,臺東市,永樂里,39,2098,697,423,1120,73,1193
公投第１６案,臺東縣,臺東市,康樂里,40,1324,434,264,698,89,787
公投第１６案,臺東縣,臺東市,豐榮里,41,1598,524,285,809,37,846
公投第１６案,臺東縣,臺東市,豐榮里,42,1513,453,300,753,33,786
公投第１６案,臺東縣,臺東市,豐榮里,43,1679,546,307,853,49,902
公投第１６案,臺東縣,臺東市,豐榮里,44,1414,393,286,679,63,742
公投第１６案,臺東縣,臺東市,豐榮里,45,1798,547,301,848,72,920
公投第１６案,臺東縣,臺東市,豐谷里,46,1749,442,273,715,86,801
公投第１６案,臺東縣,臺東市,豐谷里,47,1709,516,305,821,106,927
公投第１６案,臺東縣,臺東市,豐谷里,48,1629,515,260,775,64,839
公投第１６案,臺東縣,臺東市,豐里里,49,1116,318,203,521,69,590
公投第１６案,臺東縣,臺東市,豐里里,50,1259,321,205,526,31,557
公投第１６案,臺東縣,臺東市,豐原里,51,1232,301,215,516,39,555
公投第１６案,臺東縣,臺東市,富岡里,52,1505,360,295,655,120,775
公投第１６案,臺東縣,臺東市,富豐里,53,836,201,142,343,61,404
公投第１６案,臺東縣,臺東市,南榮里,54,1294,440,251,691,46,737
公投第１６案,臺東縣,臺東市,南榮里,55,1350,425,231,656,66,722
公投第１６案,臺東縣,臺東市,岩灣里,56,2162,709,406,1115,82,1197
公投第１６案,臺東縣,臺東市,卑南里,57,1627,572,342,914,54,968
公投第１６案,臺東縣,臺東市,卑南里,58,1140,403,215,618,49,667
公投第１６案,臺東縣,臺東市,南王里,59,1359,438,230,668,42,710
公投第１６案,臺東縣,臺東市,南王里,60,1329,425,253,678,61,739
公投第１６案,臺東縣,臺東市,豐田里,61,990,278,193,471,42,513
公投第１６案,臺東縣,臺東市,豐田里,62,1038,342,195,537,52,589
公投第１６案,臺東縣,臺東市,新園里,63,1597,397,347,744,86,830
公投第１６案,臺東縣,臺東市,建和里,64,1385,387,277,664,81,745
公投第１６案,臺東縣,臺東市,建興里,65,939,228,169,397,19,416
公投第１６案,臺東縣,臺東市,建業里,66,1258,315,189,504,52,556
公投第１６案,臺東縣,臺東市,知本里,67,1350,370,248,618,11,629
公投第１６案,臺東縣,臺東市,建農里,68,1058,249,187,436,43,479
公投第１６案,臺東縣,臺東市,建農里,69,895,195,147,342,35,377
公投第１６案,臺東縣,成功鎮,信義里,70,516,133,81,214,48,262
公投第１６案,臺東縣,成功鎮,信義里,71,960,269,246,515,69,584
公投第１６案,臺東縣,成功鎮,信義里,72,365,72,37,109,15,124
公投第１６案,臺東縣,成功鎮,和平里,73,747,166,112,278,67,345
公投第１６案,臺東縣,成功鎮,忠仁里,74,339,82,51,133,27,160
公投第１６案,臺東縣,成功鎮,忠仁里,75,995,267,160,427,27,454
公投第１６案,臺東縣,成功鎮,忠仁里,76,863,276,150,426,57,483
公投第１６案,臺東縣,成功鎮,忠智里,77,931,279,171,450,57,507
公投第１６案,臺東縣,成功鎮,忠智里,78,970,300,163,463,33,496
公投第１６案,臺東縣,成功鎮,三民里,79,1365,342,243,585,108,693
公投第１６案,臺東縣,成功鎮,三民里,80,1366,425,200,625,94,719
公投第１６案,臺東縣,成功鎮,三仙里,81,516,120,79,199,63,262
公投第１６案,臺東縣,成功鎮,三仙里,82,887,191,107,298,76,374
公投第１６案,臺東縣,成功鎮,忠孝里,83,488,97,71,168,49,217
公投第１６案,臺東縣,成功鎮,忠孝里,84,481,98,58,156,39,195
公投第１６案,臺東縣,成功鎮,博愛里,85,373,41,29,70,0,70
公投第１６案,臺東縣,成功鎮,博愛里,86,264,74,43,117,26,143
公投第１６案,臺東縣,關山鎮,里壠里,87,909,301,202,503,35,538
公投第１６案,臺東縣,關山鎮,里壠里,88,790,189,124,313,25,338
公投第１６案,臺東縣,關山鎮,中福里,89,828,271,186,457,44,501
公投第１６案,臺東縣,關山鎮,新福里,90,887,204,147,351,22,373
公投第１６案,臺東縣,關山鎮,豐泉里,91,1137,398,189,587,34,621
公投第１６案,臺東縣,關山鎮,月眉里,92,732,183,132,315,35,350
公投第１６案,臺東縣,關山鎮,德高里,93,912,248,179,427,46,473
公投第１６案,臺東縣,關山鎮,德高里,94,779,172,111,283,20,303
公投第１６案,臺東縣,關山鎮,電光里,95,535,140,45,185,18,203
公投第１６案,臺東縣,卑南鄉,賓朗村,96,1041,305,234,539,62,601
公投第１６案,臺東縣,卑南鄉,賓朗村,97,1165,343,187,530,39,569
公投第１６案,臺東縣,卑南鄉,美農村,98,219,35,40,75,22,97
公投第１６案,臺東縣,卑南鄉,美農村,99,460,112,70,182,34,216
公投第１６案,臺東縣,卑南鄉,美農村,100,387,78,61,139,16,155
公投第１６案,臺東縣,卑南鄉,初鹿村,101,767,166,126,292,37,329
公投第１６案,臺東縣,卑南鄉,初鹿村,102,503,159,69,228,42,270
公投第１６案,臺東縣,卑南鄉,明峰村,103,727,173,125,298,48,346
公投第１６案,臺東縣,卑南鄉,明峰村,104,436,122,70,192,36,228
公投第１６案,臺東縣,卑南鄉,嘉豐村,105,261,43,42,85,11,96
公投第１６案,臺東縣,卑南鄉,嘉豐村,106,215,65,39,104,12,116
公投第１６案,臺東縣,卑南鄉,太平村,107,1442,467,280,747,58,805
公投第１６案,臺東縣,卑南鄉,太平村,108,527,150,97,247,17,264
公投第１６案,臺東縣,卑南鄉,太平村,109,1046,300,224,524,56,580
公投第１６案,臺東縣,卑南鄉,泰安村,110,1110,286,246,532,70,602
公投第１６案,臺東縣,卑南鄉,利嘉村,111,1105,335,231,566,63,629
公投第１６案,臺東縣,卑南鄉,東興村,112,1167,334,241,575,150,725
公投第１６案,臺東縣,卑南鄉,溫泉村,113,968,224,182,406,67,473
公投第１６案,臺東縣,卑南鄉,溫泉村,114,159,29,23,52,3,55
公投第１６案,臺東縣,卑南鄉,富山村,115,488,127,66,193,27,220
公投第１６案,臺東縣,卑南鄉,富源村,116,347,89,88,177,25,202
公投第１６案,臺東縣,卑南鄉,利吉村,117,436,123,78,201,26,227
公投第１６案,臺東縣,鹿野鄉,鹿野村,118,522,115,66,181,10,191
公投第１６案,臺東縣,鹿野鄉,鹿野村,119,574,164,111,275,31,306
公投第１６案,臺東縣,鹿野鄉,龍田村,120,1055,239,145,384,35,419
公投第１６案,臺東縣,鹿野鄉,永安村,121,1104,278,192,470,43,513
公投第１６案,臺東縣,鹿野鄉,永安村,122,342,91,42,133,22,155
公投第１６案,臺東縣,鹿野鄉,瑞隆村,123,895,224,154,378,42,420
公投第１６案,臺東縣,鹿野鄉,瑞源村,124,864,200,144,344,66,410
公投第１６案,臺東縣,鹿野鄉,瑞和村,125,675,121,122,243,45,288
公投第１６案,臺東縣,鹿野鄉,瑞豐村,126,435,111,87,198,16,214
公投第１６案,臺東縣,鹿野鄉,瑞豐村,127,470,86,66,152,29,181
公投第１６案,臺東縣,池上鄉,福原村,128,992,264,165,429,39,468
公投第１６案,臺東縣,池上鄉,福原村,129,929,263,182,445,65,510
公投第１６案,臺東縣,池上鄉,福文村,130,434,99,87,186,25,211
公投第１６案,臺東縣,池上鄉,福文村,131,703,157,113,270,37,307
公投第１６案,臺東縣,池上鄉,慶豐村,132,654,146,91,237,24,261
公投第１６案,臺東縣,池上鄉,大坡村,133,324,50,59,109,20,129
公投第１６案,臺東縣,池上鄉,大埔村,134,794,186,125,311,48,359
公投第１６案,臺東縣,池上鄉,新興村,135,856,208,151,359,52,411
公投第１６案,臺東縣,池上鄉,錦園村,136,344,87,40,127,14,141
公投第１６案,臺東縣,池上鄉,萬安村,137,311,98,48,146,25,171
公投第１６案,臺東縣,池上鄉,富興村,138,386,72,52,124,12,136
公投第１６案,臺東縣,池上鄉,振興村,139,435,76,56,132,19,151
公投第１６案,臺東縣,東河鄉,都蘭村,140,290,58,40,98,24,122
公投第１６案,臺東縣,東河鄉,都蘭村,141,620,187,105,292,44,336
公投第１６案,臺東縣,東河鄉,都蘭村,142,1196,364,274,638,100,738
公投第１６案,臺東縣,東河鄉,興昌村,143,918,208,141,349,86,435
公投第１６案,臺東縣,東河鄉,隆昌村,144,555,119,93,212,45,257
公投第１６案,臺東縣,東河鄉,東河村,145,977,216,146,362,35,397
公投第１６案,臺東縣,東河鄉,泰源村,146,1197,169,132,301,21,322
公投第１６案,臺東縣,東河鄉,北源村,147,867,100,73,173,36,209
公投第１６案,臺東縣,東河鄉,北源村,148,345,72,57,129,19,148
公投第１６案,臺東縣,東河鄉,北源村,149,408,78,71,149,21,170
公投第１６案,臺東縣,東河鄉,尚德村,150,262,58,45,103,11,114
公投第１６案,臺東縣,長濱鄉,寧埔村,151,536,121,133,254,55,309
公投第１６案,臺東縣,長濱鄉,寧埔村,152,689,108,79,187,35,222
公投第１６案,臺東縣,長濱鄉,竹湖村,153,913,234,141,375,115,490
公投第１６案,臺東縣,長濱鄉,長濱村,154,1268,252,139,391,36,427
公投第１６案,臺東縣,長濱鄉,長濱村,155,725,153,101,254,81,335
公投第１６案,臺東縣,長濱鄉,忠勇村,156,532,64,55,119,15,134
公投第１６案,臺東縣,長濱鄉,三間村,157,660,123,88,211,68,279
公投第１６案,臺東縣,長濱鄉,三間村,158,336,44,23,67,3,70
公投第１６案,臺東縣,長濱鄉,三間村,159,195,28,20,48,16,64
公投第１６案,臺東縣,長濱鄉,樟原村,160,25,8,2,10,3,13
公投第１６案,臺東縣,長濱鄉,樟原村,161,605,134,59,193,62,255
公投第１６案,臺東縣,太麻里鄉,美和村,162,722,191,143,334,50,384
公投第１６案,臺東縣,太麻里鄉,美和村,163,575,174,86,260,35,295
公投第１６案,臺東縣,太麻里鄉,三和村,164,623,165,109,274,40,314
公投第１６案,臺東縣,太麻里鄉,華源村,165,622,138,108,246,50,296
公投第１６案,臺東縣,太麻里鄉,北里村,166,560,124,67,191,13,204
公投第１６案,臺東縣,太麻里鄉,大王村,167,957,252,164,416,109,525
公投第１６案,臺東縣,太麻里鄉,大王村,168,809,160,154,314,52,366
公投第１６案,臺東縣,太麻里鄉,泰和村,169,673,219,145,364,49,413
公投第１６案,臺東縣,太麻里鄉,泰和村,170,737,185,137,322,57,379
公投第１６案,臺東縣,太麻里鄉,香蘭村,171,424,114,86,200,40,240
公投第１６案,臺東縣,太麻里鄉,香蘭村,172,374,81,76,157,22,179
公投第１６案,臺東縣,太麻里鄉,金崙村,173,829,163,92,255,26,281
公投第１６案,臺東縣,太麻里鄉,金崙村,174,869,160,112,272,9,281
公投第１６案,臺東縣,太麻里鄉,多良村,175,223,35,24,59,6,65
公投第１６案,臺東縣,太麻里鄉,多良村,176,669,198,109,307,56,363
公投第１６案,臺東縣,大武鄉,南興村,177,568,152,108,260,73,333
公投第１６案,臺東縣,大武鄉,尚武村,178,1474,319,254,573,151,724
公投第１６案,臺東縣,大武鄉,大武村,179,1327,335,256,591,115,706
公投第１６案,臺東縣,大武鄉,大鳥村,180,1134,251,163,414,120,534
公投第１６案,臺東縣,大武鄉,大竹村,181,386,78,68,146,67,213
公投第１６案,臺東縣,大武鄉,大竹村,182,377,81,53,134,33,167
公投第１６案,臺東縣,綠島鄉,南寮村,183,1474,355,211,566,38,604
公投第１６案,臺東縣,綠島鄉,中寮村,184,1082,283,152,435,37,472
公投第１６案,臺東縣,綠島鄉,公舘村,185,813,219,141,360,21,381
公投第１６案,臺東縣,綠島鄉,公舘村,186,210,45,49,94,2,96
公投第１６案,臺東縣,海端鄉,加拿村,187,497,124,105,229,34,263
公投第１６案,臺東縣,海端鄉,崁頂村,188,569,175,120,295,35,330
公投第１６案,臺東縣,海端鄉,海端村,189,971,237,188,425,56,481
公投第１６案,臺東縣,海端鄉,廣原村,190,728,184,169,353,40,393
公投第１６案,臺東縣,海端鄉,霧鹿村,191,259,71,54,125,15,140
公投第１６案,臺東縣,海端鄉,利稻村,192,254,64,49,113,14,127
公投第１６案,臺東縣,延平鄉,桃源村,193,1014,243,216,459,55,514
公投第１６案,臺東縣,延平鄉,紅葉村,194,426,123,113,236,60,296
公投第１６案,臺東縣,延平鄉,永康村,195,315,108,74,182,27,209
公投第１６案,臺東縣,延平鄉,武陵村,196,579,126,84,210,23,233
公投第１６案,臺東縣,延平鄉,鸞山村,197,596,136,111,247,28,275
公投第１６案,臺東縣,金峰鄉,嘉蘭村,198,1241,294,194,488,73,561
公投第１６案,臺東縣,金峰鄉,正興村,199,601,186,127,313,37,350
公投第１６案,臺東縣,金峰鄉,新興村,200,520,205,130,335,57,392
公投第１６案,臺東縣,金峰鄉,賓茂村,201,336,99,57,156,32,188
公投第１６案,臺東縣,金峰鄉,歷坵村,202,330,63,55,118,36,154
公投第１６案,臺東縣,達仁鄉,安朔村,203,246,69,59,128,26,154
公投第１６案,臺東縣,達仁鄉,安朔村,204,340,54,141,195,23,218
公投第１６案,臺東縣,達仁鄉,南田村,205,296,95,83,178,18,196
公投第１６案,臺東縣,達仁鄉,森永村,206,429,126,102,228,41,269
公投第１６案,臺東縣,達仁鄉,新化村,207,331,94,94,188,27,215
公投第１６案,臺東縣,達仁鄉,台坂村,208,628,130,107,237,21,258
公投第１６案,臺東縣,達仁鄉,土坂村,209,867,184,219,403,64,467
公投第１６案,臺東縣,蘭嶼鄉,椰油村,210,943,154,197,351,30,381
公投第１６案,臺東縣,蘭嶼鄉,紅頭村,211,1238,211,274,485,44,529
公投第１６案,臺東縣,蘭嶼鄉,東清村,212,1240,148,219,367,25,392
公投第１６案,臺東縣,蘭嶼鄉,朗島村,213,760,121,127,248,31,279
公投第１６案,花蓮縣,花蓮市,民德里,1,1522,525,303,828,39,867
公投第１６案,花蓮縣,花蓮市,民勤里,2,1114,375,229,604,49,653
公投第１６案,花蓮縣,花蓮市,民勤里,3,670,212,128,340,35,375
公投第１６案,花蓮縣,花蓮市,民勤里,4,1397,446,264,710,32,742
公投第１６案,花蓮縣,花蓮市,民意里,5,470,119,87,206,34,240
公投第１６案,花蓮縣,花蓮市,民意里,6,838,261,139,400,32,432
公投第１６案,花蓮縣,花蓮市,民意里,7,721,174,102,276,25,301
公投第１６案,花蓮縣,花蓮市,民心里,8,918,290,196,486,46,532
公投第１６案,花蓮縣,花蓮市,民享里,9,1539,458,285,743,67,810
公投第１６案,花蓮縣,花蓮市,民享里,10,1403,454,235,689,57,746
公投第１６案,花蓮縣,花蓮市,民孝里,11,1068,303,212,515,49,564
公投第１６案,花蓮縣,花蓮市,民孝里,12,1167,388,229,617,28,645
公投第１６案,花蓮縣,花蓮市,民孝里,13,1259,427,250,677,74,751
公投第１６案,花蓮縣,花蓮市,民運里,14,1071,310,197,507,86,593
公投第１６案,花蓮縣,花蓮市,民運里,15,925,284,201,485,42,527
公投第１６案,花蓮縣,花蓮市,民政里,16,1141,410,222,632,79,711
公投第１６案,花蓮縣,花蓮市,民政里,17,1163,362,210,572,30,602
公投第１６案,花蓮縣,花蓮市,民政里,18,1279,460,231,691,51,742
公投第１６案,花蓮縣,花蓮市,民立里,19,1512,440,248,688,36,724
公投第１６案,花蓮縣,花蓮市,民樂里,20,615,181,121,302,31,333
公投第１６案,花蓮縣,花蓮市,民有里,21,606,170,147,317,33,350
公投第１６案,花蓮縣,花蓮市,民主里,22,559,175,78,253,21,274
公投第１６案,花蓮縣,花蓮市,民族里,23,442,154,79,233,15,248
公投第１６案,花蓮縣,花蓮市,民生里,24,1114,318,213,531,37,568
公投第１６案,花蓮縣,花蓮市,民權里,25,416,140,83,223,13,236
公投第１６案,花蓮縣,花蓮市,主商里,26,577,214,115,329,24,353
公投第１６案,花蓮縣,花蓮市,主勤里,27,810,265,201,466,28,494
公投第１６案,花蓮縣,花蓮市,主工里,28,538,175,111,286,23,309
公投第１６案,花蓮縣,花蓮市,主信里,29,566,176,101,277,32,309
公投第１６案,花蓮縣,花蓮市,主義里,30,469,159,81,240,10,250
公投第１６案,花蓮縣,花蓮市,主睦里,31,565,175,126,301,20,321
公投第１６案,花蓮縣,花蓮市,主計里,32,816,249,119,368,34,402
公投第１６案,花蓮縣,花蓮市,主和里,33,911,250,171,421,57,478
公投第１６案,花蓮縣,花蓮市,主和里,34,1029,296,183,479,59,538
公投第１６案,花蓮縣,花蓮市,主和里,35,1043,334,229,563,53,616
公投第１６案,花蓮縣,花蓮市,主學里,36,856,290,177,467,28,495
公投第１６案,花蓮縣,花蓮市,主學里,37,979,301,198,499,41,540
公投第１６案,花蓮縣,花蓮市,主農里,38,1331,431,256,687,63,750
公投第１６案,花蓮縣,花蓮市,主農里,39,1228,401,244,645,48,693
公投第１６案,花蓮縣,花蓮市,主農里,40,955,306,199,505,39,544
公投第１６案,花蓮縣,花蓮市,主安里,41,1268,361,228,589,51,640
公投第１６案,花蓮縣,花蓮市,主安里,42,1230,381,216,597,48,645
公投第１６案,花蓮縣,花蓮市,主權里,43,1369,461,252,713,61,774
公投第１６案,花蓮縣,花蓮市,主權里,44,1435,385,225,610,38,648
公投第１６案,花蓮縣,花蓮市,主權里,45,1164,354,240,594,48,642
公投第１６案,花蓮縣,花蓮市,主權里,46,1249,448,236,684,50,734
公投第１６案,花蓮縣,花蓮市,主力里,47,1184,375,227,602,59,661
公投第１６案,花蓮縣,花蓮市,主力里,48,1490,475,260,735,39,774
公投第１６案,花蓮縣,花蓮市,國風里,49,1022,359,225,584,57,641
公投第１６案,花蓮縣,花蓮市,國風里,50,1135,313,233,546,92,638
公投第１６案,花蓮縣,花蓮市,國風里,51,1084,379,184,563,47,610
公投第１６案,花蓮縣,花蓮市,國威里,52,1339,282,180,462,39,501
公投第１６案,花蓮縣,花蓮市,國威里,53,501,175,106,281,19,300
公投第１６案,花蓮縣,花蓮市,國治里,54,904,295,181,476,21,497
公投第１６案,花蓮縣,花蓮市,國安里,55,490,167,112,279,25,304
公投第１６案,花蓮縣,花蓮市,國光里,56,1192,311,216,527,38,565
公投第１６案,花蓮縣,花蓮市,國防里,57,869,249,159,408,30,438
公投第１６案,花蓮縣,花蓮市,國華里,58,1267,396,223,619,53,672
公投第１６案,花蓮縣,花蓮市,國華里,59,959,336,163,499,55,554
公投第１６案,花蓮縣,花蓮市,國魂里,60,993,325,168,493,48,541
公投第１６案,花蓮縣,花蓮市,國魂里,61,982,295,196,491,61,552
公投第１６案,花蓮縣,花蓮市,國聯里,62,1311,361,245,606,26,632
公投第１６案,花蓮縣,花蓮市,國聯里,63,1455,410,288,698,51,749
公投第１６案,花蓮縣,花蓮市,國盛里,64,1151,305,201,506,30,536
公投第１６案,花蓮縣,花蓮市,國盛里,65,1237,347,227,574,35,609
公投第１６案,花蓮縣,花蓮市,國盛里,66,1339,372,224,596,49,645
公投第１６案,花蓮縣,花蓮市,國強里,67,715,242,148,390,25,415
公投第１６案,花蓮縣,花蓮市,國強里,68,1000,311,199,510,49,559
公投第１６案,花蓮縣,花蓮市,國富里,69,1410,369,265,634,64,698
公投第１６案,花蓮縣,花蓮市,國富里,70,1303,409,254,663,27,690
公投第１６案,花蓮縣,花蓮市,國富里,71,1256,388,251,639,32,671
公投第１６案,花蓮縣,花蓮市,國富里,72,1105,364,208,572,64,636
公投第１６案,花蓮縣,花蓮市,國裕里,73,1089,318,207,525,33,558
公投第１６案,花蓮縣,花蓮市,國裕里,74,1043,287,199,486,30,516
公投第１６案,花蓮縣,花蓮市,國裕里,75,1080,376,200,576,39,615
公投第１６案,花蓮縣,花蓮市,國裕里,76,971,323,178,501,48,549
公投第１６案,花蓮縣,花蓮市,國慶里,77,1068,346,241,587,24,611
公投第１６案,花蓮縣,花蓮市,國興里,78,1379,412,228,640,55,695
公投第１６案,花蓮縣,花蓮市,國興里,79,1362,397,260,657,61,718
公投第１６案,花蓮縣,花蓮市,國興里,80,1323,462,250,712,47,759
公投第１６案,花蓮縣,花蓮市,國福里,81,1482,386,246,632,41,673
公投第１６案,花蓮縣,新城鄉,新城村,82,367,118,81,199,16,215
公投第１６案,花蓮縣,新城鄉,新城村,83,929,260,165,425,21,446
公投第１６案,花蓮縣,新城鄉,順安村,84,590,165,115,280,74,354
公投第１６案,花蓮縣,新城鄉,順安村,85,307,88,59,147,26,173
公投第１６案,花蓮縣,新城鄉,康樂村,86,260,83,50,133,28,161
公投第１６案,花蓮縣,新城鄉,康樂村,87,1283,418,227,645,75,720
公投第１６案,花蓮縣,新城鄉,康樂村,88,885,255,153,408,39,447
公投第１６案,花蓮縣,新城鄉,大漢村,89,770,230,165,395,44,439
公投第１６案,花蓮縣,新城鄉,大漢村,90,1363,430,237,667,74,741
公投第１６案,花蓮縣,新城鄉,大漢村,91,366,102,71,173,19,192
公投第１６案,花蓮縣,新城鄉,北埔村,92,1163,343,188,531,60,591
公投第１６案,花蓮縣,新城鄉,北埔村,93,1605,474,303,777,66,843
公投第１６案,花蓮縣,新城鄉,北埔村,94,1194,329,251,580,63,643
公投第１６案,花蓮縣,新城鄉,佳林村,95,979,333,179,512,40,552
公投第１６案,花蓮縣,新城鄉,嘉里村,96,1485,485,280,765,56,821
公投第１６案,花蓮縣,新城鄉,嘉里村,97,1070,317,208,525,35,560
公投第１６案,花蓮縣,新城鄉,嘉里村,98,1164,359,231,590,45,635
公投第１６案,花蓮縣,新城鄉,嘉新村,99,880,249,158,407,60,467
公投第１６案,花蓮縣,新城鄉,嘉新村,100,369,101,70,171,18,189
公投第１６案,花蓮縣,秀林鄉,和平村,101,867,265,153,418,31,449
公投第１６案,花蓮縣,秀林鄉,和平村,102,575,166,105,271,27,298
公投第１６案,花蓮縣,秀林鄉,崇德村,103,1373,286,187,473,49,522
公投第１６案,花蓮縣,秀林鄉,富世村,104,1644,404,222,626,83,709
公投第１６案,花蓮縣,秀林鄉,富世村,105,162,49,34,83,6,89
公投第１６案,花蓮縣,秀林鄉,秀林村,106,384,90,73,163,27,190
公投第１６案,花蓮縣,秀林鄉,秀林村,107,1382,341,204,545,44,589
公投第１６案,花蓮縣,秀林鄉,景美村,108,1125,271,192,463,50,513
公投第１６案,花蓮縣,秀林鄉,景美村,109,627,177,90,267,23,290
公投第１６案,花蓮縣,秀林鄉,佳民村,110,987,337,206,543,55,598
公投第１６案,花蓮縣,秀林鄉,水源村,111,1139,373,217,590,109,699
公投第１６案,花蓮縣,秀林鄉,銅門村,112,1213,401,170,571,8,579
公投第１６案,花蓮縣,秀林鄉,文蘭村,113,754,178,139,317,30,347
公投第１６案,花蓮縣,秀林鄉,文蘭村,114,330,85,44,129,15,144
公投第１６案,花蓮縣,吉安鄉,永安村,115,1059,319,187,506,52,558
公投第１６案,花蓮縣,吉安鄉,永安村,116,983,300,188,488,59,547
公投第１６案,花蓮縣,吉安鄉,永安村,117,1031,327,192,519,44,563
公投第１６案,花蓮縣,吉安鄉,永安村,118,1105,293,223,516,46,562
公投第１６案,花蓮縣,吉安鄉,太昌村,119,1107,326,215,541,33,574
公投第１６案,花蓮縣,吉安鄉,太昌村,120,1179,312,219,531,57,588
公投第１６案,花蓮縣,吉安鄉,太昌村,121,1453,355,231,586,79,665
公投第１６案,花蓮縣,吉安鄉,慶豐村,122,1432,485,301,786,56,842
公投第１６案,花蓮縣,吉安鄉,慶豐村,123,1320,440,244,684,45,729
公投第１６案,花蓮縣,吉安鄉,慶豐村,124,1356,414,224,638,51,689
公投第１６案,花蓮縣,吉安鄉,慶豐村,125,1295,400,215,615,52,667
公投第１６案,花蓮縣,吉安鄉,慶豐村,126,1467,436,285,721,76,797
公投第１６案,花蓮縣,吉安鄉,吉安村,127,1515,480,280,760,32,792
公投第１６案,花蓮縣,吉安鄉,吉安村,128,1063,380,189,569,65,634
公投第１６案,花蓮縣,吉安鄉,吉安村,129,1284,348,201,549,16,565
公投第１６案,花蓮縣,吉安鄉,吉安村,130,1380,478,249,727,46,773
公投第１６案,花蓮縣,吉安鄉,福興村,131,1297,406,263,669,63,732
公投第１６案,花蓮縣,吉安鄉,福興村,132,1662,462,298,760,101,861
公投第１６案,花蓮縣,吉安鄉,南華村,133,1563,359,282,641,109,750
公投第１６案,花蓮縣,吉安鄉,干城村,134,1288,351,205,556,67,623
公投第１６案,花蓮縣,吉安鄉,永興村,135,907,254,196,450,56,506
公投第１６案,花蓮縣,吉安鄉,永興村,136,917,239,192,431,43,474
公投第１６案,花蓮縣,吉安鄉,永興村,137,1021,296,194,490,37,527
公投第１６案,花蓮縣,吉安鄉,稻香村,138,1033,376,185,561,53,614
公投第１６案,花蓮縣,吉安鄉,稻香村,139,966,303,181,484,66,550
公投第１６案,花蓮縣,吉安鄉,稻香村,140,1188,249,303,552,71,623
公投第１６案,花蓮縣,吉安鄉,南昌村,141,1480,437,287,724,40,764
公投第１６案,花蓮縣,吉安鄉,南昌村,142,1393,378,238,616,56,672
公投第１６案,花蓮縣,吉安鄉,南昌村,143,1193,345,206,551,44,595
公投第１６案,花蓮縣,吉安鄉,宜昌村,144,1445,422,230,652,45,697
公投第１６案,花蓮縣,吉安鄉,宜昌村,145,1301,360,247,607,107,714
公投第１６案,花蓮縣,吉安鄉,宜昌村,146,1215,389,247,636,56,692
公投第１６案,花蓮縣,吉安鄉,北昌村,147,1135,341,220,561,49,610
公投第１６案,花蓮縣,吉安鄉,北昌村,148,1223,416,247,663,32,695
公投第１６案,花蓮縣,吉安鄉,北昌村,149,1274,403,246,649,52,701
公投第１６案,花蓮縣,吉安鄉,北昌村,150,1124,345,197,542,53,595
公投第１６案,花蓮縣,吉安鄉,北昌村,151,1158,394,220,614,38,652
公投第１６案,花蓮縣,吉安鄉,北昌村,152,1157,364,246,610,35,645
公投第１６案,花蓮縣,吉安鄉,勝安村,153,1258,381,257,638,49,687
公投第１６案,花蓮縣,吉安鄉,勝安村,154,1257,384,264,648,23,671
公投第１６案,花蓮縣,吉安鄉,勝安村,155,1245,404,209,613,34,647
公投第１６案,花蓮縣,吉安鄉,勝安村,156,1166,413,218,631,17,648
公投第１６案,花蓮縣,吉安鄉,仁里村,157,1358,403,223,626,82,708
公投第１６案,花蓮縣,吉安鄉,仁里村,158,1214,367,218,585,44,629
公投第１６案,花蓮縣,吉安鄉,仁里村,159,1151,339,209,548,70,618
公投第１６案,花蓮縣,吉安鄉,仁里村,160,1157,358,232,590,47,637
公投第１６案,花蓮縣,吉安鄉,仁里村,161,1161,402,208,610,46,656
公投第１６案,花蓮縣,吉安鄉,東昌村,162,1304,411,262,673,63,736
公投第１６案,花蓮縣,吉安鄉,東昌村,163,1367,418,237,655,63,718
公投第１６案,花蓮縣,吉安鄉,東昌村,164,1411,397,207,604,60,664
公投第１６案,花蓮縣,吉安鄉,東昌村,165,1409,392,202,594,73,667
公投第１６案,花蓮縣,吉安鄉,仁安村,166,1125,312,180,492,45,537
公投第１６案,花蓮縣,吉安鄉,仁安村,167,1213,340,247,587,85,672
公投第１６案,花蓮縣,吉安鄉,仁和村,168,1141,348,221,569,55,624
公投第１６案,花蓮縣,吉安鄉,仁和村,169,1156,292,193,485,41,526
公投第１６案,花蓮縣,吉安鄉,仁和村,170,1092,319,181,500,62,562
公投第１６案,花蓮縣,吉安鄉,仁和村,171,1026,249,167,416,50,466
公投第１６案,花蓮縣,吉安鄉,光華村,172,804,242,153,395,30,425
公投第１６案,花蓮縣,吉安鄉,光華村,173,1132,375,200,575,51,626
公投第１６案,花蓮縣,壽豐鄉,溪口村,174,1052,249,204,453,50,503
公投第１６案,花蓮縣,壽豐鄉,樹湖村,175,357,113,67,180,38,218
公投第１６案,花蓮縣,壽豐鄉,豐山村,176,1022,280,168,448,71,519
公投第１６案,花蓮縣,壽豐鄉,豐山村,177,875,274,216,490,58,548
公投第１６案,花蓮縣,壽豐鄉,豐裡村,178,691,203,170,373,50,423
公投第１６案,花蓮縣,壽豐鄉,豐裡村,179,708,146,153,299,30,329
公投第１６案,花蓮縣,壽豐鄉,豐坪村,180,894,218,182,400,73,473
公投第１６案,花蓮縣,壽豐鄉,壽豐村,181,746,210,154,364,43,407
公投第１６案,花蓮縣,壽豐鄉,壽豐村,182,881,241,182,423,47,470
公投第１６案,花蓮縣,壽豐鄉,共和村,183,695,249,150,399,36,435
公投第１６案,花蓮縣,壽豐鄉,光榮村,184,816,222,193,415,97,512
公投第１６案,花蓮縣,壽豐鄉,池南村,185,773,218,129,347,49,396
公投第１６案,花蓮縣,壽豐鄉,平和村,186,1029,292,223,515,70,585
公投第１６案,花蓮縣,壽豐鄉,平和村,187,407,131,95,226,32,258
公投第１６案,花蓮縣,壽豐鄉,志學村,188,1139,344,233,577,69,646
公投第１６案,花蓮縣,壽豐鄉,志學村,189,996,291,235,526,48,574
公投第１６案,花蓮縣,壽豐鄉,志學村,190,414,102,72,174,13,187
公投第１６案,花蓮縣,壽豐鄉,米棧村,191,270,87,58,145,12,157
公投第１６案,花蓮縣,壽豐鄉,月眉村,192,836,274,151,425,63,488
公投第１６案,花蓮縣,壽豐鄉,鹽寮村,193,507,165,118,283,26,309
公投第１６案,花蓮縣,壽豐鄉,水璉村,194,739,156,98,254,62,316
公投第１６案,花蓮縣,鳳林鎮,鳳仁里,195,1192,413,231,644,81,725
公投第１６案,花蓮縣,鳳林鎮,鳳義里,196,639,178,115,293,31,324
公投第１６案,花蓮縣,鳳林鎮,鳳禮里,197,601,212,137,349,51,400
公投第１６案,花蓮縣,鳳林鎮,鳳智里,198,1137,434,234,668,58,726
公投第１６案,花蓮縣,鳳林鎮,鳳信里,199,742,201,158,359,58,417
公投第１６案,花蓮縣,鳳林鎮,鳳信里,200,610,192,121,313,37,350
公投第１６案,花蓮縣,鳳林鎮,山興里,201,295,76,69,145,47,192
公投第１６案,花蓮縣,鳳林鎮,山興里,202,218,35,30,65,2,67
公投第１６案,花蓮縣,鳳林鎮,大榮里,203,720,163,109,272,26,298
公投第１６案,花蓮縣,鳳林鎮,大榮里,204,528,139,98,237,50,287
公投第１６案,花蓮縣,鳳林鎮,北林里,205,560,144,110,254,37,291
公投第１６案,花蓮縣,鳳林鎮,南平里,206,541,146,89,235,57,292
公投第１６案,花蓮縣,鳳林鎮,林榮里,207,818,262,131,393,71,464
公投第１６案,花蓮縣,鳳林鎮,長橋里,208,984,225,143,368,48,416
公投第１６案,花蓮縣,鳳林鎮,森榮里,209,91,24,15,39,10,49
公投第１６案,花蓮縣,光復鄉,大華村,210,1295,355,259,614,111,725
公投第１６案,花蓮縣,光復鄉,大安村,211,859,284,164,448,53,501
公投第１６案,花蓮縣,光復鄉,大平村,212,958,272,184,456,113,569
公投第１６案,花蓮縣,光復鄉,大馬村,213,1011,280,190,470,111,581
公投第１６案,花蓮縣,光復鄉,大同村,214,1041,335,190,525,78,603
公投第１６案,花蓮縣,光復鄉,東富村,215,821,211,128,339,109,448
公投第１６案,花蓮縣,光復鄉,東富村,216,188,26,9,35,0,35
公投第１６案,花蓮縣,光復鄉,西富村,217,514,154,84,238,44,282
公投第１６案,花蓮縣,光復鄉,西富村,218,446,86,63,149,15,164
公投第１６案,花蓮縣,光復鄉,南富村,219,851,231,137,368,60,428
公投第１６案,花蓮縣,光復鄉,北富村,220,932,162,137,299,36,335
公投第１６案,花蓮縣,光復鄉,大進村,221,471,154,83,237,30,267
公投第１６案,花蓮縣,光復鄉,大全村,222,640,169,130,299,58,357
公投第１６案,花蓮縣,光復鄉,大全村,223,116,26,15,41,4,45
公投第１６案,花蓮縣,光復鄉,大興村,224,496,86,50,136,11,147
公投第１６案,花蓮縣,光復鄉,大富村,225,324,89,44,133,13,146
公投第１６案,花蓮縣,光復鄉,大豐村,226,454,103,44,147,29,176
公投第１６案,花蓮縣,豐濱鄉,靜浦村,227,717,141,104,245,91,336
公投第１６案,花蓮縣,豐濱鄉,港口村,228,751,127,109,236,70,306
公投第１６案,花蓮縣,豐濱鄉,豐濱村,229,613,135,101,236,53,289
公投第１６案,花蓮縣,豐濱鄉,豐濱村,230,809,236,134,370,32,402
公投第１６案,花蓮縣,豐濱鄉,豐濱村,231,357,34,16,50,1,51
公投第１６案,花蓮縣,豐濱鄉,新社村,232,669,149,111,260,80,340
公投第１６案,花蓮縣,豐濱鄉,磯崎村,233,479,118,82,200,10,210
公投第１６案,花蓮縣,萬榮鄉,西林村,234,1072,289,203,492,102,594
公投第１６案,花蓮縣,萬榮鄉,見晴村,235,560,141,92,233,13,246
公投第１６案,花蓮縣,萬榮鄉,萬榮村,236,773,255,166,421,42,463
公投第１６案,花蓮縣,萬榮鄉,明利村,237,661,161,80,241,15,256
公投第１６案,花蓮縣,萬榮鄉,馬遠村,238,442,121,82,203,21,224
公投第１６案,花蓮縣,萬榮鄉,馬遠村,239,675,155,116,271,76,347
公投第１６案,花蓮縣,萬榮鄉,紅葉村,240,1086,316,274,590,148,738
公投第１６案,花蓮縣,瑞穗鄉,瑞穗村,241,813,274,142,416,55,471
公投第１６案,花蓮縣,瑞穗鄉,瑞穗村,242,1091,340,183,523,85,608
公投第１６案,花蓮縣,瑞穗鄉,瑞美村,243,839,259,155,414,63,477
公投第１６案,花蓮縣,瑞穗鄉,瑞美村,244,975,296,180,476,84,560
公投第１６案,花蓮縣,瑞穗鄉,瑞良村,245,546,136,83,219,36,255
公投第１６案,花蓮縣,瑞穗鄉,瑞祥村,246,1002,290,190,480,86,566
公投第１６案,花蓮縣,瑞穗鄉,瑞北村,247,593,132,100,232,44,276
公投第１６案,花蓮縣,瑞穗鄉,舞鶴村,248,965,275,192,467,87,554
公投第１６案,花蓮縣,瑞穗鄉,鶴岡村,249,863,230,169,399,76,475
公投第１６案,花蓮縣,瑞穗鄉,奇美村,250,340,46,29,75,4,79
公投第１６案,花蓮縣,瑞穗鄉,富源村,251,764,186,123,309,44,353
公投第１６案,花蓮縣,瑞穗鄉,富民村,252,868,100,58,158,10,168
公投第１６案,花蓮縣,瑞穗鄉,富興村,253,620,92,68,160,28,188
公投第１６案,花蓮縣,玉里鎮,中城里,254,1008,315,177,492,54,546
公投第１６案,花蓮縣,玉里鎮,中城里,255,939,282,221,503,55,558
公投第１６案,花蓮縣,玉里鎮,中城里,256,1256,385,193,578,80,658
公投第１６案,花蓮縣,玉里鎮,中城里,257,929,261,179,440,66,506
公投第１６案,花蓮縣,玉里鎮,中城里,258,979,289,200,489,49,538
公投第１６案,花蓮縣,玉里鎮,國武里,259,1244,439,239,678,52,730
公投第１６案,花蓮縣,玉里鎮,啟模里,260,847,217,139,356,60,416
公投第１６案,花蓮縣,玉里鎮,啟模里,261,772,180,143,323,57,380
公投第１６案,花蓮縣,玉里鎮,泰昌里,262,558,149,103,252,26,278
公投第１６案,花蓮縣,玉里鎮,泰昌里,263,800,139,91,230,30,260
公投第１６案,花蓮縣,玉里鎮,永昌里,264,1286,336,180,516,78,594
公投第１６案,花蓮縣,玉里鎮,源城里,265,1246,227,280,507,94,601
公投第１６案,花蓮縣,玉里鎮,長良里,266,647,140,137,277,68,345
公投第１６案,花蓮縣,玉里鎮,樂合里,267,990,135,72,207,17,224
公投第１６案,花蓮縣,玉里鎮,東豐里,268,530,122,80,202,60,262
公投第１６案,花蓮縣,玉里鎮,觀音里,269,979,168,140,308,54,362
公投第１６案,花蓮縣,玉里鎮,觀音里,270,557,140,83,223,97,320
公投第１６案,花蓮縣,玉里鎮,松浦里,271,434,89,48,137,24,161
公投第１６案,花蓮縣,玉里鎮,松浦里,272,1065,177,97,274,95,369
公投第１６案,花蓮縣,玉里鎮,春日里,273,866,183,157,340,119,459
公投第１６案,花蓮縣,玉里鎮,德武里,274,769,154,103,257,61,318
公投第１６案,花蓮縣,玉里鎮,三民里,275,869,189,135,324,46,370
公投第１６案,花蓮縣,玉里鎮,大禹里,276,1080,337,54,391,56,447
公投第１６案,花蓮縣,富里鄉,吳江村,277,467,112,62,174,21,195
公投第１６案,花蓮縣,富里鄉,東里村,278,1032,206,140,346,64,410
公投第１６案,花蓮縣,富里鄉,萬寧村,279,638,133,104,237,43,280
公投第１６案,花蓮縣,富里鄉,新興村,280,591,144,97,241,80,321
公投第１６案,花蓮縣,富里鄉,竹田村,281,1087,305,204,509,84,593
公投第１６案,花蓮縣,富里鄉,羅山村,282,431,111,86,197,27,224
公投第１６案,花蓮縣,富里鄉,石牌村,283,893,248,146,394,40,434
公投第１６案,花蓮縣,富里鄉,明里村,284,361,67,51,118,31,149
公投第１６案,花蓮縣,富里鄉,富里村,285,1362,291,204,495,48,543
公投第１６案,花蓮縣,富里鄉,永豐村,286,458,129,73,202,36,238
公投第１６案,花蓮縣,富里鄉,豐南村,287,621,99,57,156,42,198
公投第１６案,花蓮縣,富里鄉,富南村,288,493,129,88,217,26,243
公投第１６案,花蓮縣,富里鄉,學田村,289,631,159,90,249,53,302
公投第１６案,花蓮縣,卓溪鄉,崙山村,290,533,135,121,256,26,282
公投第１６案,花蓮縣,卓溪鄉,立山村,291,522,172,96,268,59,327
公投第１６案,花蓮縣,卓溪鄉,立山村,292,493,110,65,175,20,195
公投第１６案,花蓮縣,卓溪鄉,太平村,293,701,226,152,378,61,439
公投第１６案,花蓮縣,卓溪鄉,卓溪村,294,746,210,173,383,60,443
公投第１６案,花蓮縣,卓溪鄉,卓清村,295,616,165,146,311,75,386
公投第１６案,花蓮縣,卓溪鄉,卓清村,296,405,67,40,107,25,132
公投第１６案,花蓮縣,卓溪鄉,古風村,297,329,98,52,150,29,179
公投第１６案,花蓮縣,卓溪鄉,古風村,298,428,138,56,194,21,215
公投第１６案,花蓮縣,卓溪鄉,古風村,299,174,59,26,85,13,98
公投第１６案,澎湖縣,馬公市,復興里,1,481,123,79,202,21,223
公投第１６案,澎湖縣,馬公市,長安里,2,558,176,91,267,18,285
公投第１６案,澎湖縣,馬公市,中央里,3,533,135,85,220,43,263
公投第１６案,澎湖縣,馬公市,啟明里,4,922,242,172,414,39,453
公投第１６案,澎湖縣,馬公市,重慶里,5,1021,290,204,494,47,541
公投第１６案,澎湖縣,馬公市,中興里,6,793,233,129,362,42,404
公投第１６案,澎湖縣,馬公市,光復里,7,954,279,180,459,51,510
公投第１６案,澎湖縣,馬公市,光復里,8,1001,274,183,457,44,501
公投第１６案,澎湖縣,馬公市,光明里,9,1192,316,163,479,52,531
公投第１６案,澎湖縣,馬公市,光榮里,10,1402,378,214,592,68,660
公投第１６案,澎湖縣,馬公市,光榮里,11,1389,423,224,647,50,697
公投第１６案,澎湖縣,馬公市,光榮里,12,1339,403,223,626,65,691
公投第１６案,澎湖縣,馬公市,朝陽里,13,1254,350,188,538,54,592
公投第１６案,澎湖縣,馬公市,朝陽里,14,1194,341,202,543,58,601
公投第１６案,澎湖縣,馬公市,朝陽里,15,1393,365,246,611,61,672
公投第１６案,澎湖縣,馬公市,朝陽里,16,1440,446,256,702,49,751
公投第１６案,澎湖縣,馬公市,陽明里,17,1215,311,212,523,67,590
公投第１６案,澎湖縣,馬公市,陽明里,18,1284,358,192,550,83,633
公投第１６案,澎湖縣,馬公市,重光里,19,1512,428,243,671,75,746
公投第１６案,澎湖縣,馬公市,西衛里,20,1181,311,167,478,92,570
公投第１６案,澎湖縣,馬公市,西衛里,21,1348,412,211,623,47,670
公投第１６案,澎湖縣,馬公市,西衛里,22,1391,414,253,667,52,719
公投第１６案,澎湖縣,馬公市,西衛里,23,2124,493,386,879,58,937
公投第１６案,澎湖縣,馬公市,西文里,24,1500,440,221,661,79,740
公投第１６案,澎湖縣,馬公市,西文里,25,1582,474,248,722,56,778
公投第１６案,澎湖縣,馬公市,東文里,26,1638,474,263,737,57,794
公投第１６案,澎湖縣,馬公市,東文里,27,1554,456,297,753,57,810
公投第１６案,澎湖縣,馬公市,案山里,28,980,219,134,353,26,379
公投第１６案,澎湖縣,馬公市,案山里,29,892,270,130,400,47,447
公投第１６案,澎湖縣,馬公市,光華里,30,778,193,111,304,17,321
公投第１６案,澎湖縣,馬公市,前寮里,31,930,292,146,438,34,472
公投第１６案,澎湖縣,馬公市,石泉里,32,1481,515,275,790,66,856
公投第１６案,澎湖縣,馬公市,石泉里,33,1128,382,184,566,26,592
公投第１６案,澎湖縣,馬公市,菜園里,34,415,115,72,187,31,218
公投第１６案,澎湖縣,馬公市,東衛里,35,1120,328,168,496,60,556
公投第１６案,澎湖縣,馬公市,東衛里,36,950,340,143,483,32,515
公投第１６案,澎湖縣,馬公市,安宅里,37,627,161,84,245,36,281
公投第１６案,澎湖縣,馬公市,興仁里,38,1055,319,164,483,37,520
公投第１６案,澎湖縣,馬公市,烏崁里,39,989,300,170,470,48,518
公投第１６案,澎湖縣,馬公市,鐵線里,40,591,181,103,284,45,329
公投第１６案,澎湖縣,馬公市,鎖港里,41,1387,350,217,567,91,658
公投第１６案,澎湖縣,馬公市,鎖港里,42,1079,244,162,406,62,468
公投第１６案,澎湖縣,馬公市,山水里,43,797,227,109,336,61,397
公投第１６案,澎湖縣,馬公市,山水里,44,903,239,113,352,31,383
公投第１６案,澎湖縣,馬公市,五德里,45,376,89,56,145,29,174
公投第１６案,澎湖縣,馬公市,井垵里,46,371,105,67,172,23,195
公投第１６案,澎湖縣,馬公市,嵵裡里,47,1173,224,194,418,26,444
公投第１６案,澎湖縣,馬公市,風櫃里,48,1389,252,161,413,45,458
公投第１６案,澎湖縣,馬公市,虎井里,49,761,89,62,151,62,213
公投第１６案,澎湖縣,馬公市,桶盤里,50,288,91,62,153,23,176
公投第１６案,澎湖縣,湖西鄉,湖西村,51,1120,330,165,495,80,575
公投第１６案,澎湖縣,湖西鄉,湖東村,52,332,80,51,131,11,142
公投第１６案,澎湖縣,湖西鄉,青螺村,53,242,48,36,84,5,89
公投第１６案,澎湖縣,湖西鄉,白坑村,54,293,65,27,92,8,100
公投第１６案,澎湖縣,湖西鄉,南寮村,55,666,136,86,222,51,273
公投第１６案,澎湖縣,湖西鄉,北寮村,56,326,91,51,142,20,162
公投第１６案,澎湖縣,湖西鄉,紅羅村,57,732,142,102,244,28,272
公投第１６案,澎湖縣,湖西鄉,西溪村,58,651,182,85,267,30,297
公投第１６案,澎湖縣,湖西鄉,成功村,59,744,204,86,290,22,312
公投第１６案,澎湖縣,湖西鄉,東石村,60,134,43,26,69,5,74
公投第１６案,澎湖縣,湖西鄉,沙港村,61,794,147,88,235,26,261
公投第１６案,澎湖縣,湖西鄉,中西村,62,216,54,22,76,2,78
公投第１６案,澎湖縣,湖西鄉,鼎灣村,63,664,120,57,177,18,195
公投第１６案,澎湖縣,湖西鄉,潭邊村,64,279,80,39,119,11,130
公投第１６案,澎湖縣,湖西鄉,許家村,65,296,95,44,139,9,148
公投第１６案,澎湖縣,湖西鄉,城北村,66,257,78,27,105,15,120
公投第１６案,澎湖縣,湖西鄉,太武村,67,89,18,6,24,3,27
公投第１６案,澎湖縣,湖西鄉,隘門村,68,815,201,149,350,37,387
公投第１６案,澎湖縣,湖西鄉,林投村,69,975,229,120,349,31,380
公投第１６案,澎湖縣,湖西鄉,尖山村,70,648,179,106,285,30,315
公投第１６案,澎湖縣,湖西鄉,龍門村,71,893,204,123,327,32,359
公投第１６案,澎湖縣,湖西鄉,龍門村,72,846,215,132,347,91,438
公投第１６案,澎湖縣,湖西鄉,菓葉村,73,729,137,99,236,20,256
公投第１６案,澎湖縣,白沙鄉,中屯村,74,514,130,102,232,24,256
公投第１６案,澎湖縣,白沙鄉,講美村,75,657,193,123,316,18,334
公投第１６案,澎湖縣,白沙鄉,城前村,76,109,40,27,67,6,73
公投第１６案,澎湖縣,白沙鄉,鎮海村,77,156,47,12,59,6,65
公投第１６案,澎湖縣,白沙鄉,港子村,78,293,69,40,109,10,119
公投第１６案,澎湖縣,白沙鄉,岐頭村,79,231,42,24,66,4,70
公投第１６案,澎湖縣,白沙鄉,小赤村,80,161,49,27,76,10,86
公投第１６案,澎湖縣,白沙鄉,赤崁村,81,1705,476,246,722,63,785
公投第１６案,澎湖縣,白沙鄉,瓦硐村,82,285,71,39,110,11,121
公投第１６案,澎湖縣,白沙鄉,後寮村,83,723,117,79,196,19,215
公投第１６案,澎湖縣,白沙鄉,通梁村,84,774,149,98,247,38,285
公投第１６案,澎湖縣,白沙鄉,吉貝村,85,1429,219,157,376,118,494
公投第１６案,澎湖縣,白沙鄉,鳥嶼村,86,1084,297,124,421,77,498
公投第１６案,澎湖縣,白沙鄉,員貝村,87,251,68,48,116,9,125
公投第１６案,澎湖縣,白沙鄉,大倉村,88,253,36,34,70,19,89
公投第１６案,澎湖縣,西嶼鄉,橫礁村,89,283,22,19,41,3,44
公投第１６案,澎湖縣,西嶼鄉,合界村,90,424,70,37,107,15,122
公投第１６案,澎湖縣,西嶼鄉,竹灣村,91,826,137,88,225,60,285
公投第１６案,澎湖縣,西嶼鄉,小門村,92,282,55,34,89,14,103
公投第１６案,澎湖縣,西嶼鄉,大池村,93,661,112,80,192,62,254
公投第１６案,澎湖縣,西嶼鄉,二崁村,94,141,11,14,25,3,28
公投第１６案,澎湖縣,西嶼鄉,池東村,95,635,108,54,162,13,175
公投第１６案,澎湖縣,西嶼鄉,池西村,96,216,39,23,62,6,68
公投第１６案,澎湖縣,西嶼鄉,赤馬村,97,572,60,43,103,30,133
公投第１６案,澎湖縣,西嶼鄉,內垵村,98,1267,267,139,406,97,503
公投第１６案,澎湖縣,西嶼鄉,外垵村,99,942,188,85,273,26,299
公投第１６案,澎湖縣,西嶼鄉,外垵村,100,1133,197,152,349,81,430
公投第１６案,澎湖縣,望安鄉,東安村,101,734,175,103,278,51,329
公投第１６案,澎湖縣,望安鄉,西安村,102,454,105,53,158,32,190
公投第１６案,澎湖縣,望安鄉,中社村,103,300,54,27,81,16,97
公投第１６案,澎湖縣,望安鄉,水垵村,104,471,128,68,196,43,239
公投第１６案,澎湖縣,望安鄉,將軍村,105,672,123,58,181,27,208
公投第１６案,澎湖縣,望安鄉,將軍村,106,742,141,105,246,51,297
公投第１６案,澎湖縣,望安鄉,東吉村,107,264,49,41,90,18,108
公投第１６案,澎湖縣,望安鄉,東坪村,108,476,101,64,165,8,173
公投第１６案,澎湖縣,望安鄉,西坪村,109,208,20,20,40,4,44
公投第１６案,澎湖縣,望安鄉,花嶼村,110,307,49,34,83,9,92
公投第１６案,澎湖縣,七美鄉,東湖村,111,248,41,21,62,4,66
公投第１６案,澎湖縣,七美鄉,西湖村,112,581,93,78,171,33,204
公投第１６案,澎湖縣,七美鄉,中和村,113,641,108,78,186,39,225
公投第１６案,澎湖縣,七美鄉,平和村,114,382,63,44,107,9,116
公投第１６案,澎湖縣,七美鄉,海豐村,115,351,47,18,65,7,72
公投第１６案,澎湖縣,七美鄉,南港村,116,1171,183,101,284,32,316
公投第１６案,基隆市,中正區,長潭里,1,466,108,114,222,23,245
公投第１６案,基隆市,中正區,砂子里,2,1262,278,212,490,39,529
公投第１６案,基隆市,中正區,砂子里,3,1171,259,229,488,66,554
公投第１６案,基隆市,中正區,砂子里,4,2823,621,410,1031,30,1061
公投第１６案,基隆市,中正區,八斗里,5,1474,321,251,572,69,641
公投第１６案,基隆市,中正區,碧砂里,6,1271,301,176,477,76,553
公投第１６案,基隆市,中正區,新富里,7,2707,623,436,1059,102,1161
公投第１６案,基隆市,中正區,新富里,8,1545,381,241,622,126,748
公投第１６案,基隆市,中正區,新富里,9,761,159,98,257,23,280
公投第１６案,基隆市,中正區,新豐里,10,1352,361,259,620,25,645
公投第１６案,基隆市,中正區,新豐里,11,1413,405,218,623,25,648
公投第１６案,基隆市,中正區,新豐里,12,2665,654,431,1085,63,1148
公投第１６案,基隆市,中正區,平寮里,13,1261,292,227,519,68,587
公投第１６案,基隆市,中正區,社寮里,14,1753,461,317,778,97,875
公投第１６案,基隆市,中正區,和憲里,15,984,199,187,386,55,441
公投第１６案,基隆市,中正區,海濱里,16,1166,282,195,477,42,519
公投第１６案,基隆市,中正區,正濱里,17,973,261,171,432,38,470
公投第１６案,基隆市,中正區,中正里,18,1694,358,229,587,34,621
公投第１６案,基隆市,中正區,中濱里,19,1270,355,242,597,40,637
公投第１６案,基隆市,中正區,建國里,20,1090,295,217,512,55,567
公投第１６案,基隆市,中正區,建國里,21,870,264,153,417,33,450
公投第１６案,基隆市,中正區,砂灣里,22,1138,298,229,527,45,572
公投第１６案,基隆市,中正區,砂灣里,23,862,223,150,373,50,423
公投第１６案,基隆市,中正區,真砂里,24,1341,406,250,656,77,733
公投第１６案,基隆市,中正區,正砂里,25,859,248,183,431,42,473
公投第１６案,基隆市,中正區,正砂里,26,1457,374,268,642,32,674
公投第１６案,基隆市,中正區,中砂里,27,1594,343,243,586,70,656
公投第１６案,基隆市,中正區,入船里,28,802,210,169,379,48,427
公投第１６案,基隆市,中正區,正船里,29,1267,342,234,576,42,618
公投第１６案,基隆市,中正區,中船里,30,1175,293,264,557,70,627
公投第１６案,基隆市,中正區,港通里,31,1210,359,261,620,53,673
公投第１６案,基隆市,中正區,義重里,32,1037,267,200,467,72,539
公投第１６案,基隆市,中正區,正義里,33,1219,346,222,568,67,635
公投第１６案,基隆市,中正區,信義里,34,904,251,161,412,26,438
公投第１６案,基隆市,中正區,德義里,35,709,215,188,403,39,442
公投第１６案,基隆市,信義區,仁壽里,36,1096,340,126,466,56,522
公投第１６案,基隆市,信義區,仁義里,37,1232,392,284,676,53,729
公投第１６案,基隆市,信義區,義昭里,38,1184,374,240,614,25,639
公投第１６案,基隆市,信義區,義幸里,39,1133,378,222,600,65,665
公投第１６案,基隆市,信義區,義幸里,40,1188,362,251,613,43,656
公投第１６案,基隆市,信義區,義民里,41,725,227,156,383,38,421
公投第１６案,基隆市,信義區,義和里,42,1524,393,278,671,52,723
公投第１６案,基隆市,信義區,智慧里,43,736,218,154,372,35,407
公投第１６案,基隆市,信義區,智誠里,44,611,158,127,285,27,312
公投第１６案,基隆市,信義區,智誠里,45,951,232,169,401,29,430
公投第１６案,基隆市,信義區,禮儀里,46,1616,500,296,796,44,840
公投第１６案,基隆市,信義區,禮東里,47,1516,526,239,765,49,814
公投第１６案,基隆市,信義區,信綠里,48,1049,284,218,502,36,538
公投第１６案,基隆市,信義區,信綠里,49,1069,308,216,524,30,554
公投第１６案,基隆市,信義區,東信里,50,727,213,175,388,32,420
公投第１６案,基隆市,信義區,東信里,51,929,310,210,520,26,546
公投第１６案,基隆市,信義區,東信里,52,1118,381,276,657,34,691
公投第１６案,基隆市,信義區,東信里,53,1339,433,275,708,43,751
公投第１６案,基隆市,信義區,東光里,54,999,281,189,470,39,509
公投第１６案,基隆市,信義區,東光里,55,764,224,147,371,18,389
公投第１６案,基隆市,信義區,東明里,56,1555,420,280,700,45,745
公投第１６案,基隆市,信義區,東明里,57,2015,574,350,924,37,961
公投第１６案,基隆市,信義區,東安里,58,1268,410,250,660,56,716
公投第１６案,基隆市,信義區,東安里,59,1569,489,285,774,58,832
公投第１６案,基隆市,信義區,孝賢里,60,1985,526,356,882,71,953
公投第１６案,基隆市,信義區,孝賢里,61,1476,492,280,772,36,808
公投第１６案,基隆市,信義區,孝忠里,62,1493,504,296,800,34,834
公投第１６案,基隆市,信義區,孝忠里,63,1249,436,279,715,35,750
公投第１６案,基隆市,信義區,孝忠里,64,1559,465,277,742,41,783
公投第１６案,基隆市,信義區,孝忠里,65,1168,331,209,540,23,563
公投第１６案,基隆市,信義區,孝忠里,66,1602,489,294,783,42,825
公投第１６案,基隆市,信義區,孝德里,67,1485,292,340,632,43,675
公投第１６案,基隆市,信義區,孝德里,68,1009,300,173,473,32,505
公投第１６案,基隆市,信義區,孝深里,69,2016,507,301,808,53,861
公投第１６案,基隆市,信義區,孝深里,70,1764,427,266,693,47,740
公投第１６案,基隆市,信義區,孝岡里,71,1295,380,260,640,59,699
公投第１６案,基隆市,仁愛區,林泉里,72,1782,410,294,704,106,810
公投第１６案,基隆市,仁愛區,花崗里,73,1055,309,232,541,59,600
公投第１６案,基隆市,仁愛區,虹橋里,74,1558,377,308,685,41,726
公投第１６案,基隆市,仁愛區,水錦里,75,1736,508,326,834,60,894
公投第１６案,基隆市,仁愛區,智仁里,76,1243,393,281,674,59,733
公投第１６案,基隆市,仁愛區,智仁里,77,1109,310,271,581,42,623
公投第１６案,基隆市,仁愛區,和明里,78,1684,576,323,899,57,956
公投第１６案,基隆市,仁愛區,忠勇里,79,919,265,193,458,43,501
公投第１６案,基隆市,仁愛區,玉田里,80,991,272,208,480,19,499
公投第１６案,基隆市,仁愛區,仁德里,81,876,264,185,449,21,470
公投第１６案,基隆市,仁愛區,博愛里,82,1046,321,236,557,49,606
公投第１６案,基隆市,仁愛區,博愛里,83,434,143,95,238,25,263
公投第１６案,基隆市,仁愛區,福仁里,84,764,212,174,386,71,457
公投第１６案,基隆市,仁愛區,誠仁里,85,968,265,195,460,35,495
公投第１６案,基隆市,仁愛區,吉仁里,86,1326,344,272,616,61,677
公投第１６案,基隆市,仁愛區,吉仁里,87,1315,284,209,493,58,551
公投第１６案,基隆市,仁愛區,育仁里,88,775,246,150,396,51,447
公投第１６案,基隆市,仁愛區,英仁里,89,652,173,153,326,53,379
公投第１６案,基隆市,仁愛區,英仁里,90,674,215,121,336,42,378
公投第１６案,基隆市,仁愛區,龍門里,91,789,198,160,358,52,410
公投第１６案,基隆市,仁愛區,德厚里,92,1715,490,322,812,87,899
公投第１６案,基隆市,仁愛區,曲水里,93,849,218,183,401,54,455
公投第１６案,基隆市,仁愛區,崇文里,94,875,273,171,444,29,473
公投第１６案,基隆市,仁愛區,文安里,95,851,234,156,390,45,435
公投第１６案,基隆市,仁愛區,兆連里,96,735,216,166,382,45,427
公投第１６案,基隆市,仁愛區,獅球里,97,1009,267,190,457,77,534
公投第１６案,基隆市,仁愛區,書院里,98,1082,246,220,466,64,530
公投第１６案,基隆市,仁愛區,朝棟里,99,1278,328,252,580,85,665
公投第１６案,基隆市,仁愛區,朝棟里,100,1519,510,293,803,64,867
公投第１６案,基隆市,仁愛區,光華里,101,1336,309,234,543,56,599
公投第１６案,基隆市,仁愛區,光華里,102,1178,359,280,639,69,708
公投第１６案,基隆市,仁愛區,明德里,103,708,191,137,328,54,382
公投第１６案,基隆市,仁愛區,同風里,104,567,167,157,324,34,358
公投第１６案,基隆市,仁愛區,文昌里,105,751,195,172,367,49,416
公投第１６案,基隆市,仁愛區,新店里,106,589,189,134,323,31,354
公投第１６案,基隆市,中山區,新建里,107,796,229,137,366,33,399
公投第１６案,基隆市,中山區,安民里,108,1036,360,209,569,69,638
公投第１６案,基隆市,中山區,安平里,109,756,205,180,385,47,432
公投第１６案,基隆市,中山區,中山里,110,957,210,180,390,31,421
公投第１６案,基隆市,中山區,民治里,111,802,231,170,401,13,414
公投第１６案,基隆市,中山區,中興里,112,1263,369,242,611,64,675
公投第１６案,基隆市,中山區,仁正里,113,778,244,181,425,27,452
公投第１６案,基隆市,中山區,健民里,114,1180,338,216,554,113,667
公投第１６案,基隆市,中山區,通化里,115,990,271,164,435,31,466
公投第１６案,基隆市,中山區,居仁里,116,1332,284,227,511,36,547
公投第１６案,基隆市,中山區,通明里,117,848,199,162,361,34,395
公投第１６案,基隆市,中山區,通明里,118,922,242,167,409,18,427
公投第１６案,基隆市,中山區,和平里,119,459,136,113,249,23,272
公投第１６案,基隆市,中山區,仙洞里,120,574,152,96,248,32,280
公投第１６案,基隆市,中山區,太白里,121,877,246,150,396,58,454
公投第１６案,基隆市,中山區,協和里,122,1584,385,277,662,46,708
公投第１６案,基隆市,中山區,文化里,123,1319,256,199,455,38,493
公投第１６案,基隆市,中山區,德安里,124,1938,527,366,893,89,982
公投第１６案,基隆市,中山區,德安里,125,1877,494,341,835,63,898
公投第１６案,基隆市,中山區,德和里,126,2088,666,409,1075,39,1114
公投第１６案,基隆市,中山區,德和里,127,1946,627,360,987,42,1029
公投第１６案,基隆市,中山區,德和里,128,1353,410,305,715,49,764
公投第１６案,基隆市,中山區,中和里,129,1317,361,252,613,16,629
公投第１６案,基隆市,中山區,中和里,130,870,258,207,465,31,496
公投第１６案,基隆市,中山區,中和里,131,1322,418,274,692,27,719
公投第１６案,基隆市,中山區,中和里,132,1295,328,231,559,32,591
公投第１６案,基隆市,中山區,中和里,133,756,238,187,425,35,460
公投第１６案,基隆市,中山區,和慶里,134,1602,387,282,669,42,711
公投第１６案,基隆市,中山區,和慶里,135,1568,399,309,708,40,748
公投第１６案,基隆市,中山區,和慶里,136,1404,396,296,692,46,738
公投第１６案,基隆市,中山區,和慶里,137,1909,514,330,844,32,876
公投第１６案,基隆市,中山區,西康里,138,1642,404,272,676,84,760
公投第１６案,基隆市,中山區,西定里,139,932,238,161,399,31,430
公投第１６案,基隆市,中山區,西華里,140,849,271,188,459,52,511
公投第１６案,基隆市,中山區,西榮里,141,715,202,175,377,50,427
公投第１６案,基隆市,安樂區,新西里,142,1361,358,233,591,61,652
公投第１６案,基隆市,安樂區,西川里,143,1213,311,221,532,47,579
公投第１６案,基隆市,安樂區,定國里,144,1026,259,168,427,34,461
公投第１６案,基隆市,安樂區,定邦里,145,1038,296,244,540,86,626
公投第１６案,基隆市,安樂區,慈仁里,146,897,265,188,453,65,518
公投第１６案,基隆市,安樂區,干城里,147,1401,389,278,667,75,742
公投第１６案,基隆市,安樂區,干城里,148,641,127,91,218,9,227
公投第１６案,基隆市,安樂區,永康里,149,1472,379,284,663,55,718
公投第１６案,基隆市,安樂區,永康里,150,472,133,98,231,30,261
公投第１６案,基隆市,安樂區,安和里,151,841,246,213,459,36,495
公投第１６案,基隆市,安樂區,樂一里,152,571,148,117,265,38,303
公投第１６案,基隆市,安樂區,嘉仁里,153,1901,466,368,834,57,891
公投第１６案,基隆市,安樂區,嘉仁里,154,1349,346,292,638,57,695
公投第１６案,基隆市,安樂區,三民里,155,1225,339,244,583,42,625
公投第１６案,基隆市,安樂區,三民里,156,1351,413,280,693,53,746
公投第１６案,基隆市,安樂區,壯觀里,157,1601,536,319,855,53,908
公投第１６案,基隆市,安樂區,壯觀里,158,2513,730,510,1240,52,1292
公投第１６案,基隆市,安樂區,四維里,159,1613,506,316,822,50,872
公投第１６案,基隆市,安樂區,四維里,160,1731,550,334,884,57,941
公投第１６案,基隆市,安樂區,四維里,161,1424,472,338,810,35,845
公投第１６案,基隆市,安樂區,五福里,162,1806,504,347,851,68,919
公投第１６案,基隆市,安樂區,五福里,163,1679,526,347,873,74,947
公投第１６案,基隆市,安樂區,六合里,164,1902,576,352,928,57,985
公投第１６案,基隆市,安樂區,六合里,165,2040,658,337,995,48,1043
公投第１６案,基隆市,安樂區,七賢里,166,1313,374,287,661,50,711
公投第１６案,基隆市,安樂區,七賢里,167,1243,332,257,589,33,622
公投第１６案,基隆市,安樂區,長樂里,168,1759,570,300,870,26,896
公投第１６案,基隆市,安樂區,長樂里,169,694,244,173,417,21,438
公投第１６案,基隆市,安樂區,長樂里,170,866,310,214,524,27,551
公投第１６案,基隆市,安樂區,鶯歌里,171,1557,385,246,631,33,664
公投第１６案,基隆市,安樂區,鶯歌里,172,1411,427,265,692,26,718
公投第１６案,基隆市,安樂區,鶯安里,173,1568,532,325,857,33,890
公投第１６案,基隆市,安樂區,鶯安里,174,1400,428,262,690,42,732
公投第１６案,基隆市,安樂區,鶯安里,175,1531,501,264,765,16,781
公投第１６案,基隆市,安樂區,興寮里,176,1673,470,289,759,36,795
公投第１６案,基隆市,安樂區,興寮里,177,1054,299,206,505,54,559
公投第１６案,基隆市,安樂區,興寮里,178,1923,490,279,769,45,814
公投第１６案,基隆市,安樂區,外寮里,179,1960,741,276,1017,32,1049
公投第１６案,基隆市,安樂區,外寮里,180,1962,565,337,902,65,967
公投第１６案,基隆市,安樂區,新崙里,181,2117,601,430,1031,62,1093
公投第１６案,基隆市,安樂區,新崙里,182,1829,512,336,848,41,889
公投第１６案,基隆市,安樂區,武崙里,183,1529,424,278,702,39,741
公投第１６案,基隆市,安樂區,武崙里,184,1869,558,345,903,48,951
公投第１６案,基隆市,安樂區,武崙里,185,1140,390,217,607,17,624
公投第１６案,基隆市,安樂區,中崙里,186,1641,447,338,785,51,836
公投第１６案,基隆市,安樂區,內寮里,187,1279,334,271,605,57,662
公投第１６案,基隆市,安樂區,內寮里,188,1360,406,255,661,38,699
公投第１６案,基隆市,安樂區,內寮里,189,1399,397,331,728,35,763
公投第１６案,基隆市,安樂區,內寮里,190,1251,365,239,604,35,639
公投第１６案,基隆市,暖暖區,八西里,191,1431,379,274,653,47,700
公投第１６案,基隆市,暖暖區,八中里,192,456,108,86,194,8,202
公投第１６案,基隆市,暖暖區,八堵里,193,637,204,126,330,23,353
公投第１６案,基隆市,暖暖區,八南里,194,735,226,173,399,28,427
公投第１６案,基隆市,暖暖區,過港里,195,1078,291,185,476,34,510
公投第１６案,基隆市,暖暖區,過港里,196,1238,343,196,539,53,592
公投第１６案,基隆市,暖暖區,過港里,197,1325,350,283,633,44,677
公投第１６案,基隆市,暖暖區,暖暖里,198,1475,432,287,719,57,776
公投第１６案,基隆市,暖暖區,暖暖里,199,1179,283,222,505,31,536
公投第１６案,基隆市,暖暖區,暖同里,200,1110,358,237,595,51,646
公投第１６案,基隆市,暖暖區,暖同里,201,1443,390,234,624,39,663
公投第１６案,基隆市,暖暖區,暖東里,202,415,108,82,190,33,223
公投第１６案,基隆市,暖暖區,暖西里,203,1378,399,248,647,18,665
公投第１６案,基隆市,暖暖區,暖西里,204,1570,435,342,777,42,819
公投第１６案,基隆市,暖暖區,暖西里,205,1603,605,266,871,60,931
公投第１６案,基隆市,暖暖區,碇內里,206,1267,396,266,662,58,720
公投第１６案,基隆市,暖暖區,碇內里,207,1359,407,257,664,51,715
公投第１６案,基隆市,暖暖區,碇和里,208,970,329,203,532,32,564
公投第１６案,基隆市,暖暖區,碇和里,209,1002,299,201,500,23,523
公投第１６案,基隆市,暖暖區,碇和里,210,944,240,194,434,40,474
公投第１６案,基隆市,暖暖區,碇祥里,211,1500,439,355,794,49,843
公投第１６案,基隆市,暖暖區,碇祥里,212,1442,357,202,559,26,585
公投第１６案,基隆市,暖暖區,碇祥里,213,1165,370,238,608,23,631
公投第１６案,基隆市,暖暖區,碇祥里,214,1610,452,319,771,39,810
公投第１６案,基隆市,暖暖區,碇安里,215,1328,396,294,690,36,726
公投第１６案,基隆市,暖暖區,碇安里,216,1173,349,222,571,29,600
公投第１６案,基隆市,暖暖區,碇安里,217,1019,331,228,559,39,598
公投第１６案,基隆市,暖暖區,碇安里,218,1373,436,257,693,23,716
公投第１６案,基隆市,七堵區,長興里,219,1258,354,282,636,76,712
公投第１６案,基隆市,七堵區,長興里,220,1237,366,262,628,49,677
公投第１６案,基隆市,七堵區,長興里,221,1259,355,255,610,34,644
公投第１６案,基隆市,七堵區,正光里,222,1120,245,253,498,57,555
公投第１６案,基隆市,七堵區,正光里,223,1344,344,229,573,67,640
公投第１６案,基隆市,七堵區,正明里,224,1011,319,243,562,58,620
公投第１６案,基隆市,七堵區,正明里,225,925,244,192,436,29,465
公投第１６案,基隆市,七堵區,富民里,226,1735,536,376,912,73,985
公投第１６案,基隆市,七堵區,富民里,227,1833,547,411,958,74,1032
公投第１６案,基隆市,七堵區,永平里,228,938,281,203,484,23,507
公投第１６案,基隆市,七堵區,永平里,229,962,296,215,511,63,574
公投第１６案,基隆市,七堵區,永安里,230,1191,371,257,628,48,676
公投第１６案,基隆市,七堵區,永安里,231,999,302,209,511,57,568
公投第１６案,基隆市,七堵區,八德里,232,282,81,47,128,9,137
公投第１６案,基隆市,七堵區,八德里,233,1243,349,234,583,58,641
公投第１６案,基隆市,七堵區,自強里,234,1092,296,219,515,50,565
公投第１６案,基隆市,七堵區,泰安里,235,1246,330,286,616,52,668
公投第１６案,基隆市,七堵區,泰安里,236,1722,659,135,794,69,863
公投第１６案,基隆市,七堵區,泰安里,237,1318,358,297,655,39,694
公投第１６案,基隆市,七堵區,六堵里,238,975,273,163,436,24,460
公投第１６案,基隆市,七堵區,六堵里,239,1285,360,271,631,40,671
公投第１６案,基隆市,七堵區,堵南里,240,1077,235,226,461,58,519
公投第１６案,基隆市,七堵區,堵南里,241,989,264,168,432,43,475
公投第１６案,基隆市,七堵區,長安里,242,1193,319,241,560,38,598
公投第１６案,基隆市,七堵區,長安里,243,1273,483,122,605,53,658
公投第１６案,基隆市,七堵區,堵北里,244,1774,501,347,848,96,944
公投第１６案,基隆市,七堵區,堵北里,245,1689,461,348,809,80,889
公投第１６案,基隆市,七堵區,百福里,246,1355,365,256,621,73,694
公投第１６案,基隆市,七堵區,百福里,247,1512,379,317,696,68,764
公投第１６案,基隆市,七堵區,百福里,248,1486,385,283,668,37,705
公投第１６案,基隆市,七堵區,百福里,249,1706,477,340,817,29,846
公投第１６案,基隆市,七堵區,實踐里,250,1384,406,284,690,64,754
公投第１６案,基隆市,七堵區,實踐里,251,1045,321,246,567,60,627
公投第１６案,基隆市,七堵區,實踐里,252,1374,384,302,686,46,732
公投第１６案,基隆市,七堵區,瑪南里,253,428,115,94,209,10,219
公投第１６案,基隆市,七堵區,瑪東里,254,326,98,71,169,28,197
公投第１６案,基隆市,七堵區,瑪西里,255,351,135,92,227,20,247
公投第１６案,基隆市,七堵區,友一里,256,1871,499,330,829,43,872
公投第１６案,基隆市,七堵區,友二里,257,448,110,78,188,12,200
公投第１６案,新竹市,東區,育賢里,1,1512,257,204,461,30,491
公投第１６案,新竹市,東區,親仁里,2,953,360,193,553,33,586
公投第１６案,新竹市,東區,親仁里,3,729,236,151,387,36,423
公投第１６案,新竹市,東區,東門里,4,566,173,154,327,26,353
公投第１６案,新竹市,東區,成功里,5,640,188,141,329,40,369
公投第１６案,新竹市,東區,榮光里,6,305,94,58,152,21,173
公投第１６案,新竹市,東區,中正里,7,563,175,135,310,32,342
公投第１６案,新竹市,東區,錦華里,8,741,220,164,384,23,407
公投第１６案,新竹市,東區,錦華里,9,1041,328,239,567,29,596
公投第１６案,新竹市,東區,文華里,10,1615,503,325,828,39,867
公投第１６案,新竹市,東區,文華里,11,1287,430,259,689,51,740
公投第１６案,新竹市,東區,文華里,12,1554,500,334,834,48,882
公投第１６案,新竹市,東區,復中里,13,1388,483,300,783,28,811
公投第１６案,新竹市,東區,復中里,14,1419,589,186,775,60,835
公投第１６案,新竹市,東區,復中里,15,1355,398,303,701,58,759
公投第１６案,新竹市,東區,復興里,16,1490,480,299,779,51,830
公投第１６案,新竹市,東區,復興里,17,1615,536,319,855,43,898
公投第１６案,新竹市,東區,復興里,18,1672,525,357,882,75,957
公投第１６案,新竹市,東區,三民里,19,1062,349,226,575,40,615
公投第１６案,新竹市,東區,三民里,20,1315,423,271,694,58,752
公投第１６案,新竹市,東區,三民里,21,1000,319,191,510,86,596
公投第１６案,新竹市,東區,三民里,22,1337,413,319,732,59,791
公投第１６案,新竹市,東區,東園里,23,1747,570,324,894,46,940
公投第１６案,新竹市,東區,東園里,24,1600,544,369,913,44,957
公投第１６案,新竹市,東區,東園里,25,1158,368,240,608,47,655
公投第１６案,新竹市,東區,東園里,26,828,291,211,502,40,542
公投第１６案,新竹市,東區,公園里,27,1573,481,340,821,49,870
公投第１６案,新竹市,東區,公園里,28,1550,515,321,836,54,890
公投第１６案,新竹市,東區,建華里,29,1317,390,299,689,37,726
公投第１６案,新竹市,東區,建華里,30,1040,322,263,585,61,646
公投第１６案,新竹市,東區,東山里,31,935,338,177,515,41,556
公投第１６案,新竹市,東區,東山里,32,1074,361,220,581,31,612
公投第１６案,新竹市,東區,東山里,33,1133,411,246,657,44,701
公投第１６案,新竹市,東區,綠水里,34,1262,443,276,719,38,757
公投第１６案,新竹市,東區,綠水里,35,1199,422,232,654,33,687
公投第１６案,新竹市,東區,綠水里,36,1226,433,278,711,42,753
公投第１６案,新竹市,東區,綠水里,37,1377,516,314,830,56,886
公投第１６案,新竹市,東區,綠水里,38,991,356,255,611,26,637
公投第１６案,新竹市,東區,東勢里,39,1271,396,295,691,73,764
公投第１６案,新竹市,東區,東勢里,40,1012,394,232,626,26,652
公投第１６案,新竹市,東區,光復里,41,1001,331,193,524,69,593
公投第１６案,新竹市,東區,光復里,42,1603,484,298,782,72,854
公投第１６案,新竹市,東區,前溪里,43,1236,362,292,654,28,682
公投第１６案,新竹市,東區,前溪里,44,1532,407,273,680,58,738
公投第１６案,新竹市,東區,水源里,45,1306,390,277,667,56,723
公投第１６案,新竹市,東區,水源里,46,1073,334,237,571,60,631
公投第１６案,新竹市,東區,水源里,47,952,293,205,498,22,520
公投第１６案,新竹市,東區,千甲里,48,1298,322,234,556,62,618
公投第１６案,新竹市,東區,千甲里,49,778,240,142,382,33,415
公投第１６案,新竹市,東區,豐功里,50,1195,394,265,659,51,710
公投第１６案,新竹市,東區,豐功里,51,1569,482,317,799,69,868
公投第１６案,新竹市,東區,豐功里,52,1533,582,347,929,34,963
公投第１６案,新竹市,東區,武功里,53,1336,513,248,761,55,816
公投第１６案,新竹市,東區,武功里,54,1367,515,249,764,49,813
公投第１６案,新竹市,東區,武功里,55,1289,504,241,745,43,788
公投第１６案,新竹市,東區,軍功里,56,960,301,199,500,31,531
公投第１６案,新竹市,東區,軍功里,57,843,312,189,501,38,539
公投第１６案,新竹市,東區,軍功里,58,948,326,210,536,51,587
公投第１６案,新竹市,東區,立功里,59,915,296,184,480,38,518
公投第１６案,新竹市,東區,建功里,60,1801,674,317,991,49,1040
公投第１６案,新竹市,東區,建功里,61,1079,357,224,581,37,618
公投第１６案,新竹市,東區,建功里,62,676,270,134,404,13,417
公投第１６案,新竹市,東區,光明里,63,1132,400,219,619,57,676
公投第１６案,新竹市,東區,光明里,64,251,93,49,142,10,152
公投第１６案,新竹市,東區,光明里,65,1620,585,304,889,49,938
公投第１６案,新竹市,東區,龍山里,66,1479,449,306,755,45,800
公投第１６案,新竹市,東區,龍山里,67,1402,434,291,725,32,757
公投第１６案,新竹市,東區,龍山里,68,1280,380,272,652,70,722
公投第１６案,新竹市,東區,龍山里,69,1228,403,296,699,29,728
公投第１６案,新竹市,東區,龍山里,70,1157,352,258,610,13,623
公投第１６案,新竹市,東區,龍山里,71,1354,451,281,732,40,772
公投第１６案,新竹市,東區,科園里,72,1334,534,297,831,24,855
公投第１６案,新竹市,東區,科園里,73,1234,418,275,693,38,731
公投第１６案,新竹市,東區,科園里,74,1398,530,302,832,44,876
公投第１６案,新竹市,東區,科園里,75,928,312,235,547,29,576
公投第１６案,新竹市,東區,科園里,76,1368,515,293,808,37,845
公投第１６案,新竹市,東區,埔頂里,77,1215,353,149,502,28,530
公投第１６案,新竹市,東區,埔頂里,78,1067,280,221,501,37,538
公投第１６案,新竹市,東區,埔頂里,79,1194,358,278,636,27,663
公投第１６案,新竹市,東區,埔頂里,80,1193,357,250,607,31,638
公投第１６案,新竹市,東區,新莊里,81,1388,414,305,719,85,804
公投第１６案,新竹市,東區,新莊里,82,1267,419,273,692,48,740
公投第１６案,新竹市,東區,新莊里,83,1299,431,293,724,26,750
公投第１６案,新竹市,東區,新莊里,84,1288,422,267,689,54,743
公投第１６案,新竹市,東區,關新里,85,1228,428,287,715,32,747
公投第１６案,新竹市,東區,關新里,86,1135,392,276,668,33,701
公投第１６案,新竹市,東區,關新里,87,1237,459,294,753,35,788
公投第１６案,新竹市,東區,關東里,88,1135,323,229,552,55,607
公投第１６案,新竹市,東區,關東里,89,1165,344,208,552,41,593
公投第１６案,新竹市,東區,關東里,90,1124,337,235,572,46,618
公投第１６案,新竹市,東區,關東里,91,1210,391,286,677,34,711
公投第１６案,新竹市,東區,金山里,92,1323,398,272,670,48,718
公投第１６案,新竹市,東區,金山里,93,1207,384,226,610,24,634
公投第１６案,新竹市,東區,金山里,94,1264,372,216,588,43,631
公投第１６案,新竹市,東區,金山里,95,1248,410,244,654,26,680
公投第１６案,新竹市,東區,仙水里,96,1400,530,292,822,37,859
公投第１６案,新竹市,東區,仙水里,97,1473,520,315,835,39,874
公投第１６案,新竹市,東區,仙水里,98,1367,443,285,728,49,777
公投第１６案,新竹市,東區,仙宮里,99,1233,419,279,698,19,717
公投第１６案,新竹市,東區,關帝里,100,507,135,113,248,19,267
公投第１６案,新竹市,東區,南門里,101,714,217,155,372,49,421
公投第１６案,新竹市,東區,南市里,102,875,252,194,446,66,512
公投第１６案,新竹市,東區,福德里,103,1396,442,288,730,63,793
公投第１６案,新竹市,東區,振興里,104,1232,347,262,609,54,663
公投第１６案,新竹市,東區,振興里,105,1323,400,279,679,44,723
公投第１６案,新竹市,東區,振興里,106,1516,225,443,668,40,708
公投第１６案,新竹市,東區,振興里,107,1453,421,281,702,46,748
公投第１６案,新竹市,東區,新興里,108,880,265,203,468,49,517
公投第１６案,新竹市,東區,新興里,109,1058,313,228,541,24,565
公投第１６案,新竹市,東區,新興里,110,1061,301,257,558,38,596
公投第１６案,新竹市,東區,寺前里,111,710,192,172,364,39,403
公投第１６案,新竹市,東區,竹蓮里,112,752,228,174,402,51,453
公投第１６案,新竹市,東區,下竹里,113,475,154,124,278,23,301
公投第１６案,新竹市,東區,頂竹里,114,880,234,205,439,30,469
公投第１６案,新竹市,東區,頂竹里,115,989,287,248,535,43,578
公投第１６案,新竹市,東區,頂竹里,116,1059,338,223,561,51,612
公投第１６案,新竹市,東區,南大里,117,607,174,156,330,40,370
公投第１６案,新竹市,東區,南大里,118,815,244,194,438,38,476
公投第１６案,新竹市,東區,新光里,119,777,249,155,404,77,481
公投第１６案,新竹市,東區,新光里,120,1399,394,234,628,51,679
公投第１６案,新竹市,東區,新光里,121,1216,371,266,637,44,681
公投第１６案,新竹市,東區,光鎮里,122,1062,299,215,514,43,557
公投第１６案,新竹市,東區,光鎮里,123,1046,350,219,569,36,605
公投第１６案,新竹市,東區,光鎮里,124,1332,421,240,661,29,690
公投第１６案,新竹市,東區,高峰里,125,1350,407,308,715,63,778
公投第１６案,新竹市,東區,高峰里,126,1438,430,270,700,35,735
公投第１６案,新竹市,東區,高峰里,127,1414,384,301,685,43,728
公投第１６案,新竹市,東區,高峰里,128,1476,460,343,803,37,840
公投第１６案,新竹市,東區,湖濱里,129,1326,451,304,755,63,818
公投第１６案,新竹市,東區,湖濱里,130,927,315,237,552,32,584
公投第１６案,新竹市,東區,湖濱里,131,1273,386,296,682,32,714
公投第１６案,新竹市,東區,柴橋里,132,1315,394,267,661,34,695
公投第１６案,新竹市,東區,柴橋里,133,1413,477,282,759,38,797
公投第１６案,新竹市,東區,柴橋里,134,1064,335,228,563,39,602
公投第１６案,新竹市,東區,柴橋里,135,1244,455,302,757,32,789
公投第１６案,新竹市,東區,明湖里,136,1160,348,229,577,6,583
公投第１６案,新竹市,東區,明湖里,137,1398,405,246,651,37,688
公投第１６案,新竹市,東區,明湖里,138,1384,332,208,540,27,567
公投第１６案,新竹市,東區,明湖里,139,874,337,186,523,44,567
公投第１６案,新竹市,北區,中央里,140,477,111,112,223,19,242
公投第１６案,新竹市,北區,西門里,141,535,173,121,294,29,323
公投第１６案,新竹市,北區,潛園里,142,746,207,173,380,64,444
公投第１６案,新竹市,北區,石坊里,143,546,149,114,263,25,288
公投第１６案,新竹市,北區,仁德里,144,711,212,179,391,52,443
公投第１６案,新竹市,北區,崇禮里,145,1143,306,234,540,42,582
公投第１６案,新竹市,北區,興南里,146,1370,405,272,677,47,724
公投第１６案,新竹市,北區,育英里,147,1390,392,317,709,51,760
公投第１６案,新竹市,北區,育英里,148,962,311,200,511,31,542
公投第１６案,新竹市,北區,育英里,149,1237,359,283,642,25,667
公投第１６案,新竹市,北區,台溪里,150,1604,405,302,707,87,794
公投第１６案,新竹市,北區,曲溪里,151,758,190,159,349,20,369
公投第１６案,新竹市,北區,曲溪里,152,1320,384,246,630,39,669
公投第１６案,新竹市,北區,曲溪里,153,1519,435,255,690,80,770
公投第１６案,新竹市,北區,曲溪里,154,347,73,52,125,7,132
公投第１６案,新竹市,北區,曲溪里,155,1212,375,294,669,42,711
公投第１６案,新竹市,北區,西雅里,156,1484,416,302,718,57,775
公投第１６案,新竹市,北區,西雅里,157,1428,401,300,701,76,777
公投第１６案,新竹市,北區,客雅里,158,1128,348,242,590,43,633
公投第１６案,新竹市,北區,客雅里,159,638,185,140,325,27,352
公投第１６案,新竹市,北區,中雅里,160,1222,418,234,652,55,707
公投第１６案,新竹市,北區,中雅里,161,1076,309,224,533,42,575
公投第１６案,新竹市,北區,中雅里,162,937,346,228,574,25,599
公投第１６案,新竹市,北區,南勢里,163,1394,404,288,692,62,754
公投第１６案,新竹市,北區,南勢里,164,1568,414,302,716,64,780
公投第１６案,新竹市,北區,南勢里,165,1159,371,301,672,34,706
公投第１６案,新竹市,北區,大鵬里,166,252,50,52,102,3,105
公投第１６案,新竹市,北區,大同里,167,761,272,184,456,20,476
公投第１６案,新竹市,北區,中山里,168,788,245,185,430,39,469
公投第１６案,新竹市,北區,中興里,169,561,181,132,313,42,355
公投第１６案,新竹市,北區,新民里,170,1558,444,294,738,88,826
公投第１６案,新竹市,北區,長和里,171,1398,372,273,645,38,683
公投第１６案,新竹市,北區,北門里,172,957,299,189,488,46,534
公投第１６案,新竹市,北區,民富里,173,1195,396,236,632,61,693
公投第１６案,新竹市,北區,民富里,174,1236,333,232,565,48,613
公投第１６案,新竹市,北區,民富里,175,1255,339,252,591,69,660
公投第１６案,新竹市,北區,民富里,176,1114,374,213,587,41,628
公投第１６案,新竹市,北區,磐石里,177,1396,435,293,728,16,744
公投第１６案,新竹市,北區,磐石里,178,1456,455,335,790,51,841
公投第１６案,新竹市,北區,磐石里,179,1374,435,281,716,32,748
公投第１６案,新竹市,北區,磐石里,180,1070,301,224,525,51,576
公投第１６案,新竹市,北區,新雅里,181,1142,346,225,571,70,641
公投第１６案,新竹市,北區,新雅里,182,1103,351,197,548,18,566
公投第１６案,新竹市,北區,新雅里,183,1190,361,238,599,80,679
公投第１６案,新竹市,北區,新雅里,184,1089,403,239,642,34,676
公投第１６案,新竹市,北區,文雅里,185,1272,328,238,566,30,596
公投第１６案,新竹市,北區,文雅里,186,1306,396,290,686,59,745
公投第１６案,新竹市,北區,文雅里,187,1328,410,251,661,60,721
公投第１６案,新竹市,北區,水田里,188,1457,439,281,720,41,761
公投第１６案,新竹市,北區,水田里,189,1492,481,296,777,55,832
公投第１６案,新竹市,北區,光田里,190,1160,415,239,654,45,699
公投第１６案,新竹市,北區,光田里,191,971,253,220,473,99,572
公投第１６案,新竹市,北區,光華里,192,1401,264,156,420,26,446
公投第１６案,新竹市,北區,光華里,193,1340,429,291,720,47,767
公投第１６案,新竹市,北區,光華里,194,1371,453,316,769,38,807
公投第１６案,新竹市,北區,金華里,195,1267,361,289,650,40,690
公投第１６案,新竹市,北區,金華里,196,1073,358,256,614,56,670
公投第１６案,新竹市,北區,金華里,197,1159,383,255,638,40,678
公投第１６案,新竹市,北區,金華里,198,1294,409,268,677,28,705
公投第１６案,新竹市,北區,湳雅里,199,1442,444,306,750,55,805
公投第１６案,新竹市,北區,湳雅里,200,1270,425,271,696,33,729
公投第１６案,新竹市,北區,金雅里,201,1179,414,275,689,53,742
公投第１６案,新竹市,北區,金雅里,202,949,334,214,548,52,600
公投第１６案,新竹市,北區,湳中里,203,1163,365,255,620,43,663
公投第１６案,新竹市,北區,湳中里,204,1334,421,277,698,34,732
公投第１６案,新竹市,北區,湳中里,205,1415,429,313,742,51,793
公投第１６案,新竹市,北區,湳中里,206,1305,433,322,755,36,791
公投第１６案,新竹市,北區,湳中里,207,1200,402,240,642,40,682
公投第１６案,新竹市,北區,舊社里,208,1106,334,264,598,26,624
公投第１６案,新竹市,北區,舊社里,209,1044,364,225,589,35,624
公投第１６案,新竹市,北區,舊社里,210,1061,335,244,579,50,629
公投第１６案,新竹市,北區,舊社里,211,1518,353,497,850,53,903
公投第１６案,新竹市,北區,舊社里,212,1220,385,319,704,54,758
公投第１６案,新竹市,北區,金竹里,213,1475,492,339,831,23,854
公投第１６案,新竹市,北區,金竹里,214,1373,413,275,688,61,749
公投第１６案,新竹市,北區,金竹里,215,1450,492,288,780,46,826
公投第１６案,新竹市,北區,金竹里,216,1423,515,266,781,48,829
公投第１６案,新竹市,北區,武陵里,217,1059,340,239,579,23,602
公投第１６案,新竹市,北區,武陵里,218,1130,419,206,625,60,685
公投第１６案,新竹市,北區,武陵里,219,1208,465,245,710,39,749
公投第１６案,新竹市,北區,武陵里,220,1226,490,216,706,56,762
公投第１６案,新竹市,北區,福林里,221,1175,367,258,625,40,665
公投第１６案,新竹市,北區,福林里,222,1371,475,265,740,32,772
公投第１６案,新竹市,北區,福林里,223,1306,411,243,654,58,712
公投第１６案,新竹市,北區,境福里,224,1340,397,275,672,31,703
公投第１６案,新竹市,北區,境福里,225,1111,346,264,610,75,685
公投第１６案,新竹市,北區,境福里,226,1197,412,295,707,55,762
公投第１６案,新竹市,北區,境福里,227,1008,324,207,531,45,576
公投第１６案,新竹市,北區,士林里,228,946,278,205,483,28,511
公投第１６案,新竹市,北區,士林里,229,705,220,164,384,38,422
公投第１６案,新竹市,北區,古賢里,230,848,216,194,410,95,505
公投第１６案,新竹市,北區,南寮里,231,1295,397,247,644,44,688
公投第１６案,新竹市,北區,南寮里,232,1467,362,335,697,49,746
公投第１６案,新竹市,北區,南寮里,233,1659,430,268,698,54,752
公投第１６案,新竹市,北區,南寮里,234,1297,363,256,619,60,679
公投第１６案,新竹市,北區,康樂里,235,1374,424,290,714,75,789
公投第１６案,新竹市,北區,康樂里,236,1457,457,309,766,75,841
公投第１６案,新竹市,北區,中寮里,237,1072,328,252,580,53,633
公投第１６案,新竹市,北區,中寮里,238,1350,387,271,658,70,728
公投第１６案,新竹市,北區,中寮里,239,971,334,228,562,43,605
公投第１６案,新竹市,北區,海濱里,240,1450,432,350,782,68,850
公投第１６案,新竹市,北區,海濱里,241,895,279,191,470,39,509
公投第１６案,新竹市,北區,海濱里,242,1378,442,274,716,38,754
公投第１６案,新竹市,北區,港北里,243,1609,428,329,757,83,840
公投第１６案,新竹市,北區,舊港里,244,594,180,122,302,43,345
公投第１６案,新竹市,香山區,頂埔里,245,1443,432,279,711,68,779
公投第１６案,新竹市,香山區,頂埔里,246,1241,361,278,639,46,685
公投第１６案,新竹市,香山區,頂埔里,247,1194,379,239,618,31,649
公投第１６案,新竹市,香山區,頂埔里,248,1081,330,254,584,15,599
公投第１６案,新竹市,香山區,頂福里,249,807,248,180,428,34,462
公投第１６案,新竹市,香山區,頂福里,250,1760,587,312,899,59,958
公投第１６案,新竹市,香山區,頂福里,251,1635,530,323,853,60,913
公投第１６案,新竹市,香山區,中埔里,252,1473,453,333,786,64,850
公投第１６案,新竹市,香山區,中埔里,253,1408,454,302,756,36,792
公投第１６案,新竹市,香山區,牛埔里,254,1318,381,213,594,28,622
公投第１６案,新竹市,香山區,牛埔里,255,1337,389,312,701,51,752
公投第１６案,新竹市,香山區,牛埔里,256,1862,557,335,892,49,941
公投第１６案,新竹市,香山區,埔前里,257,1067,307,265,572,21,593
公投第１６案,新竹市,香山區,埔前里,258,863,288,201,489,39,528
公投第１６案,新竹市,香山區,埔前里,259,1198,403,272,675,61,736
公投第１６案,新竹市,香山區,樹下里,260,1138,373,251,624,67,691
公投第１６案,新竹市,香山區,樹下里,261,957,320,233,553,69,622
公投第１６案,新竹市,香山區,浸水里,262,1348,427,253,680,91,771
公投第１６案,新竹市,香山區,浸水里,263,1023,367,240,607,73,680
公投第１６案,新竹市,香山區,虎林里,264,970,307,204,511,35,546
公投第１６案,新竹市,香山區,虎林里,265,1318,410,279,689,66,755
公投第１６案,新竹市,香山區,虎山里,266,1088,327,229,556,53,609
公投第１６案,新竹市,香山區,虎山里,267,903,239,160,399,30,429
公投第１６案,新竹市,香山區,虎山里,268,1012,284,253,537,50,587
公投第１６案,新竹市,香山區,虎山里,269,1014,294,229,523,51,574
公投第１６案,新竹市,香山區,虎山里,270,1238,385,287,672,31,703
公投第１６案,新竹市,香山區,港南里,271,1182,380,203,583,72,655
公投第１６案,新竹市,香山區,港南里,272,1331,482,269,751,99,850
公投第１６案,新竹市,香山區,東香里,273,976,350,246,596,33,629
公投第１６案,新竹市,香山區,東香里,274,834,257,161,418,35,453
公投第１６案,新竹市,香山區,東香里,275,919,305,183,488,42,530
公投第１６案,新竹市,香山區,東香里,276,1188,396,259,655,48,703
公投第１６案,新竹市,香山區,香村里,277,1086,322,244,566,61,627
公投第１６案,新竹市,香山區,香村里,278,1144,415,249,664,52,716
公投第１６案,新竹市,香山區,香村里,279,1112,374,108,482,64,546
公投第１６案,新竹市,香山區,香山里,280,1476,476,312,788,65,853
公投第１６案,新竹市,香山區,香山里,281,1291,408,256,664,52,716
公投第１６案,新竹市,香山區,香山里,282,1464,501,335,836,67,903
公投第１６案,新竹市,香山區,大庄里,283,1427,474,280,754,89,843
公投第１６案,新竹市,香山區,大庄里,284,1336,403,291,694,53,747
公投第１６案,新竹市,香山區,美山里,285,1131,275,233,508,48,556
公投第１６案,新竹市,香山區,朝山里,286,1070,365,198,563,87,650
公投第１６案,新竹市,香山區,朝山里,287,1006,312,235,547,72,619
公投第１６案,新竹市,香山區,海山里,288,1223,320,203,523,46,569
公投第１６案,新竹市,香山區,海山里,289,1119,340,238,578,34,612
公投第１６案,新竹市,香山區,鹽水里,290,1400,364,276,640,46,686
公投第１６案,新竹市,香山區,內湖里,291,1627,445,266,711,50,761
公投第１６案,新竹市,香山區,內湖里,292,1289,369,217,586,59,645
公投第１６案,新竹市,香山區,內湖里,293,1409,397,249,646,69,715
公投第１６案,新竹市,香山區,南港里,294,814,213,174,387,45,432
公投第１６案,新竹市,香山區,中隘里,295,719,210,141,351,49,400
公投第１６案,新竹市,香山區,中隘里,296,1065,299,180,479,26,505
公投第１６案,新竹市,香山區,南隘里,297,776,226,147,373,60,433
公投第１６案,新竹市,香山區,大湖里,298,890,271,190,461,51,512
公投第１６案,新竹市,香山區,茄苳里,299,896,251,161,412,30,442
公投第１６案,嘉義市,東區,短竹里,1,1025,310,235,545,37,582
公投第１６案,嘉義市,東區,短竹里,2,1276,393,266,659,19,678
公投第１６案,嘉義市,東區,蘭潭里,3,974,252,193,445,51,496
公投第１６案,嘉義市,東區,蘭潭里,4,1175,416,250,666,53,719
公投第１６案,嘉義市,東區,東川里,5,702,221,183,404,32,436
公投第１６案,嘉義市,東區,東川里,6,1092,342,211,553,31,584
公投第１６案,嘉義市,東區,鹿寮里,7,1023,245,189,434,31,465
公投第１６案,嘉義市,東區,盧厝里,8,1816,501,354,855,81,936
公投第１６案,嘉義市,東區,文雅里,9,1936,597,395,992,73,1065
公投第１６案,嘉義市,東區,文雅里,10,1698,541,366,907,38,945
公投第１６案,嘉義市,東區,王田里,11,1221,381,292,673,42,715
公投第１６案,嘉義市,東區,王田里,12,1113,328,251,579,33,612
公投第１６案,嘉義市,東區,長竹里,13,1452,437,328,765,63,828
公投第１６案,嘉義市,東區,長竹里,14,1395,455,353,808,46,854
公投第１６案,嘉義市,東區,後庄里,15,1453,451,216,667,51,718
公投第１６案,嘉義市,東區,後庄里,16,1094,335,200,535,37,572
公投第１６案,嘉義市,東區,後庄里,17,1420,464,286,750,47,797
公投第１６案,嘉義市,東區,新店里,18,1552,475,361,836,73,909
公投第１６案,嘉義市,東區,新店里,19,1558,474,348,822,64,886
公投第１６案,嘉義市,東區,新店里,20,1062,319,250,569,51,620
公投第１６案,嘉義市,東區,圳頭里,21,1199,356,236,592,63,655
公投第１６案,嘉義市,東區,圳頭里,22,1236,392,250,642,35,677
公投第１６案,嘉義市,東區,圳頭里,23,890,250,197,447,25,472
公投第１６案,嘉義市,東區,圳頭里,24,880,288,193,481,54,535
公投第１６案,嘉義市,東區,中山里,25,1189,346,271,617,18,635
公投第１６案,嘉義市,東區,中山里,26,669,205,165,370,23,393
公投第１６案,嘉義市,東區,太平里,27,1435,451,286,737,50,787
公投第１６案,嘉義市,東區,太平里,28,1349,458,318,776,45,821
公投第１６案,嘉義市,東區,太平里,29,1455,413,316,729,37,766
公投第１６案,嘉義市,東區,東興里,30,915,292,201,493,36,529
公投第１６案,嘉義市,東區,東興里,31,952,247,243,490,31,521
公投第１６案,嘉義市,東區,華南里,32,941,260,221,481,49,530
公投第１６案,嘉義市,東區,華南里,33,1080,288,231,519,41,560
公投第１６案,嘉義市,東區,中央里,34,1157,297,229,526,34,560
公投第１６案,嘉義市,東區,中央里,35,1053,311,270,581,28,609
公投第１６案,嘉義市,東區,朝陽里,36,967,261,183,444,31,475
公投第１６案,嘉義市,東區,朝陽里,37,1091,291,216,507,46,553
公投第１６案,嘉義市,東區,民族里,38,961,285,222,507,64,571
公投第１６案,嘉義市,東區,民族里,39,863,186,137,323,31,354
公投第１６案,嘉義市,東區,過溝里,40,1023,314,241,555,61,616
公投第１６案,嘉義市,東區,過溝里,41,1078,311,250,561,86,647
公投第１６案,嘉義市,東區,新開里,42,938,250,219,469,28,497
公投第１６案,嘉義市,東區,新開里,43,1049,307,226,533,39,572
公投第１６案,嘉義市,東區,宣信里,44,1360,359,267,626,78,704
公投第１６案,嘉義市,東區,興南里,45,1615,378,300,678,100,778
公投第１６案,嘉義市,東區,豐年里,46,1267,329,287,616,57,673
公投第１６案,嘉義市,東區,芳草里,47,1579,393,275,668,83,751
公投第１６案,嘉義市,東區,芳草里,48,1831,512,325,837,107,944
公投第１６案,嘉義市,東區,芳安里,49,977,319,207,526,34,560
公投第１６案,嘉義市,東區,芳安里,50,1169,301,261,562,42,604
公投第１６案,嘉義市,東區,頂寮里,51,1238,362,287,649,86,735
公投第１６案,嘉義市,東區,頂寮里,52,1266,360,296,656,32,688
公投第１６案,嘉義市,東區,安寮里,53,1429,365,257,622,55,677
公投第１６案,嘉義市,東區,安寮里,54,1288,377,294,671,35,706
公投第１６案,嘉義市,東區,安業里,55,980,296,198,494,48,542
公投第１６案,嘉義市,東區,安業里,56,922,269,178,447,28,475
公投第１６案,嘉義市,東區,興村里,57,1133,344,260,604,55,659
公投第１６案,嘉義市,東區,興村里,58,1235,398,239,637,64,701
公投第１６案,嘉義市,東區,興村里,59,1525,466,293,759,36,795
公投第１６案,嘉義市,東區,興安里,60,1170,326,221,547,58,605
公投第１６案,嘉義市,東區,興安里,61,1177,396,277,673,69,742
公投第１６案,嘉義市,東區,興仁里,62,1207,376,245,621,63,684
公投第１６案,嘉義市,東區,興仁里,63,1272,380,300,680,51,731
公投第１６案,嘉義市,東區,興仁里,64,1188,318,239,557,117,674
公投第１６案,嘉義市,東區,北門里,65,1172,331,213,544,36,580
公投第１６案,嘉義市,東區,北門里,66,1020,339,207,546,52,598
公投第１６案,嘉義市,東區,林森里,67,1332,402,301,703,64,767
公投第１６案,嘉義市,東區,林森里,68,1011,310,260,570,54,624
公投第１６案,嘉義市,東區,中庄里,69,1682,480,325,805,71,876
公投第１６案,嘉義市,東區,中庄里,70,1567,465,312,777,79,856
公投第１６案,嘉義市,東區,頂庄里,71,1207,366,251,617,30,647
公投第１６案,嘉義市,東區,頂庄里,72,981,312,223,535,34,569
公投第１６案,嘉義市,東區,義教里,73,1395,393,286,679,59,738
公投第１６案,嘉義市,東區,義教里,74,1434,376,261,637,26,663
公投第１６案,嘉義市,東區,仁義里,75,1404,342,245,587,35,622
公投第１６案,嘉義市,東區,仁義里,76,1428,438,294,732,55,787
公投第１６案,嘉義市,東區,後湖里,77,1823,427,297,724,35,759
公投第１６案,嘉義市,東區,後湖里,78,1570,398,317,715,49,764
公投第１６案,嘉義市,東區,荖藤里,79,1282,318,249,567,80,647
公投第１６案,嘉義市,東區,荖藤里,80,1571,550,313,863,62,925
公投第１６案,嘉義市,東區,荖藤里,81,1533,421,306,727,43,770
公投第１６案,嘉義市,西區,書院里,82,885,257,185,442,20,462
公投第１６案,嘉義市,西區,書院里,83,1109,313,228,541,62,603
公投第１６案,嘉義市,西區,永和里,84,1020,217,220,437,64,501
公投第１６案,嘉義市,西區,永和里,85,925,300,222,522,58,580
公投第１６案,嘉義市,西區,新富里,86,1671,353,325,678,52,730
公投第１６案,嘉義市,西區,文化里,87,1215,362,251,613,35,648
公投第１６案,嘉義市,西區,文化里,88,1036,282,226,508,28,536
公投第１６案,嘉義市,西區,西榮里,89,1129,300,233,533,28,561
公投第１６案,嘉義市,西區,西榮里,90,1127,309,242,551,34,585
公投第１６案,嘉義市,西區,番社里,91,1415,390,297,687,59,746
公投第１６案,嘉義市,西區,國華里,92,1366,406,248,654,29,683
公投第１６案,嘉義市,西區,大溪里,93,1053,324,255,579,63,642
公投第１６案,嘉義市,西區,大溪里,94,1067,328,210,538,30,568
公投第１６案,嘉義市,西區,磚磘里,95,1575,411,269,680,40,720
公投第１６案,嘉義市,西區,磚磘里,96,1865,532,379,911,59,970
公投第１６案,嘉義市,西區,福全里,97,1196,332,212,544,47,591
公投第１６案,嘉義市,西區,福全里,98,1280,352,266,618,37,655
公投第１６案,嘉義市,西區,福全里,99,1629,513,291,804,72,876
公投第１６案,嘉義市,西區,福安里,100,1393,438,278,716,93,809
公投第１６案,嘉義市,西區,福安里,101,1077,328,256,584,53,637
公投第１６案,嘉義市,西區,福安里,102,1694,474,289,763,38,801
公投第１６案,嘉義市,西區,新西里,103,841,227,209,436,89,525
公投第１６案,嘉義市,西區,新西里,104,1183,311,248,559,5,564
公投第１６案,嘉義市,西區,港坪里,105,1000,350,222,572,36,608
公投第１６案,嘉義市,西區,港坪里,106,1095,342,259,601,30,631
公投第１６案,嘉義市,西區,港坪里,107,1256,379,308,687,48,735
公投第１６案,嘉義市,西區,頭港里,108,962,295,210,505,55,560
公投第１６案,嘉義市,西區,頭港里,109,865,291,229,520,22,542
公投第１６案,嘉義市,西區,西平里,110,1396,412,275,687,64,751
公投第１６案,嘉義市,西區,西平里,111,1799,541,358,899,76,975
公投第１６案,嘉義市,西區,劉厝里,112,1505,417,276,693,37,730
公投第１６案,嘉義市,西區,劉厝里,113,1698,497,327,824,67,891
公投第１６案,嘉義市,西區,劉厝里,114,1854,560,363,923,39,962
公投第１６案,嘉義市,西區,劉厝里,115,1537,384,269,653,20,673
公投第１６案,嘉義市,西區,自強里,116,1604,419,317,736,93,829
公投第１６案,嘉義市,西區,美源里,117,944,307,206,513,83,596
公投第１６案,嘉義市,西區,美源里,118,1627,472,374,846,85,931
公投第１６案,嘉義市,西區,美源里,119,1144,359,260,619,58,677
公投第１６案,嘉義市,西區,湖內里,120,1362,399,274,673,67,740
公投第１６案,嘉義市,西區,湖內里,121,1279,392,294,686,44,730
公投第１６案,嘉義市,西區,湖內里,122,1702,500,337,837,109,946
公投第１６案,嘉義市,西區,獅子里,123,1358,403,336,739,62,801
公投第１６案,嘉義市,西區,獅子里,124,1360,400,311,711,119,830
公投第１６案,嘉義市,西區,紅瓦里,125,1589,536,313,849,61,910
公投第１６案,嘉義市,西區,光路里,126,1280,408,303,711,50,761
公投第１６案,嘉義市,西區,光路里,127,1220,316,243,559,32,591
公投第１６案,嘉義市,西區,光路里,128,1172,385,255,640,31,671
公投第１６案,嘉義市,西區,光路里,129,1320,398,268,666,66,732
公投第１６案,嘉義市,西區,福民里,130,1185,451,266,717,38,755
公投第１６案,嘉義市,西區,福民里,131,1278,407,315,722,53,775
公投第１６案,嘉義市,西區,福民里,132,1394,370,220,590,30,620
公投第１６案,嘉義市,西區,福民里,133,1540,488,320,808,63,871
公投第１６案,嘉義市,西區,車店里,134,1548,488,300,788,85,873
公投第１６案,嘉義市,西區,車店里,135,1295,367,288,655,37,692
公投第１６案,嘉義市,西區,車店里,136,1318,429,290,719,82,801
公投第１６案,嘉義市,西區,車店里,137,1545,456,330,786,66,852
公投第１６案,嘉義市,西區,垂楊里,138,736,177,147,324,29,353
公投第１６案,嘉義市,西區,垂楊里,139,1168,306,238,544,39,583
公投第１６案,嘉義市,西區,培元里,140,756,245,185,430,43,473
公投第１６案,嘉義市,西區,培元里,141,869,292,163,455,23,478
公投第１６案,嘉義市,西區,育英里,142,983,303,221,524,56,580
公投第１６案,嘉義市,西區,育英里,143,828,254,158,412,61,473
公投第１６案,嘉義市,西區,致遠里,144,1775,590,333,923,56,979
公投第１６案,嘉義市,西區,翠岱里,145,1419,448,269,717,48,765
公投第１６案,嘉義市,西區,導明里,146,779,199,171,370,20,390
公投第１６案,嘉義市,西區,導明里,147,855,211,190,401,17,418
公投第１６案,嘉義市,西區,北榮里,148,1146,348,236,584,89,673
公投第１６案,嘉義市,西區,北榮里,149,1111,353,238,591,34,625
公投第１６案,嘉義市,西區,慶安里,150,767,235,201,436,57,493
公投第１６案,嘉義市,西區,慶安里,151,817,220,134,354,33,387
公投第１６案,嘉義市,西區,香湖里,152,770,202,188,390,57,447
公投第１６案,嘉義市,西區,重興里,153,1135,265,212,477,19,496
公投第１６案,嘉義市,西區,重興里,154,835,204,165,369,86,455
公投第１６案,嘉義市,西區,後驛里,155,1182,292,221,513,50,563
公投第１６案,嘉義市,西區,後驛里,156,944,210,183,393,47,440
公投第１６案,嘉義市,西區,湖邊里,157,997,272,194,466,43,509
公投第１６案,嘉義市,西區,湖邊里,158,1074,299,233,532,33,565
公投第１６案,嘉義市,西區,竹圍里,159,1460,355,255,610,31,641
公投第１６案,嘉義市,西區,竹圍里,160,1352,420,230,650,36,686
公投第１６案,嘉義市,西區,竹圍里,161,1499,431,343,774,53,827
公投第１６案,嘉義市,西區,保生里,162,1262,393,241,634,68,702
公投第１６案,嘉義市,西區,保生里,163,1299,364,272,636,40,676
公投第１６案,嘉義市,西區,保生里,164,1734,466,330,796,71,867
公投第１６案,嘉義市,西區,保安里,165,1674,448,320,768,36,804
公投第１６案,嘉義市,西區,保安里,166,1540,432,310,742,47,789
公投第１６案,嘉義市,西區,北新里,167,1056,320,263,583,40,623
公投第１６案,嘉義市,西區,新厝里,168,1467,437,292,729,127,856
公投第１６案,嘉義市,西區,新厝里,169,1431,386,283,669,76,745
公投第１６案,嘉義市,西區,新厝里,170,1234,425,258,683,90,773
公投第１６案,嘉義市,西區,保福里,171,1266,361,266,627,27,654
公投第１６案,嘉義市,西區,保福里,172,1211,332,294,626,38,664
公投第１６案,嘉義市,西區,保福里,173,1121,359,247,606,29,635
公投第１６案,嘉義市,西區,竹村里,174,1155,315,210,525,28,553
公投第１６案,嘉義市,西區,北湖里,175,1546,438,377,815,90,905
公投第１６案,嘉義市,西區,北湖里,176,1322,411,218,629,28,657
公投第１６案,嘉義市,西區,下埤里,177,1549,536,317,853,96,949
公投第１６案,臺北市,北投區,建民里,1,1313,447,298,745,59,804
公投第１６案,臺北市,北投區,建民里,2,1403,441,384,825,48,873
公投第１６案,臺北市,北投區,建民里,3,1081,335,276,611,64,675
公投第１６案,臺北市,北投區,文林里,4,1209,251,424,675,52,727
公投第１６案,臺北市,北投區,文林里,5,1326,377,340,717,60,777
公投第１６案,臺北市,北投區,文林里,6,1263,386,326,712,55,767
公投第１６案,臺北市,北投區,石牌里,7,1580,509,375,884,73,957
公投第１６案,臺北市,北投區,石牌里,8,1577,486,382,868,65,933
公投第１６案,臺北市,北投區,石牌里,9,1483,506,311,817,72,889
公投第１６案,臺北市,北投區,福興里,10,1461,451,326,777,41,818
公投第１６案,臺北市,北投區,福興里,11,1466,416,342,758,80,838
公投第１６案,臺北市,北投區,福興里,12,1620,502,393,895,71,966
公投第１６案,臺北市,北投區,福興里,13,1543,463,307,770,42,812
公投第１６案,臺北市,北投區,榮光里,14,1513,424,314,738,78,816
公投第１６案,臺北市,北投區,榮光里,15,1534,497,325,822,56,878
公投第１６案,臺北市,北投區,榮光里,16,1650,541,367,908,80,988
公投第１６案,臺北市,北投區,榮光里,17,1533,490,340,830,50,880
公投第１６案,臺北市,北投區,榮華里,18,1702,513,362,875,66,941
公投第１６案,臺北市,北投區,榮華里,19,1721,541,378,919,62,981
公投第１６案,臺北市,北投區,榮華里,20,1575,503,396,899,60,959
公投第１６案,臺北市,北投區,榮華里,21,1530,481,345,826,74,900
公投第１６案,臺北市,北投區,裕民里,22,1728,529,425,954,17,971
公投第１６案,臺北市,北投區,裕民里,23,1702,514,393,907,70,977
公投第１６案,臺北市,北投區,裕民里,24,1696,501,382,883,81,964
公投第１６案,臺北市,北投區,裕民里,25,1684,467,281,748,46,794
公投第１６案,臺北市,北投區,振華里,26,1717,599,371,970,60,1030
公投第１６案,臺北市,北投區,振華里,27,1605,486,354,840,45,885
公投第１６案,臺北市,北投區,振華里,28,1723,539,380,919,71,990
公投第１６案,臺北市,北投區,振華里,29,1597,555,370,925,54,979
公投第１６案,臺北市,北投區,永和里,30,1700,563,368,931,42,973
公投第１６案,臺北市,北投區,永和里,31,1544,415,362,777,41,818
公投第１６案,臺北市,北投區,永和里,32,1635,453,358,811,66,877
公投第１６案,臺北市,北投區,永和里,33,1495,445,387,832,37,869
公投第１６案,臺北市,北投區,永和里,34,1619,510,389,899,42,941
公投第１６案,臺北市,北投區,永欣里,35,1683,493,401,894,57,951
公投第１６案,臺北市,北投區,永欣里,36,1662,480,325,805,85,890
公投第１６案,臺北市,北投區,永欣里,37,1850,514,358,872,39,911
公投第１６案,臺北市,北投區,永欣里,38,1674,455,368,823,33,856
公投第１６案,臺北市,北投區,永明里,39,1511,520,344,864,59,923
公投第１６案,臺北市,北投區,永明里,40,1393,385,346,731,32,763
公投第１６案,臺北市,北投區,永明里,41,1279,419,326,745,64,809
公投第１６案,臺北市,北投區,東華里,42,1122,377,212,589,48,637
公投第１６案,臺北市,北投區,東華里,43,1238,491,309,800,57,857
公投第１６案,臺北市,北投區,東華里,44,1477,480,369,849,73,922
公投第１６案,臺北市,北投區,吉利里,45,1495,487,355,842,73,915
公投第１６案,臺北市,北投區,吉利里,46,1469,511,353,864,59,923
公投第１６案,臺北市,北投區,吉利里,47,1462,508,291,799,60,859
公投第１６案,臺北市,北投區,吉利里,48,1431,464,307,771,82,853
公投第１６案,臺北市,北投區,吉慶里,49,1486,451,345,796,55,851
公投第１６案,臺北市,北投區,吉慶里,50,1449,459,351,810,72,882
公投第１６案,臺北市,北投區,吉慶里,51,1456,455,337,792,53,845
公投第１６案,臺北市,北投區,尊賢里,52,1311,402,304,706,40,746
公投第１６案,臺北市,北投區,尊賢里,53,1356,428,301,729,71,800
公投第１６案,臺北市,北投區,尊賢里,54,1338,442,314,756,40,796
公投第１６案,臺北市,北投區,立賢里,55,1525,476,343,819,41,860
公投第１６案,臺北市,北投區,立賢里,56,1620,458,363,821,63,884
公投第１６案,臺北市,北投區,立賢里,57,1499,412,329,741,49,790
公投第１６案,臺北市,北投區,立農里,58,1497,550,302,852,48,900
公投第１６案,臺北市,北投區,立農里,59,1624,506,342,848,71,919
公投第１６案,臺北市,北投區,立農里,60,1536,400,323,723,116,839
公投第１６案,臺北市,北投區,立農里,61,1469,475,343,818,87,905
公投第１６案,臺北市,北投區,立農里,62,1598,480,360,840,52,892
公投第１６案,臺北市,北投區,八仙里,63,1690,523,359,882,44,926
公投第１６案,臺北市,北投區,八仙里,64,1599,447,350,797,111,908
公投第１６案,臺北市,北投區,八仙里,65,1634,514,350,864,70,934
公投第１６案,臺北市,北投區,洲美里,66,1660,451,367,818,63,881
公投第１６案,臺北市,北投區,奇岩里,67,1900,544,388,932,70,1002
公投第１６案,臺北市,北投區,奇岩里,68,1797,550,419,969,71,1040
公投第１６案,臺北市,北投區,奇岩里,69,1832,544,437,981,80,1061
公投第１６案,臺北市,北投區,奇岩里,70,1784,553,416,969,79,1048
公投第１６案,臺北市,北投區,奇岩里,71,1732,545,398,943,70,1013
公投第１６案,臺北市,北投區,清江里,72,2035,288,209,497,62,559
公投第１６案,臺北市,北投區,清江里,73,1504,453,336,789,72,861
公投第１６案,臺北市,北投區,清江里,74,1683,549,353,902,86,988
公投第１６案,臺北市,北投區,清江里,75,1635,471,350,821,85,906
公投第１６案,臺北市,北投區,清江里,76,1613,487,236,723,87,810
公投第１６案,臺北市,北投區,中央里,77,1483,465,285,750,42,792
公投第１６案,臺北市,北投區,中央里,78,1500,435,348,783,60,843
公投第１６案,臺北市,北投區,中央里,79,1483,456,334,790,79,869
公投第１６案,臺北市,北投區,中央里,80,1544,466,329,795,78,873
公投第１６案,臺北市,北投區,中央里,81,1532,385,305,690,80,770
公投第１６案,臺北市,北投區,長安里,82,1819,650,288,938,89,1027
公投第１６案,臺北市,北投區,長安里,83,1863,479,395,874,89,963
公投第１６案,臺北市,北投區,長安里,84,1872,492,391,883,32,915
公投第１６案,臺北市,北投區,大同里,85,1627,466,365,831,67,898
公投第１６案,臺北市,北投區,大同里,86,1696,488,356,844,49,893
公投第１６案,臺北市,北投區,大同里,87,1841,558,401,959,72,1031
公投第１６案,臺北市,北投區,溫泉里,88,1324,384,295,679,74,753
公投第１６案,臺北市,北投區,溫泉里,89,1504,448,316,764,52,816
公投第１６案,臺北市,北投區,溫泉里,90,1511,460,323,783,72,855
公投第１６案,臺北市,北投區,溫泉里,91,1615,496,407,903,52,955
公投第１６案,臺北市,北投區,林泉里,92,1270,378,256,634,43,677
公投第１６案,臺北市,北投區,林泉里,93,1492,374,310,684,46,730
公投第１６案,臺北市,北投區,中心里,94,1429,413,311,724,41,765
公投第１６案,臺北市,北投區,中心里,95,1567,477,304,781,32,813
公投第１６案,臺北市,北投區,中心里,96,1388,441,280,721,59,780
公投第１６案,臺北市,北投區,中心里,97,1448,416,290,706,31,737
公投第１６案,臺北市,北投區,中庸里,98,1356,369,300,669,49,718
公投第１６案,臺北市,北投區,中庸里,99,1308,403,271,674,61,735
公投第１６案,臺北市,北投區,中庸里,100,1165,358,275,633,68,701
公投第１６案,臺北市,北投區,開明里,101,1429,460,301,761,102,863
公投第１６案,臺北市,北投區,開明里,102,1472,459,284,743,44,787
公投第１６案,臺北市,北投區,開明里,103,1508,510,374,884,66,950
公投第１６案,臺北市,北投區,開明里,104,1480,441,337,778,69,847
公投第１６案,臺北市,北投區,中和里,105,1142,315,257,572,58,630
公投第１６案,臺北市,北投區,中和里,106,1554,480,297,777,45,822
公投第１６案,臺北市,北投區,中和里,107,1669,524,383,907,92,999
公投第１６案,臺北市,北投區,智仁里,108,1823,543,405,948,80,1028
公投第１６案,臺北市,北投區,智仁里,109,1739,543,314,857,92,949
公投第１６案,臺北市,北投區,智仁里,110,1771,540,333,873,78,951
公投第１６案,臺北市,北投區,秀山里,111,1468,412,296,708,64,772
公投第１６案,臺北市,北投區,秀山里,112,1469,466,282,748,59,807
公投第１６案,臺北市,北投區,文化里,113,1094,426,249,675,34,709
公投第１６案,臺北市,北投區,文化里,114,1101,429,231,660,46,706
公投第１６案,臺北市,北投區,文化里,115,1422,490,303,793,73,866
公投第１６案,臺北市,北投區,豐年里,116,1390,429,275,704,74,778
公投第１６案,臺北市,北投區,豐年里,117,1307,406,304,710,71,781
公投第１６案,臺北市,北投區,豐年里,118,1215,394,305,699,73,772
公投第１６案,臺北市,北投區,稻香里,119,1642,473,329,802,67,869
公投第１６案,臺北市,北投區,稻香里,120,1623,454,329,783,48,831
公投第１６案,臺北市,北投區,稻香里,121,1621,504,326,830,67,897
公投第１６案,臺北市,北投區,桃源里,122,1367,401,313,714,26,740
公投第１６案,臺北市,北投區,桃源里,123,1309,345,307,652,70,722
公投第１６案,臺北市,北投區,桃源里,124,1356,423,309,732,44,776
公投第１６案,臺北市,北投區,桃源里,125,1365,415,290,705,53,758
公投第１６案,臺北市,北投區,一德里,126,1613,448,365,813,54,867
公投第１６案,臺北市,北投區,一德里,127,1590,415,294,709,52,761
公投第１６案,臺北市,北投區,一德里,128,1662,505,376,881,88,969
公投第１６案,臺北市,北投區,一德里,129,1622,494,381,875,59,934
公投第１６案,臺北市,北投區,關渡里,130,1820,502,439,941,45,986
公投第１６案,臺北市,北投區,關渡里,131,1615,513,352,865,79,944
公投第１６案,臺北市,北投區,關渡里,132,1612,391,287,678,75,753
公投第１６案,臺北市,北投區,關渡里,133,1652,481,336,817,96,913
公投第１６案,臺北市,北投區,關渡里,134,1666,494,376,870,47,917
公投第１６案,臺北市,北投區,關渡里,135,1641,462,361,823,63,886
公投第１６案,臺北市,北投區,泉源里,136,528,156,129,285,34,319
公投第１６案,臺北市,北投區,泉源里,137,1642,366,334,700,84,784
公投第１６案,臺北市,北投區,湖山里,138,829,250,168,418,52,470
公投第１６案,臺北市,北投區,湖山里,139,690,226,111,337,46,383
公投第１６案,臺北市,北投區,大屯里,140,1067,295,225,520,63,583
公投第１６案,臺北市,北投區,湖田里,141,892,233,176,409,98,507
公投第１６案,臺北市,士林區,仁勇里,142,1695,480,381,861,89,950
公投第１６案,臺北市,士林區,仁勇里,143,1720,498,404,902,112,1014
公投第１６案,臺北市,士林區,義信里,144,1288,385,264,649,95,744
公投第１６案,臺北市,士林區,義信里,145,1546,459,336,795,71,866
公投第１６案,臺北市,士林區,福林里,146,652,222,157,379,34,413
公投第１６案,臺北市,士林區,福林里,147,870,253,186,439,45,484
公投第１６案,臺北市,士林區,福林里,148,1137,347,308,655,56,711
公投第１６案,臺北市,士林區,福德里,149,1050,356,252,608,62,670
公投第１６案,臺北市,士林區,福德里,150,1031,324,250,574,68,642
公投第１６案,臺北市,士林區,福德里,151,1075,340,272,612,32,644
公投第１６案,臺北市,士林區,福德里,152,2175,265,205,470,52,522
公投第１６案,臺北市,士林區,福志里,153,1775,553,336,889,56,945
公投第１６案,臺北市,士林區,福志里,154,1669,578,339,917,67,984
公投第１６案,臺北市,士林區,福志里,155,1665,514,412,926,89,1015
公投第１６案,臺北市,士林區,福志里,156,1648,551,390,941,83,1024
公投第１６案,臺北市,士林區,舊佳里,157,1246,403,287,690,36,726
公投第１６案,臺北市,士林區,舊佳里,158,1419,368,377,745,71,816
公投第１６案,臺北市,士林區,舊佳里,159,1327,361,334,695,84,779
公投第１６案,臺北市,士林區,舊佳里,160,1573,450,411,861,78,939
公投第１６案,臺北市,士林區,福佳里,161,1470,454,324,778,95,873
公投第１６案,臺北市,士林區,福佳里,162,1775,536,411,947,51,998
公投第１６案,臺北市,士林區,福佳里,163,1692,537,424,961,62,1023
公投第１６案,臺北市,士林區,福佳里,164,1842,573,429,1002,67,1069
公投第１６案,臺北市,士林區,後港里,165,1166,370,280,650,63,713
公投第１６案,臺北市,士林區,後港里,166,1687,438,353,791,95,886
公投第１６案,臺北市,士林區,後港里,167,1624,506,354,860,72,932
公投第１６案,臺北市,士林區,後港里,168,1477,450,364,814,108,922
公投第１６案,臺北市,士林區,後港里,169,1250,380,311,691,71,762
公投第１６案,臺北市,士林區,福中里,170,1434,410,336,746,110,856
公投第１６案,臺北市,士林區,福中里,171,1452,445,321,766,51,817
公投第１６案,臺北市,士林區,福中里,172,1533,519,371,890,74,964
公投第１６案,臺北市,士林區,福中里,173,1515,483,352,835,93,928
公投第１６案,臺北市,士林區,前港里,174,1203,369,290,659,70,729
公投第１６案,臺北市,士林區,前港里,175,1487,463,377,840,88,928
公投第１６案,臺北市,士林區,前港里,176,1252,381,283,664,49,713
公投第１６案,臺北市,士林區,百齡里,177,1536,480,332,812,61,873
公投第１６案,臺北市,士林區,百齡里,178,1556,471,418,889,63,952
公投第１６案,臺北市,士林區,百齡里,179,1511,463,354,817,76,893
公投第１６案,臺北市,士林區,百齡里,180,1572,516,394,910,83,993
公投第１６案,臺北市,士林區,承德里,181,1668,471,364,835,84,919
公投第１６案,臺北市,士林區,承德里,182,1685,484,366,850,123,973
公投第１６案,臺北市,士林區,承德里,183,1568,490,336,826,79,905
公投第１６案,臺北市,士林區,福華里,184,1327,364,310,674,59,733
公投第１６案,臺北市,士林區,福華里,185,1338,388,285,673,74,747
公投第１６案,臺北市,士林區,福華里,186,1515,403,324,727,77,804
公投第１６案,臺北市,士林區,福華里,187,1452,430,360,790,76,866
公投第１６案,臺北市,士林區,明勝里,188,1448,461,309,770,72,842
公投第１６案,臺北市,士林區,明勝里,189,1521,482,345,827,72,899
公投第１６案,臺北市,士林區,明勝里,190,1461,442,336,778,59,837
公投第１６案,臺北市,士林區,福順里,191,1541,401,345,746,87,833
公投第１６案,臺北市,士林區,福順里,192,1611,369,322,691,61,752
公投第１６案,臺北市,士林區,福順里,193,1595,432,391,823,78,901
公投第１６案,臺北市,士林區,富光里,194,1685,473,343,816,57,873
公投第１６案,臺北市,士林區,富光里,195,1816,517,378,895,85,980
公投第１６案,臺北市,士林區,富光里,196,1687,473,375,848,110,958
公投第１６案,臺北市,士林區,葫蘆里,197,1646,469,369,838,93,931
公投第１６案,臺北市,士林區,葫蘆里,198,1643,479,335,814,71,885
公投第１６案,臺北市,士林區,葫蘆里,199,1687,494,424,918,61,979
公投第１６案,臺北市,士林區,葫蘆里,200,1655,483,398,881,92,973
公投第１６案,臺北市,士林區,葫東里,201,1779,490,384,874,44,918
公投第１６案,臺北市,士林區,葫東里,202,1855,578,439,1017,67,1084
公投第１６案,臺北市,士林區,社子里,203,1350,400,312,712,74,786
公投第１６案,臺北市,士林區,社子里,204,1455,403,293,696,51,747
公投第１６案,臺北市,士林區,社子里,205,1497,357,296,653,68,721
公投第１６案,臺北市,士林區,社子里,206,1398,318,292,610,64,674
公投第１６案,臺北市,士林區,社新里,207,1747,544,398,942,83,1025
公投第１６案,臺北市,士林區,社新里,208,1465,409,298,707,113,820
公投第１６案,臺北市,士林區,社新里,209,1530,407,376,783,85,868
公投第１６案,臺北市,士林區,社新里,210,1855,474,408,882,91,973
公投第１６案,臺北市,士林區,社新里,211,1444,394,353,747,85,832
公投第１６案,臺北市,士林區,社園里,212,1563,400,350,750,80,830
公投第１６案,臺北市,士林區,社園里,213,1482,388,372,760,99,859
公投第１６案,臺北市,士林區,社園里,214,1552,397,348,745,120,865
公投第１６案,臺北市,士林區,社園里,215,1790,544,369,913,98,1011
公投第１６案,臺北市,士林區,永倫里,216,1628,328,421,749,108,857
公投第１６案,臺北市,士林區,永倫里,217,1337,361,290,651,96,747
公投第１６案,臺北市,士林區,永倫里,218,1750,496,382,878,115,993
公投第１６案,臺北市,士林區,永倫里,219,1668,438,337,775,115,890
公投第１６案,臺北市,士林區,福安里,220,1403,310,272,582,86,668
公投第１６案,臺北市,士林區,福安里,221,1468,320,314,634,67,701
公投第１６案,臺北市,士林區,福安里,222,1471,363,302,665,47,712
公投第１６案,臺北市,士林區,富洲里,223,1666,444,327,771,105,876
公投第１６案,臺北市,士林區,富洲里,224,1587,376,373,749,78,827
公投第１６案,臺北市,士林區,富洲里,225,1987,490,375,865,88,953
公投第１６案,臺北市,士林區,岩山里,226,1271,359,249,608,41,649
公投第１６案,臺北市,士林區,岩山里,227,1728,597,354,951,88,1039
公投第１６案,臺北市,士林區,名山里,228,1630,511,378,889,91,980
公投第１６案,臺北市,士林區,名山里,229,1619,505,393,898,74,972
公投第１６案,臺北市,士林區,名山里,230,1425,479,316,795,49,844
公投第１６案,臺北市,士林區,名山里,231,1623,537,389,926,74,1000
公投第１６案,臺北市,士林區,聖山里,232,1564,493,358,851,77,928
公投第１６案,臺北市,士林區,聖山里,233,1376,598,237,835,51,886
公投第１６案,臺北市,士林區,聖山里,234,1517,568,327,895,49,944
公投第１６案,臺北市,士林區,芝山里,235,1729,484,372,856,65,921
公投第１６案,臺北市,士林區,芝山里,236,1511,489,382,871,53,924
公投第１６案,臺北市,士林區,芝山里,237,1811,583,420,1003,62,1065
公投第１６案,臺北市,士林區,芝山里,238,1533,480,375,855,45,900
公投第１６案,臺北市,士林區,東山里,239,1657,590,421,1011,66,1077
公投第１６案,臺北市,士林區,東山里,240,1499,491,322,813,48,861
公投第１６案,臺北市,士林區,東山里,241,1402,435,294,729,81,810
公投第１６案,臺北市,士林區,德行里,242,1273,395,370,765,67,832
公投第１６案,臺北市,士林區,德行里,243,1273,418,300,718,47,765
公投第１６案,臺北市,士林區,德行里,244,1316,405,321,726,61,787
公投第１６案,臺北市,士林區,德華里,245,1659,485,409,894,64,958
公投第１６案,臺北市,士林區,德華里,246,1749,532,379,911,57,968
公投第１６案,臺北市,士林區,德華里,247,1552,471,333,804,82,886
公投第１６案,臺北市,士林區,忠誠里,248,1529,529,321,850,60,910
公投第１６案,臺北市,士林區,忠誠里,249,1644,570,30,600,55,655
公投第１６案,臺北市,士林區,忠誠里,250,1779,531,410,941,70,1011
公投第１６案,臺北市,士林區,蘭雅里,251,1597,476,378,854,62,916
公投第１６案,臺北市,士林區,蘭雅里,252,1454,440,325,765,80,845
公投第１６案,臺北市,士林區,蘭雅里,253,1582,516,400,916,57,973
公投第１６案,臺北市,士林區,蘭雅里,254,1518,476,355,831,71,902
公投第１６案,臺北市,士林區,蘭雅里,255,1501,412,337,749,29,778
公投第１６案,臺北市,士林區,蘭興里,256,1420,475,320,795,63,858
公投第１６案,臺北市,士林區,蘭興里,257,1494,477,340,817,66,883
公投第１６案,臺北市,士林區,蘭興里,258,1568,500,393,893,71,964
公投第１６案,臺北市,士林區,蘭興里,259,1208,382,330,712,56,768
公投第１６案,臺北市,士林區,三玉里,260,1826,552,394,946,86,1032
公投第１６案,臺北市,士林區,三玉里,261,1647,496,381,877,62,939
公投第１６案,臺北市,士林區,三玉里,262,1654,498,379,877,71,948
公投第１６案,臺北市,士林區,天福里,263,1550,511,360,871,60,931
公投第１６案,臺北市,士林區,天福里,264,1298,407,357,764,57,821
公投第１６案,臺北市,士林區,天福里,265,1297,383,330,713,88,801
公投第１６案,臺北市,士林區,天福里,266,1352,401,311,712,51,763
公投第１６案,臺北市,士林區,天祿里,267,1522,479,333,812,67,879
公投第１６案,臺北市,士林區,天祿里,268,1602,436,390,826,90,916
公投第１６案,臺北市,士林區,天祿里,269,1441,415,343,758,74,832
公投第１６案,臺北市,士林區,天壽里,270,1325,375,287,662,34,696
公投第１６案,臺北市,士林區,天壽里,271,1567,498,342,840,60,900
公投第１６案,臺北市,士林區,天壽里,272,1518,444,386,830,49,879
公投第１６案,臺北市,士林區,天和里,273,1549,532,353,885,61,946
公投第１６案,臺北市,士林區,天和里,274,1652,523,365,888,43,931
公投第１６案,臺北市,士林區,天和里,275,1766,589,395,984,72,1056
公投第１６案,臺北市,士林區,天和里,276,1638,490,360,850,53,903
公投第１６案,臺北市,士林區,天山里,277,1491,513,325,838,64,902
公投第１６案,臺北市,士林區,天山里,278,1521,483,357,840,47,887
公投第１６案,臺北市,士林區,天山里,279,1351,459,313,772,53,825
公投第１６案,臺北市,士林區,天山里,280,1742,536,351,887,35,922
公投第１６案,臺北市,士林區,天玉里,281,1585,486,379,865,53,918
公投第１６案,臺北市,士林區,天玉里,282,1521,499,337,836,57,893
公投第１６案,臺北市,士林區,天玉里,283,1543,455,372,827,35,862
公投第１６案,臺北市,士林區,天玉里,284,1404,477,313,790,41,831
公投第１６案,臺北市,士林區,天玉里,285,1541,347,513,860,33,893
公投第１６案,臺北市,士林區,天母里,286,1584,464,346,810,68,878
公投第１６案,臺北市,士林區,天母里,287,1519,460,383,843,67,910
公投第１６案,臺北市,士林區,天母里,288,1482,435,303,738,36,774
公投第１６案,臺北市,士林區,天母里,289,1243,366,293,659,50,709
公投第１６案,臺北市,士林區,永福里,290,1156,332,265,597,71,668
公投第１６案,臺北市,士林區,公館里,291,1262,338,252,590,110,700
公投第１６案,臺北市,士林區,新安里,292,889,274,201,475,58,533
公投第１６案,臺北市,士林區,新安里,293,858,245,225,470,66,536
公投第１６案,臺北市,士林區,陽明里,294,945,219,238,457,82,539
公投第１６案,臺北市,士林區,陽明里,295,960,279,192,471,63,534
公投第１６案,臺北市,士林區,陽明里,296,876,250,189,439,56,495
公投第１６案,臺北市,士林區,菁山里,297,556,169,146,315,47,362
公投第１６案,臺北市,士林區,菁山里,298,919,397,194,591,79,670
公投第１６案,臺北市,士林區,平等里,299,1360,440,350,790,109,899
公投第１６案,臺北市,士林區,溪山里,300,1355,391,343,734,97,831
公投第１６案,臺北市,士林區,翠山里,301,1252,416,278,694,50,744
公投第１６案,臺北市,士林區,翠山里,302,1182,401,285,686,46,732
公投第１６案,臺北市,士林區,臨溪里,303,1431,401,269,670,23,693
公投第１６案,臺北市,士林區,臨溪里,304,1240,357,271,628,46,674
公投第１６案,臺北市,內湖區,西湖里,305,1661,466,333,799,50,849
公投第１６案,臺北市,內湖區,西湖里,306,1602,459,350,809,83,892
公投第１６案,臺北市,內湖區,西湖里,307,1655,515,411,926,99,1025
公投第１６案,臺北市,內湖區,西湖里,308,1582,532,368,900,58,958
公投第１６案,臺北市,內湖區,西康里,309,1688,527,348,875,46,921
公投第１６案,臺北市,內湖區,西康里,310,1737,573,359,932,62,994
公投第１６案,臺北市,內湖區,西康里,311,1809,609,380,989,76,1065
公投第１６案,臺北市,內湖區,西康里,312,1376,454,273,727,57,784
公投第１６案,臺北市,內湖區,西康里,313,1747,592,328,920,140,1060
公投第１６案,臺北市,內湖區,西安里,314,1389,546,362,908,39,947
公投第１６案,臺北市,內湖區,西安里,315,1454,485,364,849,54,903
公投第１６案,臺北市,內湖區,西安里,316,1468,508,387,895,47,942
公投第１６案,臺北市,內湖區,西安里,317,1603,578,386,964,48,1012
公投第１６案,臺北市,內湖區,港墘里,318,1795,575,381,956,37,993
公投第１６案,臺北市,內湖區,港墘里,319,1737,597,414,1011,72,1083
公投第１６案,臺北市,內湖區,港墘里,320,1744,589,376,965,83,1048
公投第１６案,臺北市,內湖區,港都里,321,1661,567,343,910,77,987
公投第１６案,臺北市,內湖區,港都里,322,1577,488,369,857,60,917
公投第１６案,臺北市,內湖區,港都里,323,1494,450,410,860,43,903
公投第１６案,臺北市,內湖區,港富里,324,1626,511,385,896,65,961
公投第１６案,臺北市,內湖區,港富里,325,1641,543,347,890,83,973
公投第１６案,臺北市,內湖區,港富里,326,1554,513,327,840,65,905
公投第１６案,臺北市,內湖區,港富里,327,1728,556,415,971,84,1055
公投第１６案,臺北市,內湖區,港富里,328,1736,574,351,925,64,989
公投第１６案,臺北市,內湖區,港華里,329,1461,542,343,885,52,937
公投第１６案,臺北市,內湖區,港華里,330,1509,594,248,842,45,887
公投第１６案,臺北市,內湖區,港華里,331,1358,442,293,735,51,786
公投第１６案,臺北市,內湖區,港華里,332,1761,558,366,924,63,987
公投第１６案,臺北市,內湖區,港華里,333,1651,558,358,916,39,955
公投第１６案,臺北市,內湖區,內湖里,334,1809,601,403,1004,79,1083
公投第１６案,臺北市,內湖區,內湖里,335,1773,607,361,968,70,1038
公投第１６案,臺北市,內湖區,內湖里,336,1890,627,376,1003,50,1053
公投第１６案,臺北市,內湖區,湖濱里,337,1760,634,426,1060,75,1135
公投第１６案,臺北市,內湖區,湖濱里,338,1645,584,349,933,43,976
公投第１６案,臺北市,內湖區,湖濱里,339,1324,368,318,686,37,723
公投第１６案,臺北市,內湖區,湖濱里,340,1072,376,243,619,44,663
公投第１６案,臺北市,內湖區,湖濱里,341,1509,512,313,825,37,862
公投第１６案,臺北市,內湖區,紫星里,342,1715,518,402,920,73,993
公投第１６案,臺北市,內湖區,紫星里,343,1774,551,433,984,57,1041
公投第１６案,臺北市,內湖區,紫星里,344,1796,651,410,1061,65,1126
公投第１６案,臺北市,內湖區,紫星里,345,1784,570,387,957,52,1009
公投第１６案,臺北市,內湖區,大湖里,346,1417,445,381,826,58,884
公投第１６案,臺北市,內湖區,大湖里,347,1699,526,411,937,38,975
公投第１６案,臺北市,內湖區,大湖里,348,1719,529,490,1019,62,1081
公投第１６案,臺北市,內湖區,金龍里,349,1715,557,392,949,47,996
公投第１６案,臺北市,內湖區,金龍里,350,1634,489,314,803,47,850
公投第１６案,臺北市,內湖區,金龍里,351,1435,414,328,742,70,812
公投第１６案,臺北市,內湖區,金瑞里,352,1440,426,332,758,51,809
公投第１６案,臺北市,內湖區,金瑞里,353,1446,510,345,855,38,893
公投第１６案,臺北市,內湖區,金瑞里,354,1657,451,328,779,74,853
公投第１６案,臺北市,內湖區,金瑞里,355,1261,393,306,699,78,777
公投第１６案,臺北市,內湖區,碧山里,356,456,91,102,193,45,238
公投第１６案,臺北市,內湖區,碧山里,357,1433,568,329,897,45,942
公投第１６案,臺北市,內湖區,碧山里,358,1485,472,375,847,46,893
公投第１６案,臺北市,內湖區,碧山里,359,1590,488,372,860,57,917
公投第１６案,臺北市,內湖區,碧山里,360,1219,415,303,718,68,786
公投第１６案,臺北市,內湖區,紫雲里,361,1732,538,354,892,78,970
公投第１６案,臺北市,內湖區,紫雲里,362,1727,568,401,969,37,1006
公投第１６案,臺北市,內湖區,紫雲里,363,1637,508,386,894,68,962
公投第１６案,臺北市,內湖區,清白里,364,1453,482,312,794,42,836
公投第１６案,臺北市,內湖區,清白里,365,1617,512,341,853,52,905
公投第１６案,臺北市,內湖區,清白里,366,1604,523,334,857,50,907
公投第１６案,臺北市,內湖區,清白里,367,1406,495,366,861,38,899
公投第１６案,臺北市,內湖區,清白里,368,1353,452,312,764,47,811
公投第１６案,臺北市,內湖區,葫洲里,369,1724,623,365,988,65,1053
公投第１６案,臺北市,內湖區,葫洲里,370,1378,485,300,785,52,837
公投第１６案,臺北市,內湖區,葫洲里,371,1403,491,322,813,45,858
公投第１６案,臺北市,內湖區,葫洲里,372,1547,500,327,827,48,875
公投第１６案,臺北市,內湖區,紫陽里,373,1718,579,375,954,68,1022
公投第１６案,臺北市,內湖區,紫陽里,374,1813,581,395,976,66,1042
公投第１６案,臺北市,內湖區,紫陽里,375,1791,614,425,1039,83,1122
公投第１６案,臺北市,內湖區,紫陽里,376,1855,641,430,1071,61,1132
公投第１６案,臺北市,內湖區,瑞陽里,377,1731,599,368,967,40,1007
公投第１６案,臺北市,內湖區,瑞陽里,378,1593,551,418,969,61,1030
公投第１６案,臺北市,內湖區,瑞陽里,379,1869,590,365,955,58,1013
公投第１６案,臺北市,內湖區,瑞陽里,380,1687,561,394,955,62,1017
公投第１６案,臺北市,內湖區,瑞光里,381,1530,538,327,865,39,904
公投第１６案,臺北市,內湖區,瑞光里,382,1300,461,278,739,63,802
公投第１６案,臺北市,內湖區,瑞光里,383,1314,471,319,790,56,846
公投第１６案,臺北市,內湖區,五分里,384,1433,383,309,692,46,738
公投第１６案,臺北市,內湖區,五分里,385,1450,437,315,752,42,794
公投第１６案,臺北市,內湖區,五分里,386,1608,528,325,853,69,922
公投第１６案,臺北市,內湖區,五分里,387,1414,429,346,775,63,838
公投第１６案,臺北市,內湖區,五分里,388,1492,493,319,812,57,869
公投第１６案,臺北市,內湖區,五分里,389,1528,416,350,766,39,805
公投第１６案,臺北市,內湖區,東湖里,390,1692,540,390,930,56,986
公投第１６案,臺北市,內湖區,東湖里,391,1556,464,397,861,60,921
公投第１６案,臺北市,內湖區,東湖里,392,1637,477,361,838,55,893
公投第１６案,臺北市,內湖區,東湖里,393,1749,533,387,920,43,963
公投第１６案,臺北市,內湖區,樂康里,394,1220,365,267,632,48,680
公投第１６案,臺北市,內湖區,樂康里,395,1600,503,343,846,80,926
公投第１６案,臺北市,內湖區,樂康里,396,1473,469,320,789,65,854
公投第１６案,臺北市,內湖區,樂康里,397,1498,469,320,789,70,859
公投第１６案,臺北市,內湖區,樂康里,398,1557,504,339,843,52,895
公投第１６案,臺北市,內湖區,內溝里,399,1674,518,339,857,46,903
公投第１６案,臺北市,內湖區,內溝里,400,1728,565,414,979,65,1044
公投第１６案,臺北市,內湖區,內溝里,401,788,171,154,325,76,401
公投第１６案,臺北市,內湖區,週美里,402,1542,443,330,773,87,860
公投第１６案,臺北市,內湖區,週美里,403,1676,417,355,772,65,837
公投第１６案,臺北市,內湖區,週美里,404,1360,358,307,665,42,707
公投第１６案,臺北市,內湖區,週美里,405,1259,462,291,753,37,790
公投第１６案,臺北市,內湖區,週美里,406,1301,428,265,693,23,716
公投第１６案,臺北市,內湖區,行善里,407,1251,323,272,595,47,642
公投第１６案,臺北市,內湖區,行善里,408,1502,484,294,778,76,854
公投第１６案,臺北市,內湖區,行善里,409,1596,518,334,852,47,899
公投第１６案,臺北市,內湖區,行善里,410,1649,518,391,909,36,945
公投第１６案,臺北市,內湖區,石潭里,411,1774,559,342,901,78,979
公投第１６案,臺北市,內湖區,石潭里,412,1746,544,339,883,51,934
公投第１６案,臺北市,內湖區,湖興里,413,1473,474,302,776,34,810
公投第１６案,臺北市,內湖區,湖興里,414,2824,533,366,899,76,975
公投第１６案,臺北市,內湖區,湖興里,415,1849,490,407,897,60,957
公投第１６案,臺北市,內湖區,湖興里,416,1530,477,297,774,79,853
公投第１６案,臺北市,內湖區,湖元里,417,1656,485,402,887,60,947
公投第１６案,臺北市,內湖區,湖元里,418,1457,465,343,808,49,857
公投第１６案,臺北市,內湖區,湖元里,419,1695,578,382,960,59,1019
公投第１６案,臺北市,內湖區,安湖里,420,1663,565,368,933,58,991
公投第１６案,臺北市,內湖區,安湖里,421,1654,506,382,888,60,948
公投第１６案,臺北市,內湖區,安湖里,422,1642,569,350,919,67,986
公投第１６案,臺北市,內湖區,安湖里,423,1685,557,355,912,45,957
公投第１６案,臺北市,內湖區,秀湖里,424,1862,566,408,974,72,1046
公投第１６案,臺北市,內湖區,秀湖里,425,1900,648,435,1083,57,1140
公投第１６案,臺北市,內湖區,秀湖里,426,1790,677,398,1075,64,1139
公投第１６案,臺北市,內湖區,安泰里,427,1417,423,313,736,76,812
公投第１６案,臺北市,內湖區,安泰里,428,1694,520,385,905,66,971
公投第１６案,臺北市,內湖區,安泰里,429,1676,500,400,900,88,988
公投第１６案,臺北市,內湖區,金湖里,430,1643,528,366,894,33,927
公投第１６案,臺北市,內湖區,金湖里,431,1588,548,332,880,57,937
公投第１６案,臺北市,內湖區,金湖里,432,1603,539,364,903,60,963
公投第１６案,臺北市,內湖區,金湖里,433,1629,545,333,878,78,956
公投第１６案,臺北市,內湖區,金湖里,434,1646,597,365,962,53,1015
公投第１６案,臺北市,內湖區,康寧里,435,1883,633,355,988,54,1042
公投第１６案,臺北市,內湖區,康寧里,436,1434,475,305,780,46,826
公投第１６案,臺北市,內湖區,康寧里,437,1418,452,309,761,50,811
公投第１６案,臺北市,內湖區,康寧里,438,1373,456,291,747,72,819
公投第１６案,臺北市,內湖區,康寧里,439,1349,453,296,749,68,817
公投第１６案,臺北市,內湖區,明湖里,440,1511,521,353,874,58,932
公投第１６案,臺北市,內湖區,明湖里,441,1563,545,355,900,72,972
公投第１６案,臺北市,內湖區,明湖里,442,1550,497,356,853,59,912
公投第１６案,臺北市,內湖區,蘆洲里,443,1157,330,277,607,52,659
公投第１６案,臺北市,內湖區,麗山里,444,1768,544,430,974,60,1034
公投第１６案,臺北市,內湖區,麗山里,445,1664,535,373,908,64,972
公投第１６案,臺北市,內湖區,麗山里,446,1743,563,372,935,92,1027
公投第１６案,臺北市,內湖區,寶湖里,447,1480,493,359,852,26,878
公投第１６案,臺北市,內湖區,寶湖里,448,1589,527,401,928,63,991
公投第１６案,臺北市,內湖區,寶湖里,449,1371,443,316,759,34,793
公投第１６案,臺北市,內湖區,寶湖里,450,1575,585,344,929,55,984
公投第１６案,臺北市,內湖區,寶湖里,451,1377,470,307,777,26,803
公投第１６案,臺北市,內湖區,南湖里,452,1469,566,353,919,71,990
公投第１６案,臺北市,內湖區,南湖里,453,1529,561,359,920,32,952
公投第１６案,臺北市,內湖區,南湖里,454,1649,537,388,925,73,998
公投第１６案,臺北市,南港區,南港里,455,1280,345,292,637,33,670
公投第１６案,臺北市,南港區,南港里,456,1351,407,303,710,38,748
公投第１６案,臺北市,南港區,南港里,457,1345,453,284,737,49,786
公投第１６案,臺北市,南港區,南港里,458,1679,395,310,705,48,753
公投第１６案,臺北市,南港區,中南里,459,1680,448,375,823,63,886
公投第１６案,臺北市,南港區,中南里,460,1635,427,340,767,75,842
公投第１６案,臺北市,南港區,三重里,461,1459,434,316,750,65,815
公投第１６案,臺北市,南港區,三重里,462,1706,601,353,954,37,991
公投第１６案,臺北市,南港區,三重里,463,1674,482,365,847,54,901
公投第１６案,臺北市,南港區,三重里,464,1491,487,311,798,36,834
公投第１６案,臺北市,南港區,新富里,465,1086,356,291,647,57,704
公投第１６案,臺北市,南港區,新富里,466,1202,412,297,709,73,782
公投第１６案,臺北市,南港區,新富里,467,1198,356,308,664,59,723
公投第１６案,臺北市,南港區,中研里,468,1430,418,298,716,34,750
公投第１６案,臺北市,南港區,中研里,469,1275,410,319,729,58,787
公投第１６案,臺北市,南港區,中研里,470,1344,456,353,809,63,872
公投第１６案,臺北市,南港區,中研里,471,1391,460,332,792,43,835
公投第１６案,臺北市,南港區,中研里,472,1342,470,314,784,40,824
公投第１６案,臺北市,南港區,中研里,473,1389,443,264,707,58,765
公投第１６案,臺北市,南港區,九如里,474,1426,457,360,817,46,863
公投第１６案,臺北市,南港區,九如里,475,1359,494,278,772,42,814
公投第１６案,臺北市,南港區,九如里,476,1366,399,320,719,73,792
公投第１６案,臺北市,南港區,九如里,477,1441,501,308,809,39,848
公投第１６案,臺北市,南港區,舊莊里,478,1529,430,335,765,73,838
公投第１６案,臺北市,南港區,舊莊里,479,1618,442,332,774,85,859
公投第１６案,臺北市,南港區,舊莊里,480,1545,393,287,680,85,765
公投第１６案,臺北市,南港區,舊莊里,481,1569,500,334,834,65,899
公投第１６案,臺北市,南港區,舊莊里,482,1661,466,350,816,50,866
公投第１６案,臺北市,南港區,東新里,483,1518,420,304,724,74,798
公投第１６案,臺北市,南港區,東新里,484,1552,501,383,884,69,953
公投第１６案,臺北市,南港區,東新里,485,1658,502,331,833,38,871
公投第１６案,臺北市,南港區,東新里,486,1608,485,372,857,75,932
公投第１６案,臺北市,南港區,重陽里,487,1475,428,316,744,51,795
公投第１６案,臺北市,南港區,重陽里,488,1722,593,397,990,60,1050
公投第１６案,臺北市,南港區,重陽里,489,1383,501,362,863,33,896
公投第１６案,臺北市,南港區,東明里,490,1397,417,342,759,100,859
公投第１６案,臺北市,南港區,東明里,491,1352,465,310,775,40,815
公投第１６案,臺北市,南港區,東明里,492,1344,420,342,762,50,812
公投第１６案,臺北市,南港區,西新里,493,1385,388,313,701,39,740
公投第１６案,臺北市,南港區,西新里,494,1399,448,307,755,42,797
公投第１６案,臺北市,南港區,西新里,495,1381,393,305,698,40,738
公投第１６案,臺北市,南港區,玉成里,496,1548,476,324,800,51,851
公投第１６案,臺北市,南港區,玉成里,497,1190,348,278,626,37,663
公投第１６案,臺北市,南港區,玉成里,498,1490,474,347,821,50,871
公投第１６案,臺北市,南港區,合成里,499,1096,354,274,628,42,670
公投第１６案,臺北市,南港區,合成里,500,1238,417,301,718,45,763
公投第１６案,臺北市,南港區,合成里,501,1271,426,319,745,39,784
公投第１６案,臺北市,南港區,合成里,502,1146,368,241,609,59,668
公投第１６案,臺北市,南港區,合成里,503,1232,376,285,661,48,709
公投第１６案,臺北市,南港區,新光里,504,1649,497,291,788,41,829
公投第１６案,臺北市,南港區,新光里,505,1688,571,359,930,60,990
公投第１６案,臺北市,南港區,聯成里,506,1503,510,348,858,36,894
公投第１６案,臺北市,南港區,聯成里,507,1542,459,369,828,39,867
公投第１６案,臺北市,南港區,聯成里,508,1463,485,333,818,56,874
公投第１６案,臺北市,南港區,萬福里,509,1195,391,286,677,85,762
公投第１６案,臺北市,南港區,萬福里,510,1254,389,333,722,33,755
公投第１６案,臺北市,南港區,萬福里,511,1356,458,292,750,50,800
公投第１６案,臺北市,南港區,鴻福里,512,1363,409,343,752,96,848
公投第１６案,臺北市,南港區,鴻福里,513,1317,477,294,771,65,836
公投第１６案,臺北市,南港區,鴻福里,514,1331,451,284,735,36,771
公投第１６案,臺北市,南港區,百福里,515,1610,501,354,855,85,940
公投第１６案,臺北市,南港區,百福里,516,1542,479,323,802,46,848
公投第１６案,臺北市,南港區,百福里,517,1581,507,345,852,84,936
公投第１６案,臺北市,南港區,成福里,518,1225,324,288,612,52,664
公投第１６案,臺北市,南港區,成福里,519,1264,472,302,774,62,836
公投第１６案,臺北市,南港區,成福里,520,1649,381,525,906,112,1018
公投第１６案,臺北市,南港區,成福里,521,1267,461,275,736,24,760
公投第１６案,臺北市,南港區,成福里,522,1336,425,280,705,66,771
公投第１６案,臺北市,南港區,仁福里,523,1162,400,287,687,34,721
公投第１６案,臺北市,南港區,仁福里,524,1045,363,228,591,25,616
公投第１６案,臺北市,南港區,仁福里,525,1351,502,324,826,68,894
公投第１６案,臺北市,南港區,仁福里,526,1358,440,296,736,41,777
公投第１６案,臺北市,松山區,莊敬里,527,1583,521,354,875,60,935
公投第１６案,臺北市,松山區,莊敬里,528,1691,547,349,896,86,982
公投第１６案,臺北市,松山區,莊敬里,529,1386,452,287,739,55,794
公投第１６案,臺北市,松山區,東榮里,530,1362,444,324,768,58,826
公投第１６案,臺北市,松山區,東榮里,531,1399,462,328,790,53,843
公投第１６案,臺北市,松山區,東榮里,532,1324,393,334,727,85,812
公投第１６案,臺北市,松山區,東榮里,533,1296,429,325,754,77,831
公投第１６案,臺北市,松山區,東榮里,534,1386,459,335,794,60,854
公投第１６案,臺北市,松山區,三民里,535,1529,507,385,892,89,981
公投第１６案,臺北市,松山區,三民里,536,1416,496,279,775,46,821
公投第１６案,臺北市,松山區,三民里,537,1619,513,324,837,68,905
公投第１６案,臺北市,松山區,三民里,538,1386,432,356,788,57,845
公投第１６案,臺北市,松山區,新益里,539,1380,507,329,836,50,886
公投第１６案,臺北市,松山區,新益里,540,1357,424,346,770,56,826
公投第１６案,臺北市,松山區,新益里,541,1296,464,303,767,53,820
公投第１６案,臺北市,松山區,富錦里,542,1632,558,348,906,79,985
公投第１６案,臺北市,松山區,富錦里,543,1414,442,332,774,52,826
公投第１６案,臺北市,松山區,富錦里,544,1404,343,447,790,52,842
公投第１６案,臺北市,松山區,新東里,545,1365,460,320,780,73,853
公投第１６案,臺北市,松山區,新東里,546,1431,456,337,793,71,864
公投第１６案,臺北市,松山區,新東里,547,1483,474,367,841,64,905
公投第１６案,臺北市,松山區,富泰里,548,1293,433,320,753,60,813
公投第１６案,臺北市,松山區,富泰里,549,1410,486,271,757,58,815
公投第１６案,臺北市,松山區,富泰里,550,1307,473,270,743,50,793
公投第１６案,臺北市,松山區,介壽里,551,1242,399,341,740,54,794
公投第１６案,臺北市,松山區,介壽里,552,1192,405,292,697,38,735
公投第１６案,臺北市,松山區,介壽里,553,1276,416,321,737,64,801
公投第１６案,臺北市,松山區,精忠里,554,1201,392,274,666,38,704
公投第１６案,臺北市,松山區,精忠里,555,1318,448,304,752,39,791
公投第１６案,臺北市,松山區,精忠里,556,1157,388,268,656,42,698
公投第１６案,臺北市,松山區,東光里,557,1157,371,266,637,28,665
公投第１６案,臺北市,松山區,東光里,558,1357,461,314,775,58,833
公投第１６案,臺北市,松山區,東光里,559,1215,372,231,603,45,648
公投第１６案,臺北市,松山區,東光里,560,1345,469,280,749,41,790
公投第１６案,臺北市,松山區,東光里,561,1237,378,294,672,77,749
公投第１６案,臺北市,松山區,龍田里,562,1393,544,288,832,34,866
公投第１６案,臺北市,松山區,龍田里,563,1331,455,352,807,56,863
公投第１６案,臺北市,松山區,龍田里,564,1550,554,354,908,57,965
公投第１６案,臺北市,松山區,龍田里,565,1308,493,209,702,41,743
公投第１６案,臺北市,松山區,龍田里,566,1490,548,287,835,43,878
公投第１６案,臺北市,松山區,龍田里,567,1406,540,314,854,39,893
公投第１６案,臺北市,松山區,東昌里,568,1191,392,334,726,43,769
公投第１６案,臺北市,松山區,東昌里,569,1095,365,247,612,53,665
公投第１６案,臺北市,松山區,東勢里,570,1198,372,281,653,58,711
公投第１６案,臺北市,松山區,東勢里,571,1265,413,274,687,60,747
公投第１６案,臺北市,松山區,東勢里,572,1225,396,274,670,47,717
公投第１６案,臺北市,松山區,中華里,573,1698,570,416,986,69,1055
公投第１６案,臺北市,松山區,中華里,574,1819,634,347,981,59,1040
公投第１６案,臺北市,松山區,中華里,575,1754,577,404,981,79,1060
公投第１６案,臺北市,松山區,民有里,576,1361,412,388,800,50,850
公投第１６案,臺北市,松山區,民有里,577,1189,430,289,719,25,744
公投第１６案,臺北市,松山區,民有里,578,1214,390,301,691,56,747
公投第１６案,臺北市,松山區,民有里,579,1284,402,300,702,64,766
公投第１６案,臺北市,松山區,民有里,580,1297,439,313,752,53,805
公投第１６案,臺北市,松山區,民有里,581,1330,413,307,720,54,774
公投第１６案,臺北市,松山區,民福里,582,1396,487,313,800,95,895
公投第１６案,臺北市,松山區,民福里,583,1480,491,301,792,45,837
公投第１６案,臺北市,松山區,民福里,584,1419,496,319,815,48,863
公投第１６案,臺北市,松山區,民福里,585,1390,441,334,775,71,846
公投第１６案,臺北市,松山區,松基里,586,1525,481,379,860,57,917
公投第１６案,臺北市,松山區,松基里,587,1633,491,354,845,54,899
公投第１６案,臺北市,松山區,慈祐里,588,2677,481,358,839,58,897
公投第１６案,臺北市,松山區,慈祐里,589,1281,374,342,716,57,773
公投第１６案,臺北市,松山區,慈祐里,590,1469,354,301,655,69,724
公投第１６案,臺北市,松山區,慈祐里,591,1700,492,387,879,86,965
公投第１６案,臺北市,松山區,安平里,592,1503,423,348,771,53,824
公投第１６案,臺北市,松山區,安平里,593,1309,406,294,700,40,740
公投第１６案,臺北市,松山區,安平里,594,1376,447,302,749,87,836
公投第１６案,臺北市,松山區,安平里,595,1654,529,375,904,49,953
公投第１６案,臺北市,松山區,安平里,596,1601,452,380,832,76,908
公投第１６案,臺北市,松山區,鵬程里,597,1496,531,297,828,56,884
公投第１６案,臺北市,松山區,鵬程里,598,1598,548,379,927,85,1012
公投第１６案,臺北市,松山區,鵬程里,599,1751,609,383,992,62,1054
公投第１６案,臺北市,松山區,自強里,600,1557,658,267,925,48,973
公投第１６案,臺北市,松山區,自強里,601,1686,701,337,1038,51,1089
公投第１６案,臺北市,松山區,自強里,602,1707,702,278,980,71,1051
公投第１６案,臺北市,松山區,自強里,603,1854,755,383,1138,57,1195
公投第１６案,臺北市,松山區,自強里,604,1740,617,311,928,49,977
公投第１６案,臺北市,松山區,吉祥里,605,1494,482,319,801,85,886
公投第１６案,臺北市,松山區,吉祥里,606,1453,491,328,819,55,874
公投第１６案,臺北市,松山區,吉祥里,607,1458,493,339,832,40,872
公投第１６案,臺北市,松山區,吉祥里,608,1536,520,337,857,41,898
公投第１６案,臺北市,松山區,吉祥里,609,1463,497,343,840,45,885
公投第１６案,臺北市,松山區,新聚里,610,1790,523,388,911,45,956
公投第１６案,臺北市,松山區,新聚里,611,1679,536,415,951,66,1017
公投第１６案,臺北市,松山區,新聚里,612,1785,484,378,862,82,944
公投第１６案,臺北市,松山區,新聚里,613,1793,547,394,941,71,1012
公投第１６案,臺北市,松山區,復盛里,614,1381,520,238,758,62,820
公投第１６案,臺北市,松山區,復盛里,615,1279,418,298,716,59,775
公投第１６案,臺北市,松山區,復盛里,616,1681,537,375,912,96,1008
公投第１６案,臺北市,松山區,復盛里,617,1232,441,280,721,60,781
公投第１６案,臺北市,松山區,中正里,618,1533,476,356,832,56,888
公投第１６案,臺北市,松山區,中正里,619,1540,496,389,885,64,949
公投第１６案,臺北市,松山區,中正里,620,1716,511,394,905,61,966
公投第１６案,臺北市,松山區,中正里,621,1664,628,235,863,61,924
公投第１６案,臺北市,松山區,中正里,622,1350,430,316,746,33,779
公投第１６案,臺北市,松山區,中崙里,623,1837,575,423,998,53,1051
公投第１６案,臺北市,松山區,中崙里,624,1558,431,330,761,91,852
公投第１６案,臺北市,松山區,美仁里,625,1420,466,338,804,68,872
公投第１６案,臺北市,松山區,美仁里,626,1474,454,340,794,56,850
公投第１６案,臺北市,松山區,吉仁里,627,1591,499,341,840,74,914
公投第１６案,臺北市,松山區,吉仁里,628,1726,548,384,932,68,1000
公投第１６案,臺北市,松山區,敦化里,629,1452,435,363,798,54,852
公投第１６案,臺北市,松山區,敦化里,630,1482,422,351,773,54,827
公投第１６案,臺北市,松山區,敦化里,631,1460,447,362,809,64,873
公投第１６案,臺北市,松山區,敦化里,632,1398,430,316,746,63,809
公投第１６案,臺北市,松山區,復源里,633,1423,454,335,789,67,856
公投第１６案,臺北市,松山區,復源里,634,1226,390,301,691,42,733
公投第１６案,臺北市,松山區,復建里,635,1158,360,290,650,54,704
公投第１６案,臺北市,松山區,復建里,636,1426,451,318,769,54,823
公投第１６案,臺北市,松山區,復建里,637,1177,401,127,528,31,559
公投第１６案,臺北市,松山區,復勢里,638,1363,449,302,751,52,803
公投第１６案,臺北市,松山區,復勢里,639,1240,429,281,710,60,770
公投第１６案,臺北市,松山區,復勢里,640,1375,433,362,795,66,861
公投第１６案,臺北市,松山區,復勢里,641,1377,439,323,762,63,825
公投第１６案,臺北市,松山區,福成里,642,1225,371,269,640,43,683
公投第１６案,臺北市,松山區,福成里,643,1017,307,291,598,49,647
公投第１６案,臺北市,信義區,西村里,644,2476,498,275,773,34,807
公投第１６案,臺北市,信義區,西村里,645,1381,565,280,845,28,873
公投第１６案,臺北市,信義區,西村里,646,1294,497,272,769,52,821
公投第１６案,臺北市,信義區,正和里,647,1351,455,300,755,44,799
公投第１６案,臺北市,信義區,正和里,648,1296,449,268,717,52,769
公投第１６案,臺北市,信義區,正和里,649,1302,466,300,766,51,817
公投第１６案,臺北市,信義區,興隆里,650,1025,304,209,513,72,585
公投第１６案,臺北市,信義區,興隆里,651,1421,460,294,754,32,786
公投第１６案,臺北市,信義區,中興里,652,1501,496,310,806,50,856
公投第１６案,臺北市,信義區,中興里,653,1575,449,318,767,45,812
公投第１６案,臺北市,信義區,新仁里,654,1516,506,343,849,31,880
公投第１６案,臺北市,信義區,新仁里,655,1382,475,316,791,39,830
公投第１６案,臺北市,信義區,興雅里,656,1128,360,246,606,53,659
公投第１６案,臺北市,信義區,興雅里,657,1397,440,288,728,70,798
公投第１６案,臺北市,信義區,興雅里,658,1161,375,295,670,66,736
公投第１６案,臺北市,信義區,興雅里,659,1368,447,302,749,52,801
公投第１６案,臺北市,信義區,敦厚里,660,1049,350,247,597,33,630
公投第１６案,臺北市,信義區,敦厚里,661,1308,415,303,718,53,771
公投第１６案,臺北市,信義區,敦厚里,662,1154,370,296,666,61,727
公投第１６案,臺北市,信義區,敦厚里,663,1078,366,272,638,28,666
公投第１６案,臺北市,信義區,廣居里,664,1375,459,298,757,56,813
公投第１６案,臺北市,信義區,廣居里,665,1448,485,323,808,53,861
公投第１６案,臺北市,信義區,廣居里,666,1250,445,279,724,31,755
公投第１６案,臺北市,信義區,廣居里,667,1381,453,332,785,43,828
公投第１６案,臺北市,信義區,廣居里,668,1213,403,293,696,57,753
公投第１６案,臺北市,信義區,安康里,669,1373,448,377,825,52,877
公投第１６案,臺北市,信義區,安康里,670,1226,406,294,700,51,751
公投第１６案,臺北市,信義區,安康里,671,1117,355,278,633,35,668
公投第１６案,臺北市,信義區,安康里,672,1123,380,269,649,53,702
公投第１６案,臺北市,信義區,安康里,673,1200,408,282,690,39,729
公投第１６案,臺北市,信義區,安康里,674,1335,387,289,676,37,713
公投第１６案,臺北市,信義區,安康里,675,1332,413,278,691,37,728
公投第１６案,臺北市,信義區,六藝里,676,1648,535,363,898,83,981
公投第１６案,臺北市,信義區,六藝里,677,1542,465,342,807,72,879
公投第１６案,臺北市,信義區,雅祥里,678,1228,377,283,660,78,738
公投第１６案,臺北市,信義區,雅祥里,679,1731,494,416,910,71,981
公投第１６案,臺北市,信義區,雅祥里,680,1403,447,344,791,44,835
公投第１６案,臺北市,信義區,五常里,681,1929,578,394,972,94,1066
公投第１６案,臺北市,信義區,五常里,682,1300,433,300,733,65,798
公投第１６案,臺北市,信義區,五全里,683,1486,462,298,760,38,798
公投第１６案,臺北市,信義區,五全里,684,1532,394,313,707,79,786
公投第１６案,臺北市,信義區,五全里,685,1387,461,349,810,58,868
公投第１６案,臺北市,信義區,永吉里,686,1195,376,215,591,62,653
公投第１６案,臺北市,信義區,永吉里,687,1068,330,212,542,61,603
公投第１６案,臺北市,信義區,永吉里,688,1273,349,277,626,57,683
公投第１６案,臺北市,信義區,長春里,689,1329,425,322,747,86,833
公投第１６案,臺北市,信義區,長春里,690,1311,381,296,677,47,724
公投第１６案,臺北市,信義區,長春里,691,1258,362,274,636,67,703
公投第１６案,臺北市,信義區,四育里,692,1277,390,296,686,88,774
公投第１６案,臺北市,信義區,四育里,693,1285,435,311,746,67,813
公投第１６案,臺北市,信義區,四育里,694,1161,369,312,681,64,745
公投第１６案,臺北市,信義區,四育里,695,1299,405,292,697,55,752
公投第１６案,臺北市,信義區,四維里,696,1243,407,259,666,54,720
公投第１６案,臺北市,信義區,四維里,697,1197,389,259,648,44,692
公投第１６案,臺北市,信義區,四維里,698,1224,443,306,749,31,780
公投第１６案,臺北市,信義區,四維里,699,1147,330,250,580,54,634
公投第１６案,臺北市,信義區,永春里,700,1045,329,257,586,30,616
公投第１６案,臺北市,信義區,永春里,701,1096,395,253,648,56,704
公投第１６案,臺北市,信義區,永春里,702,1115,355,254,609,29,638
公投第１６案,臺北市,信義區,永春里,703,1117,339,231,570,73,643
公投第１６案,臺北市,信義區,富台里,704,1019,294,206,500,35,535
公投第１６案,臺北市,信義區,富台里,705,1346,441,283,724,72,796
公投第１６案,臺北市,信義區,富台里,706,1405,456,290,746,50,796
公投第１６案,臺北市,信義區,國業里,707,1356,464,271,735,58,793
公投第１６案,臺北市,信義區,國業里,708,1250,455,322,777,27,804
公投第１６案,臺北市,信義區,國業里,709,1254,421,287,708,60,768
公投第１６案,臺北市,信義區,國業里,710,1317,434,282,716,46,762
公投第１６案,臺北市,信義區,國業里,711,1271,460,290,750,55,805
公投第１６案,臺北市,信義區,松隆里,712,979,286,229,515,40,555
公投第１６案,臺北市,信義區,松隆里,713,1025,306,220,526,42,568
公投第１６案,臺北市,信義區,松友里,714,1512,427,278,705,49,754
公投第１６案,臺北市,信義區,松友里,715,1483,475,361,836,51,887
公投第１６案,臺北市,信義區,松友里,716,1359,458,325,783,51,834
公投第１６案,臺北市,信義區,松友里,717,1387,491,309,800,35,835
公投第１６案,臺北市,信義區,松光里,718,1455,416,343,759,36,795
公投第１６案,臺北市,信義區,松光里,719,1461,461,354,815,34,849
公投第１６案,臺北市,信義區,松光里,720,1532,513,347,860,58,918
公投第１６案,臺北市,信義區,中坡里,721,1043,350,269,619,53,672
公投第１６案,臺北市,信義區,中坡里,722,875,282,220,502,54,556
公投第１６案,臺北市,信義區,中坡里,723,927,282,203,485,42,527
公投第１６案,臺北市,信義區,中坡里,724,1119,352,254,606,80,686
公投第１６案,臺北市,信義區,中行里,725,1463,425,362,787,76,863
公投第１６案,臺北市,信義區,中行里,726,1293,424,337,761,58,819
公投第１６案,臺北市,信義區,中行里,727,1553,475,335,810,65,875
公投第１６案,臺北市,信義區,中行里,728,1360,425,317,742,43,785
公投第１６案,臺北市,信義區,中行里,729,1392,447,322,769,58,827
公投第１６案,臺北市,信義區,大道里,730,1377,436,322,758,32,790
公投第１６案,臺北市,信義區,大道里,731,1377,451,312,763,29,792
公投第１６案,臺北市,信義區,大道里,732,1269,360,284,644,40,684
公投第１６案,臺北市,信義區,大道里,733,1407,455,286,741,105,846
公投第１６案,臺北市,信義區,大仁里,734,1172,358,279,637,48,685
公投第１６案,臺北市,信義區,大仁里,735,1182,365,278,643,38,681
公投第１６案,臺北市,信義區,大仁里,736,1255,417,277,694,64,758
公投第１６案,臺北市,信義區,景新里,737,1689,534,314,848,45,893
公投第１６案,臺北市,信義區,景新里,738,1605,518,319,837,36,873
公投第１６案,臺北市,信義區,景新里,739,1143,362,249,611,38,649
公投第１６案,臺北市,信義區,惠安里,740,1440,442,276,718,59,777
公投第１６案,臺北市,信義區,惠安里,741,1495,494,308,802,61,863
公投第１６案,臺北市,信義區,惠安里,742,1514,522,339,861,52,913
公投第１６案,臺北市,信義區,惠安里,743,1449,438,304,742,48,790
公投第１６案,臺北市,信義區,三張里,744,1401,461,326,787,69,856
公投第１６案,臺北市,信義區,三張里,745,1181,372,237,609,26,635
公投第１６案,臺北市,信義區,三張里,746,1376,512,302,814,50,864
公投第１６案,臺北市,信義區,三張里,747,1422,507,301,808,66,874
公投第１６案,臺北市,信義區,三張里,748,1267,446,256,702,35,737
公投第１６案,臺北市,信義區,三張里,749,1220,361,253,614,44,658
公投第１６案,臺北市,信義區,三犁里,750,1562,467,291,758,45,803
公投第１６案,臺北市,信義區,三犁里,751,1455,451,314,765,34,799
公投第１６案,臺北市,信義區,三犁里,752,1605,519,306,825,60,885
公投第１６案,臺北市,信義區,六合里,753,1626,629,320,949,48,997
公投第１６案,臺北市,信義區,六合里,754,1561,582,300,882,55,937
公投第１６案,臺北市,信義區,六合里,755,1547,405,300,705,36,741
公投第１６案,臺北市,信義區,六合里,756,1336,443,288,731,38,769
公投第１６案,臺北市,信義區,泰和里,757,1314,379,237,616,61,677
公投第１６案,臺北市,信義區,泰和里,758,1297,407,255,662,46,708
公投第１６案,臺北市,信義區,泰和里,759,1366,422,260,682,80,762
公投第１６案,臺北市,信義區,泰和里,760,1472,386,349,735,106,841
公投第１６案,臺北市,信義區,泰和里,761,1450,465,312,777,60,837
公投第１６案,臺北市,信義區,景聯里,762,1328,418,270,688,87,775
公投第１６案,臺北市,信義區,景聯里,763,1399,458,320,778,81,859
公投第１６案,臺北市,信義區,景聯里,764,1373,452,298,750,97,847
公投第１６案,臺北市,信義區,景勤里,765,1099,420,154,574,38,612
公投第１６案,臺北市,信義區,景勤里,766,1226,371,282,653,59,712
公投第１６案,臺北市,信義區,景勤里,767,1267,386,254,640,31,671
公投第１６案,臺北市,信義區,雙和里,768,1531,457,363,820,90,910
公投第１６案,臺北市,信義區,雙和里,769,1438,514,305,819,55,874
公投第１６案,臺北市,信義區,雙和里,770,1657,540,334,874,44,918
公投第１６案,臺北市,信義區,雙和里,771,1621,555,349,904,60,964
公投第１６案,臺北市,信義區,嘉興里,772,1508,524,354,878,22,900
公投第１６案,臺北市,信義區,嘉興里,773,1334,448,320,768,50,818
公投第１６案,臺北市,信義區,黎順里,774,1246,323,223,546,56,602
公投第１６案,臺北市,信義區,黎順里,775,1196,433,268,701,61,762
公投第１６案,臺北市,信義區,黎順里,776,1220,404,279,683,41,724
公投第１６案,臺北市,信義區,黎平里,777,1538,486,324,810,50,860
公投第１６案,臺北市,信義區,黎平里,778,1565,540,324,864,76,940
公投第１６案,臺北市,信義區,黎平里,779,1621,484,311,795,78,873
公投第１６案,臺北市,信義區,黎平里,780,1486,459,316,775,65,840
公投第１６案,臺北市,信義區,黎忠里,781,1507,466,304,770,53,823
公投第１６案,臺北市,信義區,黎忠里,782,1516,509,325,834,65,899
公投第１６案,臺北市,信義區,黎忠里,783,1287,419,303,722,77,799
公投第１６案,臺北市,信義區,黎安里,784,1050,309,187,496,65,561
公投第１６案,臺北市,信義區,黎安里,785,801,286,166,452,45,497
公投第１６案,臺北市,中山區,正守里,786,1522,463,355,818,57,875
公投第１６案,臺北市,中山區,正守里,787,1332,364,325,689,38,727
公投第１６案,臺北市,中山區,正義里,788,1656,429,346,775,62,837
公投第１６案,臺北市,中山區,正義里,789,1367,361,283,644,67,711
公投第１６案,臺北市,中山區,正義里,790,1732,485,337,822,62,884
公投第１６案,臺北市,中山區,正得里,791,1634,454,400,854,72,926
公投第１６案,臺北市,中山區,正得里,792,1650,465,368,833,71,904
公投第１６案,臺北市,中山區,民安里,793,1392,400,369,769,46,815
公投第１６案,臺北市,中山區,民安里,794,1177,356,326,682,47,729
公投第１６案,臺北市,中山區,民安里,795,1477,430,384,814,64,878
公投第１６案,臺北市,中山區,康樂里,796,1063,296,217,513,68,581
公投第１６案,臺北市,中山區,康樂里,797,1296,396,264,660,50,710
公投第１６案,臺北市,中山區,中山里,798,1330,387,283,670,44,714
公投第１６案,臺北市,中山區,中山里,799,1483,404,341,745,67,812
公投第１６案,臺北市,中山區,中山里,800,1542,439,323,762,64,826
公投第１６案,臺北市,中山區,中山里,801,1710,484,351,835,72,907
公投第１６案,臺北市,中山區,聚盛里,802,1315,243,274,517,45,562
公投第１６案,臺北市,中山區,聚盛里,803,1245,350,277,627,76,703
公投第１６案,臺北市,中山區,聚盛里,804,1262,376,260,636,53,689
公投第１６案,臺北市,中山區,集英里,805,1518,451,359,810,67,877
公投第１６案,臺北市,中山區,集英里,806,1522,456,341,797,81,878
公投第１６案,臺北市,中山區,集英里,807,1580,411,354,765,68,833
公投第１６案,臺北市,中山區,集英里,808,1529,459,345,804,58,862
公投第１６案,臺北市,中山區,聚葉里,809,1221,380,266,646,47,693
公投第１６案,臺北市,中山區,聚葉里,810,1221,389,297,686,39,725
公投第１６案,臺北市,中山區,聚葉里,811,1139,308,229,537,35,572
公投第１６案,臺北市,中山區,恆安里,812,1407,380,324,704,100,804
公投第１６案,臺北市,中山區,恆安里,813,1321,403,315,718,41,759
公投第１６案,臺北市,中山區,恆安里,814,1578,434,308,742,49,791
公投第１６案,臺北市,中山區,晴光里,815,1739,475,365,840,63,903
公投第１６案,臺北市,中山區,晴光里,816,1637,454,350,804,51,855
公投第１６案,臺北市,中山區,晴光里,817,1541,439,326,765,78,843
公投第１６案,臺北市,中山區,圓山里,818,1210,374,284,658,61,719
公投第１６案,臺北市,中山區,圓山里,819,1331,387,293,680,54,734
公投第１６案,臺北市,中山區,圓山里,820,1224,314,266,580,69,649
公投第１６案,臺北市,中山區,新庄里,821,1585,473,362,835,76,911
公投第１６案,臺北市,中山區,新庄里,822,1523,472,390,862,88,950
公投第１６案,臺北市,中山區,新庄里,823,1368,436,338,774,75,849
公投第１６案,臺北市,中山區,劍潭里,824,1805,664,313,977,62,1039
公投第１６案,臺北市,中山區,劍潭里,825,1404,516,243,759,53,812
公投第１６案,臺北市,中山區,大直里,826,1708,590,416,1006,51,1057
公投第１６案,臺北市,中山區,大直里,827,1451,504,354,858,62,920
公投第１６案,臺北市,中山區,大直里,828,1684,548,402,950,88,1038
公投第１６案,臺北市,中山區,大直里,829,1585,553,299,852,47,899
公投第１６案,臺北市,中山區,大直里,830,1391,416,334,750,88,838
公投第１６案,臺北市,中山區,成功里,831,1375,451,375,826,85,911
公投第１６案,臺北市,中山區,成功里,832,1472,489,369,858,38,896
公投第１６案,臺北市,中山區,成功里,833,1327,417,278,695,45,740
公投第１６案,臺北市,中山區,成功里,834,1401,478,307,785,34,819
公投第１６案,臺北市,中山區,永安里,835,1423,455,333,788,52,840
公投第１６案,臺北市,中山區,永安里,836,1569,505,366,871,53,924
公投第１６案,臺北市,中山區,永安里,837,1651,526,393,919,39,958
公投第１６案,臺北市,中山區,永安里,838,1624,481,392,873,42,915
公投第１６案,臺北市,中山區,永安里,839,1713,564,437,1001,59,1060
公投第１６案,臺北市,中山區,金泰里,840,1647,546,381,927,61,988
公投第１６案,臺北市,中山區,金泰里,841,1762,533,369,902,52,954
公投第１６案,臺北市,中山區,金泰里,842,1399,502,315,817,47,864
公投第１６案,臺北市,中山區,金泰里,843,1489,471,385,856,62,918
公投第１６案,臺北市,中山區,北安里,844,1269,474,264,738,48,786
公投第１６案,臺北市,中山區,北安里,845,998,347,248,595,38,633
公投第１６案,臺北市,中山區,新喜里,846,1472,410,346,756,74,830
公投第１６案,臺北市,中山區,新喜里,847,1517,430,320,750,71,821
公投第１６案,臺北市,中山區,新喜里,848,1704,449,414,863,85,948
公投第１６案,臺北市,中山區,新福里,849,1603,444,431,875,73,948
公投第１６案,臺北市,中山區,新福里,850,1432,400,296,696,92,788
公投第１６案,臺北市,中山區,新福里,851,1500,439,385,824,72,896
公投第１６案,臺北市,中山區,松江里,852,1332,402,343,745,62,807
公投第１６案,臺北市,中山區,松江里,853,1450,494,347,841,61,902
公投第１６案,臺北市,中山區,松江里,854,1434,454,347,801,62,863
公投第１６案,臺北市,中山區,松江里,855,1419,440,297,737,52,789
公投第１６案,臺北市,中山區,新生里,856,1292,348,313,661,55,716
公投第１６案,臺北市,中山區,新生里,857,1526,420,340,760,77,837
公投第１６案,臺北市,中山區,新生里,858,1582,407,324,731,56,787
公投第１６案,臺北市,中山區,中庄里,859,1588,399,357,756,71,827
公投第１６案,臺北市,中山區,中庄里,860,1463,401,354,755,88,843
公投第１６案,臺北市,中山區,中庄里,861,1533,405,313,718,75,793
公投第１６案,臺北市,中山區,大佳里,862,944,259,217,476,62,538
公投第１６案,臺北市,中山區,行政里,863,1745,512,511,1023,72,1095
公投第１６案,臺北市,中山區,行政里,864,1679,447,350,797,55,852
公投第１６案,臺北市,中山區,行政里,865,3419,441,339,780,49,829
公投第１６案,臺北市,中山區,行仁里,866,1387,443,314,757,78,835
公投第１６案,臺北市,中山區,行仁里,867,1672,516,387,903,87,990
公投第１６案,臺北市,中山區,行仁里,868,1319,387,300,687,81,768
公投第１６案,臺北市,中山區,行仁里,869,1364,385,310,695,67,762
公投第１６案,臺北市,中山區,行仁里,870,1461,400,344,744,70,814
公投第１６案,臺北市,中山區,行孝里,871,1173,347,269,616,69,685
公投第１６案,臺北市,中山區,行孝里,872,1171,343,241,584,53,637
公投第１６案,臺北市,中山區,行孝里,873,1310,371,308,679,71,750
公投第１６案,臺北市,中山區,下埤里,874,1373,453,316,769,56,825
公投第１６案,臺北市,中山區,下埤里,875,1290,401,345,746,39,785
公投第１６案,臺北市,中山區,下埤里,876,1346,445,303,748,78,826
公投第１６案,臺北市,中山區,下埤里,877,1468,468,359,827,60,887
公投第１６案,臺北市,中山區,下埤里,878,1178,372,291,663,40,703
公投第１６案,臺北市,中山區,江寧里,879,1654,564,405,969,61,1030
公投第１６案,臺北市,中山區,江寧里,880,1464,467,329,796,65,861
公投第１６案,臺北市,中山區,江寧里,881,1450,426,338,764,39,803
公投第１６案,臺北市,中山區,江寧里,882,1534,472,337,809,72,881
公投第１６案,臺北市,中山區,江山里,883,1703,503,398,901,52,953
公投第１６案,臺北市,中山區,江山里,884,1610,531,356,887,70,957
公投第１６案,臺北市,中山區,江山里,885,1653,486,364,850,78,928
公投第１６案,臺北市,中山區,江山里,886,1694,523,416,939,82,1021
公投第１６案,臺北市,中山區,中吉里,887,1623,481,362,843,69,912
公投第１６案,臺北市,中山區,中吉里,888,1618,465,418,883,62,945
公投第１６案,臺北市,中山區,中吉里,889,1583,445,406,851,45,896
公投第１６案,臺北市,中山區,中原里,890,1605,454,442,896,69,965
公投第１６案,臺北市,中山區,中原里,891,1398,482,349,831,61,892
公投第１６案,臺北市,中山區,中原里,892,1526,527,387,914,70,984
公投第１６案,臺北市,中山區,興亞里,893,1555,460,398,858,54,912
公投第１６案,臺北市,中山區,興亞里,894,1597,497,348,845,47,892
公投第１６案,臺北市,中山區,興亞里,895,1587,467,371,838,97,935
公投第１６案,臺北市,中山區,中央里,896,1587,513,375,888,74,962
公投第１６案,臺北市,中山區,中央里,897,1546,485,386,871,76,947
公投第１６案,臺北市,中山區,朱馥里,898,1322,410,277,687,66,753
公投第１６案,臺北市,中山區,朱馥里,899,1267,392,296,688,53,741
公投第１６案,臺北市,中山區,朱馥里,900,1210,359,294,653,34,687
公投第１６案,臺北市,中山區,朱馥里,901,1295,402,282,684,63,747
公投第１６案,臺北市,中山區,龍洲里,902,1467,482,333,815,94,909
公投第１６案,臺北市,中山區,龍洲里,903,1491,587,278,865,62,927
公投第１６案,臺北市,中山區,龍洲里,904,1516,599,306,905,78,983
公投第１６案,臺北市,中山區,朱園里,905,1384,390,313,703,42,745
公投第１６案,臺北市,中山區,朱園里,906,1138,374,298,672,52,724
公投第１６案,臺北市,中山區,朱園里,907,1513,435,333,768,39,807
公投第１６案,臺北市,中山區,埤頭里,908,1559,521,329,850,76,926
公投第１６案,臺北市,中山區,埤頭里,909,1429,461,335,796,91,887
公投第１６案,臺北市,中山區,朱崙里,910,1245,409,321,730,39,769
公投第１６案,臺北市,中山區,朱崙里,911,1214,400,313,713,56,769
公投第１６案,臺北市,中山區,力行里,912,1394,429,346,775,55,830
公投第１６案,臺北市,中山區,力行里,913,1336,383,284,667,25,692
公投第１６案,臺北市,中山區,力行里,914,1227,375,276,651,52,703
公投第１６案,臺北市,中山區,力行里,915,1382,432,339,771,53,824
公投第１６案,臺北市,中山區,復華里,916,1436,457,315,772,55,827
公投第１６案,臺北市,中山區,復華里,917,1405,397,295,692,43,735
公投第１６案,臺北市,中山區,復華里,918,1259,430,267,697,38,735
公投第１６案,臺北市,大同區,玉泉里,919,1261,359,304,663,88,751
公投第１６案,臺北市,大同區,玉泉里,920,1352,424,341,765,71,836
公投第１６案,臺北市,大同區,建明里,921,1462,443,343,786,60,846
公投第１６案,臺北市,大同區,建明里,922,1510,461,337,798,79,877
公投第１６案,臺北市,大同區,建功里,923,1496,398,342,740,53,793
公投第１６案,臺北市,大同區,建功里,924,1329,364,322,686,64,750
公投第１６案,臺北市,大同區,建功里,925,1307,389,289,678,90,768
公投第１６案,臺北市,大同區,建泰里,926,1065,305,255,560,70,630
公投第１６案,臺北市,大同區,建泰里,927,1085,299,283,582,49,631
公投第１６案,臺北市,大同區,建泰里,928,1047,289,294,583,79,662
公投第１６案,臺北市,大同區,永樂里,929,1215,324,278,602,45,647
公投第１６案,臺北市,大同區,永樂里,930,1117,307,332,639,47,686
公投第１６案,臺北市,大同區,永樂里,931,1186,336,327,663,69,732
公投第１６案,臺北市,大同區,永樂里,932,1185,324,333,657,72,729
公投第１６案,臺北市,大同區,朝陽里,933,1359,419,300,719,53,772
公投第１６案,臺北市,大同區,朝陽里,934,1273,369,317,686,34,720
公投第１６案,臺北市,大同區,朝陽里,935,1291,399,333,732,58,790
公投第１６案,臺北市,大同區,星明里,936,1288,385,279,664,52,716
公投第１６案,臺北市,大同區,星明里,937,1245,411,314,725,56,781
公投第１６案,臺北市,大同區,星明里,938,1261,419,301,720,72,792
公投第１６案,臺北市,大同區,星明里,939,1348,405,301,706,33,739
公投第１６案,臺北市,大同區,光能里,940,1676,448,431,879,111,990
公投第１６案,臺北市,大同區,光能里,941,1311,430,305,735,70,805
公投第１６案,臺北市,大同區,光能里,942,1316,412,300,712,91,803
公投第１６案,臺北市,大同區,大有里,943,1409,402,330,732,93,825
公投第１６案,臺北市,大同區,大有里,944,1436,433,361,794,75,869
公投第１６案,臺北市,大同區,大有里,945,1408,450,326,776,66,842
公投第１６案,臺北市,大同區,延平里,946,1276,387,303,690,46,736
公投第１６案,臺北市,大同區,延平里,947,1110,335,267,602,34,636
公投第１６案,臺北市,大同區,延平里,948,1324,391,326,717,50,767
公投第１６案,臺北市,大同區,雙連里,949,1016,308,246,554,41,595
公投第１６案,臺北市,大同區,雙連里,950,1028,339,253,592,48,640
公投第１６案,臺北市,大同區,雙連里,951,1158,375,265,640,65,705
公投第１６案,臺北市,大同區,雙連里,952,1138,364,269,633,63,696
公投第１６案,臺北市,大同區,雙連里,953,1214,360,298,658,70,728
公投第１６案,臺北市,大同區,雙連里,954,1090,330,264,594,34,628
公投第１６案,臺北市,大同區,雙連里,955,1305,450,341,791,71,862
公投第１６案,臺北市,大同區,南芳里,956,1167,330,256,586,38,624
公投第１６案,臺北市,大同區,南芳里,957,1148,350,262,612,61,673
公投第１６案,臺北市,大同區,南芳里,958,1203,380,308,688,65,753
公投第１６案,臺北市,大同區,民權里,959,1441,379,350,729,70,799
公投第１６案,臺北市,大同區,民權里,960,1315,405,344,749,70,819
公投第１６案,臺北市,大同區,民權里,961,1393,395,326,721,72,793
公投第１６案,臺北市,大同區,民權里,962,1278,400,305,705,60,765
公投第１６案,臺北市,大同區,景星里,963,1246,329,278,607,64,671
公投第１６案,臺北市,大同區,景星里,964,1142,317,265,582,81,663
公投第１６案,臺北市,大同區,隆和里,965,1336,400,324,724,88,812
公投第１６案,臺北市,大同區,隆和里,966,1363,405,372,777,61,838
公投第１６案,臺北市,大同區,蓬萊里,967,1476,425,373,798,40,838
公投第１６案,臺北市,大同區,蓬萊里,968,1418,402,362,764,71,835
公投第１６案,臺北市,大同區,蓬萊里,969,1460,391,341,732,60,792
公投第１６案,臺北市,大同區,國順里,970,1222,276,259,535,73,608
公投第１６案,臺北市,大同區,國順里,971,1246,288,257,545,103,648
公投第１６案,臺北市,大同區,國慶里,972,1256,404,296,700,84,784
公投第１６案,臺北市,大同區,國慶里,973,1289,375,320,695,47,742
公投第１６案,臺北市,大同區,國慶里,974,1340,376,307,683,36,719
公投第１６案,臺北市,大同區,揚雅里,975,1555,443,329,772,67,839
公投第１６案,臺北市,大同區,揚雅里,976,2459,432,299,731,102,833
公投第１６案,臺北市,大同區,斯文里,977,1108,248,216,464,75,539
公投第１６案,臺北市,大同區,斯文里,978,867,227,174,401,71,472
公投第１６案,臺北市,大同區,斯文里,979,1329,395,349,744,73,817
公投第１６案,臺北市,大同區,斯文里,980,1162,328,291,619,47,666
公投第１６案,臺北市,大同區,鄰江里,981,1434,375,326,701,86,787
公投第１６案,臺北市,大同區,鄰江里,982,1351,400,303,703,86,789
公投第１６案,臺北市,大同區,鄰江里,983,1531,493,247,740,67,807
公投第１６案,臺北市,大同區,鄰江里,984,1507,378,328,706,56,762
公投第１６案,臺北市,大同區,至聖里,985,1488,417,351,768,75,843
公投第１６案,臺北市,大同區,至聖里,986,1384,410,348,758,98,856
公投第１６案,臺北市,大同區,至聖里,987,1460,456,310,766,83,849
公投第１６案,臺北市,大同區,至聖里,988,1371,452,320,772,74,846
公投第１６案,臺北市,大同區,至聖里,989,1439,429,331,760,32,792
公投第１６案,臺北市,大同區,老師里,990,1376,302,454,756,72,828
公投第１６案,臺北市,大同區,老師里,991,1366,379,305,684,94,778
公投第１６案,臺北市,大同區,老師里,992,1218,419,295,714,74,788
公投第１６案,臺北市,大同區,老師里,993,1235,393,271,664,68,732
公投第１６案,臺北市,大同區,重慶里,994,1364,413,281,694,31,725
公投第１６案,臺北市,大同區,重慶里,995,1408,500,334,834,77,911
公投第１６案,臺北市,大同區,重慶里,996,1450,463,319,782,65,847
公投第１６案,臺北市,大同區,重慶里,997,1429,479,336,815,80,895
公投第１６案,臺北市,大同區,保安里,998,1170,343,290,633,75,708
公投第１６案,臺北市,大同區,保安里,999,1245,319,326,645,91,736
公投第１６案,臺北市,大同區,保安里,1000,1215,384,326,710,82,792
公投第１６案,臺北市,中正區,水源里,1001,1308,426,317,743,45,788
公投第１６案,臺北市,中正區,水源里,1002,1317,371,296,667,72,739
公投第１６案,臺北市,中正區,富水里,1003,1069,382,246,628,36,664
公投第１６案,臺北市,中正區,富水里,1004,1128,372,209,581,49,630
公投第１６案,臺北市,中正區,文盛里,1005,1053,356,249,605,44,649
公投第１６案,臺北市,中正區,文盛里,1006,1048,343,245,588,32,620
公投第１６案,臺北市,中正區,林興里,1007,1297,422,268,690,55,745
公投第１６案,臺北市,中正區,林興里,1008,1193,411,261,672,37,709
公投第１６案,臺北市,中正區,林興里,1009,1500,542,373,915,55,970
公投第１６案,臺北市,中正區,河堤里,1010,1346,430,272,702,43,745
公投第１６案,臺北市,中正區,河堤里,1011,1283,456,265,721,23,744
公投第１６案,臺北市,中正區,河堤里,1012,1450,455,327,782,46,828
公投第１６案,臺北市,中正區,頂東里,1013,1433,466,339,805,49,854
公投第１６案,臺北市,中正區,頂東里,1014,1309,456,349,805,57,862
公投第１６案,臺北市,中正區,頂東里,1015,1386,481,308,789,32,821
公投第１６案,臺北市,中正區,頂東里,1016,1201,395,283,678,55,733
公投第１６案,臺北市,中正區,網溪里,1017,1336,479,303,782,56,838
公投第１６案,臺北市,中正區,網溪里,1018,1358,459,319,778,48,826
公投第１６案,臺北市,中正區,網溪里,1019,1177,415,252,667,55,722
公投第１６案,臺北市,中正區,網溪里,1020,1236,444,306,750,38,788
公投第１６案,臺北市,中正區,板溪里,1021,1478,476,333,809,47,856
公投第１６案,臺北市,中正區,板溪里,1022,1474,526,323,849,38,887
公投第１６案,臺北市,中正區,螢圃里,1023,1172,374,276,650,40,690
公投第１６案,臺北市,中正區,螢圃里,1024,1310,428,301,729,43,772
公投第１６案,臺北市,中正區,螢圃里,1025,1263,449,283,732,30,762
公投第１６案,臺北市,中正區,螢圃里,1026,1169,379,278,657,47,704
公投第１６案,臺北市,中正區,螢雪里,1027,1391,469,292,761,31,792
公投第１６案,臺北市,中正區,螢雪里,1028,1201,386,263,649,39,688
公投第１６案,臺北市,中正區,螢雪里,1029,1324,429,297,726,57,783
公投第１６案,臺北市,中正區,永功里,1030,1216,364,253,617,66,683
公投第１６案,臺北市,中正區,永功里,1031,1183,348,273,621,60,681
公投第１６案,臺北市,中正區,永功里,1032,1469,456,354,810,82,892
公投第１６案,臺北市,中正區,永功里,1033,1411,451,310,761,60,821
公投第１６案,臺北市,中正區,永昌里,1034,1398,445,309,754,92,846
公投第１６案,臺北市,中正區,永昌里,1035,1479,447,312,759,81,840
公投第１６案,臺北市,中正區,永昌里,1036,1620,501,328,829,73,902
公投第１６案,臺北市,中正區,龍興里,1037,1041,350,223,573,22,595
公投第１６案,臺北市,中正區,龍興里,1038,1056,315,246,561,23,584
公投第１６案,臺北市,中正區,龍興里,1039,1063,370,261,631,51,682
公投第１６案,臺北市,中正區,忠勤里,1040,1591,395,283,678,68,746
公投第１６案,臺北市,中正區,忠勤里,1041,1502,367,252,619,88,707
公投第１６案,臺北市,中正區,忠勤里,1042,1331,391,247,638,77,715
公投第１６案,臺北市,中正區,忠勤里,1043,1441,458,293,751,70,821
公投第１６案,臺北市,中正區,廈安里,1044,1273,415,321,736,57,793
公投第１６案,臺北市,中正區,廈安里,1045,1133,368,283,651,43,694
公投第１６案,臺北市,中正區,廈安里,1046,1156,364,287,651,38,689
公投第１６案,臺北市,中正區,愛國里,1047,1377,412,340,752,58,810
公投第１６案,臺北市,中正區,愛國里,1048,1266,379,339,718,62,780
公投第１６案,臺北市,中正區,南門里,1049,1111,406,257,663,51,714
公投第１６案,臺北市,中正區,南門里,1050,1124,365,262,627,40,667
公投第１６案,臺北市,中正區,龍光里,1051,1373,432,359,791,53,844
公投第１６案,臺北市,中正區,龍光里,1052,1351,501,281,782,55,837
公投第１６案,臺北市,中正區,南福里,1053,1495,509,337,846,41,887
公投第１６案,臺北市,中正區,南福里,1054,1436,479,374,853,68,921
公投第１６案,臺北市,中正區,南福里,1055,1516,503,333,836,30,866
公投第１６案,臺北市,中正區,南福里,1056,1374,459,297,756,47,803
公投第１６案,臺北市,中正區,南福里,1057,1522,456,308,764,67,831
公投第１６案,臺北市,中正區,南福里,1058,1336,480,278,758,43,801
公投第１６案,臺北市,中正區,龍福里,1059,1551,489,387,876,43,919
公投第１６案,臺北市,中正區,龍福里,1060,1594,528,379,907,52,959
公投第１６案,臺北市,中正區,龍福里,1061,1503,495,327,822,63,885
公投第１６案,臺北市,中正區,新營里,1062,1455,501,325,826,41,867
公投第１６案,臺北市,中正區,新營里,1063,1439,498,325,823,22,845
公投第１６案,臺北市,中正區,新營里,1064,1469,507,312,819,49,868
公投第１６案,臺北市,中正區,新營里,1065,1430,533,248,781,35,816
公投第１６案,臺北市,中正區,新營里,1066,1444,555,288,843,50,893
公投第１６案,臺北市,中正區,建國里,1067,1254,418,291,709,24,733
公投第１６案,臺北市,中正區,光復里,1068,932,308,215,523,52,575
公投第１６案,臺北市,中正區,光復里,1069,1055,339,245,584,61,645
公投第１６案,臺北市,中正區,光復里,1070,1226,403,265,668,54,722
公投第１６案,臺北市,中正區,黎明里,1071,1390,409,271,680,52,732
公投第１６案,臺北市,中正區,黎明里,1072,1336,462,288,750,29,779
公投第１６案,臺北市,中正區,梅花里,1073,1419,386,336,722,54,776
公投第１６案,臺北市,中正區,梅花里,1074,1361,577,218,795,52,847
公投第１６案,臺北市,中正區,幸福里,1075,2520,518,346,864,54,918
公投第１６案,臺北市,中正區,幸福里,1076,1224,396,279,675,34,709
公投第１６案,臺北市,中正區,幸福里,1077,1272,334,319,653,6,659
公投第１６案,臺北市,中正區,幸市里,1078,1400,412,342,754,58,812
公投第１６案,臺北市,中正區,幸市里,1079,1319,420,279,699,38,737
公投第１６案,臺北市,中正區,幸市里,1080,1232,430,285,715,48,763
公投第１６案,臺北市,中正區,東門里,1081,1265,448,306,754,48,802
公投第１６案,臺北市,中正區,東門里,1082,1055,370,272,642,34,676
公投第１６案,臺北市,中正區,東門里,1083,954,318,226,544,24,568
公投第１６案,臺北市,中正區,文北里,1084,1018,306,231,537,43,580
公投第１６案,臺北市,中正區,文北里,1085,1431,439,325,764,52,816
公投第１６案,臺北市,中正區,文北里,1086,1271,379,246,625,49,674
公投第１６案,臺北市,中正區,文北里,1087,983,291,271,562,52,614
公投第１６案,臺北市,中正區,文祥里,1088,1594,513,358,871,42,913
公投第１６案,臺北市,中正區,文祥里,1089,1565,552,345,897,52,949
公投第１６案,臺北市,中正區,文祥里,1090,1650,547,363,910,43,953
公投第１６案,臺北市,中正區,文祥里,1091,1600,505,343,848,39,887
公投第１６案,臺北市,中正區,三愛里,1092,1391,420,329,749,37,786
公投第１６案,臺北市,中正區,三愛里,1093,1769,572,388,960,53,1013
公投第１６案,臺北市,中正區,三愛里,1094,1487,470,349,819,65,884
公投第１６案,臺北市,中正區,三愛里,1095,1291,383,295,678,108,786
公投第１６案,臺北市,中正區,三愛里,1096,1289,455,294,749,35,784
公投第１６案,臺北市,萬華區,福星里,1097,1305,406,318,724,58,782
公投第１６案,臺北市,萬華區,福星里,1098,1183,304,221,525,79,604
公投第１６案,臺北市,萬華區,福星里,1099,1176,348,260,608,32,640
公投第１６案,臺北市,萬華區,福星里,1100,1169,312,260,572,33,605
公投第１６案,臺北市,萬華區,萬壽里,1101,1457,399,287,686,56,742
公投第１６案,臺北市,萬華區,萬壽里,1102,1563,377,293,670,86,756
公投第１６案,臺北市,萬華區,西門里,1103,1771,498,300,798,56,854
公投第１６案,臺北市,萬華區,西門里,1104,1615,439,336,775,65,840
公投第１６案,臺北市,萬華區,新起里,1105,1478,436,311,747,85,832
公投第１６案,臺北市,萬華區,新起里,1106,1462,442,290,732,57,789
公投第１６案,臺北市,萬華區,新起里,1107,1507,387,271,658,79,737
公投第１６案,臺北市,萬華區,新起里,1108,1347,404,314,718,73,791
公投第１６案,臺北市,萬華區,菜園里,1109,1367,376,288,664,62,726
公投第１６案,臺北市,萬華區,菜園里,1110,1277,408,311,719,64,783
公投第１６案,臺北市,萬華區,菜園里,1111,1395,380,283,663,63,726
公投第１６案,臺北市,萬華區,菜園里,1112,1450,376,353,729,59,788
公投第１６案,臺北市,萬華區,青山里,1113,1340,360,254,614,80,694
公投第１６案,臺北市,萬華區,青山里,1114,1242,327,265,592,67,659
公投第１６案,臺北市,萬華區,青山里,1115,1286,340,291,631,84,715
公投第１６案,臺北市,萬華區,青山里,1116,1324,361,274,635,73,708
公投第１６案,臺北市,萬華區,富民里,1117,1619,452,328,780,80,860
公投第１６案,臺北市,萬華區,富民里,1118,1352,330,254,584,92,676
公投第１６案,臺北市,萬華區,富民里,1119,1440,398,303,701,62,763
公投第１６案,臺北市,萬華區,福音里,1120,1194,376,294,670,51,721
公投第１６案,臺北市,萬華區,福音里,1121,1083,361,258,619,74,693
公投第１６案,臺北市,萬華區,福音里,1122,1237,343,251,594,85,679
公投第１６案,臺北市,萬華區,仁德里,1123,1625,448,381,829,65,894
公投第１６案,臺北市,萬華區,仁德里,1124,1324,404,315,719,86,805
公投第１６案,臺北市,萬華區,仁德里,1125,1352,417,312,729,67,796
公投第１６案,臺北市,萬華區,富福里,1126,2630,376,314,690,59,749
公投第１６案,臺北市,萬華區,富福里,1127,1504,451,387,838,75,913
公投第１６案,臺北市,萬華區,富福里,1128,1425,370,332,702,75,777
公投第１６案,臺北市,萬華區,柳鄉里,1129,1591,399,317,716,88,804
公投第１６案,臺北市,萬華區,柳鄉里,1130,1474,420,305,725,80,805
公投第１６案,臺北市,萬華區,柳鄉里,1131,1612,408,353,761,88,849
公投第１６案,臺北市,萬華區,華江里,1132,1447,399,325,724,74,798
公投第１６案,臺北市,萬華區,華江里,1133,1491,492,326,818,79,897
公投第１６案,臺北市,萬華區,華江里,1134,1500,455,359,814,71,885
公投第１６案,臺北市,萬華區,華江里,1135,1582,470,382,852,78,930
公投第１６案,臺北市,萬華區,華江里,1136,1623,438,322,760,74,834
公投第１６案,臺北市,萬華區,糖廍里,1137,1228,370,252,622,41,663
公投第１６案,臺北市,萬華區,糖廍里,1138,1268,370,268,638,85,723
公投第１６案,臺北市,萬華區,糖廍里,1139,1207,370,285,655,76,731
公投第１６案,臺北市,萬華區,糖廍里,1140,1188,362,291,653,63,716
公投第１６案,臺北市,萬華區,綠堤里,1141,1474,420,318,738,56,794
公投第１６案,臺北市,萬華區,綠堤里,1142,1304,365,215,580,39,619
公投第１６案,臺北市,萬華區,綠堤里,1143,1082,218,177,395,68,463
公投第１６案,臺北市,萬華區,頂碩里,1144,1052,250,250,500,56,556
公投第１６案,臺北市,萬華區,頂碩里,1145,1135,300,269,569,61,630
公投第１６案,臺北市,萬華區,頂碩里,1146,1225,352,270,622,68,690
公投第１６案,臺北市,萬華區,頂碩里,1147,1583,444,308,752,81,833
公投第１６案,臺北市,萬華區,頂碩里,1148,1403,379,319,698,90,788
公投第１６案,臺北市,萬華區,雙園里,1149,1406,409,316,725,88,813
公投第１６案,臺北市,萬華區,雙園里,1150,1401,426,316,742,74,816
公投第１６案,臺北市,萬華區,雙園里,1151,1188,358,260,618,83,701
公投第１６案,臺北市,萬華區,和平里,1152,1597,422,356,778,82,860
公投第１６案,臺北市,萬華區,和平里,1153,1290,387,315,702,93,795
公投第１６案,臺北市,萬華區,和平里,1154,1746,441,364,805,37,842
公投第１６案,臺北市,萬華區,和平里,1155,1595,409,323,732,44,776
公投第１６案,臺北市,萬華區,和德里,1156,1701,462,362,824,116,940
公投第１６案,臺北市,萬華區,和德里,1157,1339,305,280,585,77,662
公投第１６案,臺北市,萬華區,和德里,1158,1484,353,277,630,104,734
公投第１６案,臺北市,萬華區,和德里,1159,1604,479,350,829,94,923
公投第１６案,臺北市,萬華區,全德里,1160,1197,371,272,643,54,697
公投第１６案,臺北市,萬華區,全德里,1161,1347,361,277,638,97,735
公投第１６案,臺北市,萬華區,全德里,1162,1223,403,330,733,55,788
公投第１６案,臺北市,萬華區,日善里,1163,1036,319,244,563,49,612
公投第１６案,臺北市,萬華區,日善里,1164,1035,317,266,583,78,661
公投第１６案,臺北市,萬華區,日善里,1165,1141,377,272,649,62,711
公投第１６案,臺北市,萬華區,忠德里,1166,1271,364,324,688,60,748
公投第１６案,臺北市,萬華區,忠德里,1167,1328,388,316,704,105,809
公投第１６案,臺北市,萬華區,忠德里,1168,1286,372,329,701,57,758
公投第１６案,臺北市,萬華區,錦德里,1169,1679,493,395,888,100,988
公投第１６案,臺北市,萬華區,錦德里,1170,1619,474,362,836,76,912
公投第１６案,臺北市,萬華區,錦德里,1171,1625,431,322,753,67,820
公投第１６案,臺北市,萬華區,孝德里,1172,1623,495,390,885,73,958
公投第１６案,臺北市,萬華區,孝德里,1173,1280,375,266,641,80,721
公投第１６案,臺北市,萬華區,壽德里,1174,1608,472,334,806,91,897
公投第１６案,臺北市,萬華區,壽德里,1175,1453,441,338,779,76,855
公投第１６案,臺北市,萬華區,壽德里,1176,1472,474,365,839,64,903
公投第１６案,臺北市,萬華區,銘德里,1177,1373,393,334,727,62,789
公投第１６案,臺北市,萬華區,銘德里,1178,1394,419,269,688,84,772
公投第１６案,臺北市,萬華區,銘德里,1179,1427,427,272,699,47,746
公投第１６案,臺北市,萬華區,保德里,1180,1342,406,361,767,62,829
公投第１６案,臺北市,萬華區,保德里,1181,1569,495,346,841,92,933
公投第１６案,臺北市,萬華區,榮德里,1182,1514,408,279,687,75,762
公投第１６案,臺北市,萬華區,榮德里,1183,1720,461,314,775,44,819
公投第１６案,臺北市,萬華區,華中里,1184,1461,467,363,830,87,917
公投第１６案,臺北市,萬華區,華中里,1185,1264,361,278,639,52,691
公投第１６案,臺北市,萬華區,華中里,1186,1334,410,346,756,75,831
公投第１６案,臺北市,萬華區,華中里,1187,1446,335,474,809,36,845
公投第１６案,臺北市,萬華區,興德里,1188,1307,362,270,632,54,686
公投第１６案,臺北市,萬華區,興德里,1189,1420,435,302,737,95,832
公投第１６案,臺北市,萬華區,興德里,1190,1427,379,313,692,51,743
公投第１６案,臺北市,萬華區,日祥里,1191,956,296,192,488,54,542
公投第１６案,臺北市,萬華區,日祥里,1192,1352,417,311,728,65,793
公投第１６案,臺北市,萬華區,日祥里,1193,1370,434,279,713,68,781
公投第１６案,臺北市,萬華區,日祥里,1194,1222,449,237,686,49,735
公投第１６案,臺北市,萬華區,忠貞里,1195,1375,470,254,724,52,776
公投第１６案,臺北市,萬華區,忠貞里,1196,1463,507,298,805,53,858
公投第１６案,臺北市,萬華區,忠貞里,1197,1527,424,311,735,60,795
公投第１６案,臺北市,萬華區,新忠里,1198,1485,480,259,739,69,808
公投第１６案,臺北市,萬華區,新忠里,1199,1591,636,285,921,58,979
公投第１６案,臺北市,萬華區,新和里,1200,1394,572,293,865,42,907
公投第１６案,臺北市,萬華區,新和里,1201,1522,524,317,841,37,878
公投第１６案,臺北市,萬華區,新和里,1202,1661,631,329,960,42,1002
公投第１６案,臺北市,萬華區,新和里,1203,1561,562,334,896,40,936
公投第１６案,臺北市,萬華區,新和里,1204,1406,559,289,848,59,907
公投第１６案,臺北市,萬華區,新安里,1205,1498,377,262,639,60,699
公投第１６案,臺北市,萬華區,新安里,1206,1478,378,251,629,83,712
公投第１６案,臺北市,萬華區,新安里,1207,1170,358,228,586,77,663
公投第１６案,臺北市,萬華區,新安里,1208,1376,481,275,756,61,817
公投第１６案,臺北市,萬華區,凌霄里,1209,1093,357,226,583,30,613
公投第１６案,臺北市,萬華區,凌霄里,1210,1084,380,237,617,69,686
公投第１６案,臺北市,萬華區,凌霄里,1211,1119,362,245,607,69,676
公投第１６案,臺北市,萬華區,騰雲里,1212,1381,497,305,802,52,854
公投第１６案,臺北市,萬華區,騰雲里,1213,1396,427,334,761,54,815
公投第１６案,臺北市,大安區,德安里,1214,1184,362,262,624,38,662
公投第１６案,臺北市,大安區,德安里,1215,1197,376,241,617,39,656
公投第１６案,臺北市,大安區,德安里,1216,1221,383,300,683,26,709
公投第１６案,臺北市,大安區,德安里,1217,1246,496,214,710,36,746
公投第１６案,臺北市,大安區,仁慈里,1218,1478,502,359,861,50,911
公投第１６案,臺北市,大安區,仁慈里,1219,1314,376,297,673,76,749
公投第１６案,臺北市,大安區,仁慈里,1220,1594,557,359,916,58,974
公投第１６案,臺北市,大安區,和安里,1221,1429,466,352,818,41,859
公投第１６案,臺北市,大安區,和安里,1222,1452,556,298,854,29,883
公投第１６案,臺北市,大安區,和安里,1223,1551,490,368,858,35,893
公投第１６案,臺北市,大安區,和安里,1224,1335,447,315,762,62,824
公投第１６案,臺北市,大安區,民炤里,1225,1196,359,264,623,34,657
公投第１６案,臺北市,大安區,民炤里,1226,1339,405,303,708,32,740
公投第１６案,臺北市,大安區,民炤里,1227,1448,450,331,781,39,820
公投第１６案,臺北市,大安區,民炤里,1228,1373,457,302,759,43,802
公投第１６案,臺北市,大安區,民炤里,1229,1439,468,330,798,48,846
公投第１６案,臺北市,大安區,仁愛里,1230,1174,343,264,607,24,631
公投第１６案,臺北市,大安區,仁愛里,1231,1144,314,256,570,34,604
公投第１６案,臺北市,大安區,仁愛里,1232,1119,342,223,565,35,600
公投第１６案,臺北市,大安區,仁愛里,1233,1024,278,187,465,32,497
公投第１６案,臺北市,大安區,義村里,1234,1032,372,223,595,35,630
公投第１６案,臺北市,大安區,義村里,1235,1319,519,242,761,37,798
公投第１６案,臺北市,大安區,義村里,1236,1369,501,301,802,42,844
公投第１６案,臺北市,大安區,義村里,1237,1347,398,355,753,49,802
公投第１６案,臺北市,大安區,民輝里,1238,1655,451,375,826,41,867
公投第１６案,臺北市,大安區,民輝里,1239,1595,447,316,763,50,813
公投第１６案,臺北市,大安區,民輝里,1240,1429,468,279,747,36,783
公投第１６案,臺北市,大安區,民輝里,1241,1309,365,285,650,37,687
公投第１６案,臺北市,大安區,昌隆里,1242,1508,447,322,769,56,825
公投第１６案,臺北市,大安區,昌隆里,1243,1310,370,314,684,49,733
公投第１６案,臺北市,大安區,誠安里,1244,1233,324,279,603,42,645
公投第１６案,臺北市,大安區,誠安里,1245,1287,363,270,633,63,696
公投第１６案,臺北市,大安區,誠安里,1246,1147,311,252,563,41,604
公投第１６案,臺北市,大安區,光武里,1247,1260,340,292,632,47,679
公投第１６案,臺北市,大安區,光武里,1248,1377,440,283,723,31,754
公投第１６案,臺北市,大安區,光武里,1249,1284,366,275,641,76,717
公投第１６案,臺北市,大安區,光武里,1250,1314,377,270,647,36,683
公投第１６案,臺北市,大安區,光武里,1251,1273,350,278,628,48,676
公投第１６案,臺北市,大安區,龍坡里,1252,1146,334,315,649,26,675
公投第１６案,臺北市,大安區,龍坡里,1253,1285,412,301,713,45,758
公投第１６案,臺北市,大安區,龍坡里,1254,1297,410,344,754,35,789
公投第１６案,臺北市,大安區,龍坡里,1255,1101,374,260,634,51,685
公投第１６案,臺北市,大安區,龍泉里,1256,1310,402,301,703,53,756
公投第１６案,臺北市,大安區,龍泉里,1257,1365,449,327,776,68,844
公投第１６案,臺北市,大安區,龍泉里,1258,1372,432,331,763,30,793
公投第１６案,臺北市,大安區,古風里,1259,1189,410,274,684,47,731
公投第１６案,臺北市,大安區,古風里,1260,1256,436,280,716,45,761
公投第１６案,臺北市,大安區,古風里,1261,1151,379,278,657,40,697
公投第１６案,臺北市,大安區,古莊里,1262,1501,527,352,879,56,935
公投第１６案,臺北市,大安區,古莊里,1263,1520,524,352,876,46,922
公投第１６案,臺北市,大安區,古莊里,1264,1529,482,402,884,66,950
公投第１６案,臺北市,大安區,古莊里,1265,1579,518,372,890,76,966
公投第１６案,臺北市,大安區,龍安里,1266,2619,367,273,640,37,677
公投第１６案,臺北市,大安區,龍安里,1267,1290,425,285,710,31,741
公投第１６案,臺北市,大安區,龍安里,1268,1307,455,336,791,32,823
公投第１６案,臺北市,大安區,龍安里,1269,1489,526,337,863,31,894
公投第１６案,臺北市,大安區,錦安里,1270,1097,387,264,651,38,689
公投第１６案,臺北市,大安區,錦安里,1271,1328,448,296,744,39,783
公投第１６案,臺北市,大安區,錦安里,1272,1189,376,278,654,31,685
公投第１６案,臺北市,大安區,錦安里,1273,1270,413,291,704,32,736
公投第１６案,臺北市,大安區,福住里,1274,1349,420,328,748,28,776
公投第１６案,臺北市,大安區,福住里,1275,1292,411,276,687,42,729
公投第１６案,臺北市,大安區,福住里,1276,1314,456,302,758,54,812
公投第１６案,臺北市,大安區,福住里,1277,1200,377,304,681,50,731
公投第１６案,臺北市,大安區,永康里,1278,1558,471,373,844,60,904
公投第１６案,臺北市,大安區,永康里,1279,1561,483,345,828,59,887
公投第１６案,臺北市,大安區,光明里,1280,1446,491,319,810,54,864
公投第１６案,臺北市,大安區,光明里,1281,1499,511,341,852,38,890
公投第１６案,臺北市,大安區,錦泰里,1282,1467,505,323,828,41,869
公投第１６案,臺北市,大安區,錦泰里,1283,1511,504,311,815,39,854
公投第１６案,臺北市,大安區,錦華里,1284,1600,516,367,883,83,966
公投第１６案,臺北市,大安區,錦華里,1285,1573,520,367,887,42,929
公投第１６案,臺北市,大安區,錦華里,1286,1467,528,332,860,43,903
公投第１６案,臺北市,大安區,龍圖里,1287,1358,468,295,763,40,803
公投第１６案,臺北市,大安區,龍圖里,1288,1568,527,320,847,60,907
公投第１６案,臺北市,大安區,龍圖里,1289,1411,464,321,785,56,841
公投第１６案,臺北市,大安區,龍圖里,1290,1554,497,338,835,31,866
公投第１６案,臺北市,大安區,新龍里,1291,1345,489,282,771,49,820
公投第１６案,臺北市,大安區,新龍里,1292,1435,533,278,811,27,838
公投第１６案,臺北市,大安區,新龍里,1293,1481,577,313,890,40,930
公投第１６案,臺北市,大安區,新龍里,1294,1451,559,313,872,32,904
公投第１６案,臺北市,大安區,龍陣里,1295,1566,498,361,859,68,927
公投第１６案,臺北市,大安區,龍陣里,1296,1525,489,359,848,48,896
公投第１６案,臺北市,大安區,龍雲里,1297,1336,421,296,717,47,764
公投第１６案,臺北市,大安區,龍雲里,1298,1483,505,325,830,63,893
公投第１６案,臺北市,大安區,龍雲里,1299,1396,396,291,687,33,720
公投第１６案,臺北市,大安區,龍生里,1300,1406,462,335,797,73,870
公投第１６案,臺北市,大安區,龍生里,1301,1434,482,337,819,50,869
公投第１６案,臺北市,大安區,龍生里,1302,1288,424,292,716,43,759
公投第１６案,臺北市,大安區,龍生里,1303,1407,476,310,786,50,836
公投第１６案,臺北市,大安區,住安里,1304,1514,464,323,787,44,831
公投第１６案,臺北市,大安區,住安里,1305,1550,403,291,694,66,760
公投第１６案,臺北市,大安區,住安里,1306,1490,499,314,813,64,877
公投第１６案,臺北市,大安區,義安里,1307,1284,379,297,676,39,715
公投第１６案,臺北市,大安區,義安里,1308,1129,414,235,649,33,682
公投第１６案,臺北市,大安區,義安里,1309,1193,398,284,682,33,715
公投第１６案,臺北市,大安區,義安里,1310,1057,306,254,560,41,601
公投第１６案,臺北市,大安區,通化里,1311,1361,404,323,727,60,787
公投第１６案,臺北市,大安區,通化里,1312,1412,455,286,741,56,797
公投第１６案,臺北市,大安區,通化里,1313,1423,371,257,628,56,684
公投第１６案,臺北市,大安區,通化里,1314,1257,374,274,648,87,735
公投第１６案,臺北市,大安區,通安里,1315,1133,386,251,637,63,700
公投第１６案,臺北市,大安區,通安里,1316,1077,320,244,564,54,618
公投第１６案,臺北市,大安區,通安里,1317,1300,413,313,726,55,781
公投第１６案,臺北市,大安區,通安里,1318,1319,472,291,763,59,822
公投第１６案,臺北市,大安區,臨江里,1319,1265,402,297,699,80,779
公投第１６案,臺北市,大安區,臨江里,1320,1265,379,261,640,42,682
公投第１６案,臺北市,大安區,臨江里,1321,1103,386,226,612,49,661
公投第１６案,臺北市,大安區,法治里,1322,1341,486,271,757,55,812
公投第１６案,臺北市,大安區,法治里,1323,1357,512,261,773,50,823
公投第１６案,臺北市,大安區,法治里,1324,1260,448,257,705,42,747
公投第１６案,臺北市,大安區,全安里,1325,1295,450,268,718,43,761
公投第１６案,臺北市,大安區,全安里,1326,1399,395,318,713,41,754
公投第１６案,臺北市,大安區,全安里,1327,1150,384,236,620,42,662
公投第１６案,臺北市,大安區,群賢里,1328,1351,436,240,676,40,716
公投第１６案,臺北市,大安區,群賢里,1329,1341,417,309,726,71,797
公投第１６案,臺北市,大安區,群賢里,1330,1129,375,228,603,27,630
公投第１６案,臺北市,大安區,群賢里,1331,1328,480,239,719,42,761
公投第１６案,臺北市,大安區,群英里,1332,1557,647,294,941,43,984
公投第１６案,臺北市,大安區,群英里,1333,1461,553,301,854,56,910
公投第１６案,臺北市,大安區,群英里,1334,1589,524,257,781,39,820
公投第１６案,臺北市,大安區,群英里,1335,1473,536,251,787,46,833
公投第１６案,臺北市,大安區,虎嘯里,1336,1479,454,340,794,42,836
公投第１６案,臺北市,大安區,虎嘯里,1337,833,289,197,486,34,520
公投第１６案,臺北市,大安區,虎嘯里,1338,999,279,235,514,54,568
公投第１６案,臺北市,大安區,臥龍里,1339,1757,305,386,691,56,747
公投第１６案,臺北市,大安區,龍淵里,1340,1573,516,357,873,56,929
公投第１６案,臺北市,大安區,龍淵里,1341,1587,570,371,941,42,983
公投第１６案,臺北市,大安區,龍淵里,1342,1496,482,375,857,59,916
公投第１６案,臺北市,大安區,龍淵里,1343,1440,481,340,821,37,858
公投第１６案,臺北市,大安區,龍淵里,1344,1578,550,343,893,63,956
公投第１６案,臺北市,大安區,龍門里,1345,1223,383,305,688,34,722
公投第１６案,臺北市,大安區,龍門里,1346,1119,342,276,618,32,650
公投第１６案,臺北市,大安區,龍門里,1347,1252,416,308,724,35,759
公投第１６案,臺北市,大安區,大學里,1348,1576,535,358,893,48,941
公投第１６案,臺北市,大安區,大學里,1349,1425,461,325,786,33,819
公投第１６案,臺北市,大安區,大學里,1350,1450,436,320,756,33,789
公投第１６案,臺北市,大安區,大學里,1351,1444,461,311,772,54,826
公投第１６案,臺北市,大安區,大學里,1352,1337,436,362,798,43,841
公投第１６案,臺北市,大安區,芳和里,1353,1417,436,301,737,44,781
公投第１６案,臺北市,大安區,芳和里,1354,1250,398,277,675,58,733
公投第１６案,臺北市,大安區,芳和里,1355,1176,395,235,630,60,690
公投第１６案,臺北市,大安區,芳和里,1356,1257,428,297,725,55,780
公投第１６案,臺北市,大安區,黎元里,1357,1257,400,230,630,58,688
公投第１６案,臺北市,大安區,黎元里,1358,1148,362,273,635,40,675
公投第１６案,臺北市,大安區,黎元里,1359,1418,442,331,773,61,834
公投第１６案,臺北市,大安區,黎元里,1360,1028,322,225,547,35,582
公投第１６案,臺北市,大安區,黎孝里,1361,1445,486,338,824,44,868
公投第１６案,臺北市,大安區,黎孝里,1362,1361,466,291,757,53,810
公投第１６案,臺北市,大安區,黎孝里,1363,1343,484,292,776,55,831
公投第１６案,臺北市,大安區,黎孝里,1364,1267,417,278,695,58,753
公投第１６案,臺北市,大安區,黎孝里,1365,1380,400,307,707,48,755
公投第１６案,臺北市,大安區,黎和里,1366,1524,483,318,801,57,858
公投第１６案,臺北市,大安區,黎和里,1367,1470,501,309,810,61,871
公投第１６案,臺北市,大安區,黎和里,1368,1318,359,257,616,77,693
公投第１６案,臺北市,大安區,建安里,1369,1430,412,297,709,70,779
公投第１６案,臺北市,大安區,建安里,1370,1386,460,288,748,52,800
公投第１６案,臺北市,大安區,建安里,1371,1438,437,283,720,43,763
公投第１６案,臺北市,大安區,建倫里,1372,1270,361,259,620,38,658
公投第１６案,臺北市,大安區,建倫里,1373,1395,416,313,729,52,781
公投第１６案,臺北市,大安區,建倫里,1374,1292,392,303,695,53,748
公投第１６案,臺北市,大安區,建倫里,1375,1310,389,297,686,47,733
公投第１６案,臺北市,大安區,敦安里,1376,1319,391,299,690,53,743
公投第１６案,臺北市,大安區,敦安里,1377,1355,403,348,751,41,792
公投第１６案,臺北市,大安區,敦安里,1378,1312,376,293,669,32,701
公投第１６案,臺北市,大安區,敦安里,1379,1335,451,284,735,27,762
公投第１６案,臺北市,大安區,正聲里,1380,1489,444,306,750,38,788
公投第１６案,臺北市,大安區,正聲里,1381,1307,424,293,717,44,761
公投第１６案,臺北市,大安區,正聲里,1382,1328,382,278,660,40,700
公投第１６案,臺北市,大安區,敦煌里,1383,1277,402,262,664,7,671
公投第１６案,臺北市,大安區,敦煌里,1384,1314,425,280,705,53,758
公投第１６案,臺北市,大安區,敦煌里,1385,1270,433,285,718,53,771
公投第１６案,臺北市,大安區,敦煌里,1386,1308,409,295,704,59,763
公投第１６案,臺北市,大安區,華聲里,1387,1138,388,274,662,27,689
公投第１６案,臺北市,大安區,華聲里,1388,1333,429,268,697,44,741
公投第１６案,臺北市,大安區,華聲里,1389,1176,397,251,648,45,693
公投第１６案,臺北市,大安區,車層里,1390,1311,416,289,705,55,760
公投第１６案,臺北市,大安區,車層里,1391,1295,397,290,687,37,724
公投第１６案,臺北市,大安區,車層里,1392,1421,500,275,775,53,828
公投第１６案,臺北市,大安區,車層里,1393,1409,448,300,748,42,790
公投第１６案,臺北市,大安區,光信里,1394,1434,470,293,763,70,833
公投第１６案,臺北市,大安區,光信里,1395,1449,391,297,688,96,784
公投第１６案,臺北市,大安區,光信里,1396,1284,428,279,707,54,761
公投第１６案,臺北市,大安區,光信里,1397,1248,406,267,673,45,718
公投第１６案,臺北市,大安區,光信里,1398,1119,423,276,699,40,739
公投第１６案,臺北市,大安區,學府里,1399,883,305,190,495,39,534
公投第１６案,臺北市,大安區,學府里,1400,630,204,111,315,46,361
公投第１６案,臺北市,大安區,學府里,1401,814,260,192,452,35,487
公投第１６案,臺北市,文山區,景行里,1402,1539,469,335,804,62,866
公投第１６案,臺北市,文山區,景行里,1403,1548,504,272,776,43,819
公投第１６案,臺北市,文山區,景行里,1404,1493,489,347,836,73,909
公投第１６案,臺北市,文山區,景行里,1405,1648,551,384,935,64,999
公投第１６案,臺北市,文山區,景東里,1406,1544,519,314,833,65,898
公投第１６案,臺北市,文山區,景東里,1407,1557,523,323,846,63,909
公投第１６案,臺北市,文山區,景東里,1408,1514,491,313,804,47,851
公投第１６案,臺北市,文山區,景東里,1409,1540,577,349,926,63,989
公投第１６案,臺北市,文山區,景美里,1410,1466,503,354,857,54,911
公投第１６案,臺北市,文山區,景美里,1411,1444,534,306,840,57,897
公投第１６案,臺北市,文山區,景美里,1412,1455,466,337,803,84,887
公投第１６案,臺北市,文山區,景慶里,1413,1440,462,285,747,61,808
公投第１６案,臺北市,文山區,景慶里,1414,1398,483,315,798,69,867
公投第１６案,臺北市,文山區,景慶里,1415,1412,443,311,754,30,784
公投第１６案,臺北市,文山區,景慶里,1416,1426,451,314,765,63,828
公投第１６案,臺北市,文山區,景仁里,1417,1437,447,336,783,61,844
公投第１６案,臺北市,文山區,景仁里,1418,1340,413,327,740,73,813
公投第１６案,臺北市,文山區,景仁里,1419,1568,530,332,862,46,908
公投第１６案,臺北市,文山區,景華里,1420,1372,462,294,756,47,803
公投第１６案,臺北市,文山區,景華里,1421,1046,336,236,572,40,612
公投第１６案,臺北市,文山區,景華里,1422,1274,445,277,722,50,772
公投第１６案,臺北市,文山區,景華里,1423,1324,453,289,742,40,782
公投第１６案,臺北市,文山區,萬有里,1424,1722,573,364,937,76,1013
公投第１６案,臺北市,文山區,萬有里,1425,1737,632,345,977,67,1044
公投第１６案,臺北市,文山區,萬有里,1426,1370,523,310,833,28,861
公投第１６案,臺北市,文山區,萬祥里,1427,1495,497,308,805,78,883
公投第１６案,臺北市,文山區,萬祥里,1428,1328,447,283,730,71,801
公投第１６案,臺北市,文山區,萬祥里,1429,1138,387,260,647,61,708
公投第１６案,臺北市,文山區,萬隆里,1430,1471,559,296,855,37,892
公投第１６案,臺北市,文山區,萬隆里,1431,1144,403,281,684,33,717
公投第１６案,臺北市,文山區,萬隆里,1432,1176,437,267,704,57,761
公投第１６案,臺北市,文山區,萬隆里,1433,1212,430,290,720,54,774
公投第１６案,臺北市,文山區,萬隆里,1434,1214,420,297,717,49,766
公投第１６案,臺北市,文山區,萬年里,1435,1170,361,264,625,50,675
公投第１６案,臺北市,文山區,萬年里,1436,1308,434,311,745,59,804
公投第１６案,臺北市,文山區,萬年里,1437,1190,405,262,667,62,729
公投第１６案,臺北市,文山區,萬年里,1438,1110,385,249,634,58,692
公投第１６案,臺北市,文山區,萬和里,1439,1512,524,311,835,56,891
公投第１６案,臺北市,文山區,萬和里,1440,1387,551,253,804,61,865
公投第１６案,臺北市,文山區,萬盛里,1441,1355,459,303,762,53,815
公投第１６案,臺北市,文山區,萬盛里,1442,1370,442,312,754,76,830
公投第１６案,臺北市,文山區,萬盛里,1443,1484,485,332,817,70,887
公投第１６案,臺北市,文山區,興豐里,1444,1786,576,392,968,86,1054
公投第１６案,臺北市,文山區,興豐里,1445,1260,443,265,708,62,770
公投第１６案,臺北市,文山區,興豐里,1446,1194,471,269,740,39,779
公投第１６案,臺北市,文山區,興邦里,1447,1444,472,331,803,69,872
公投第１６案,臺北市,文山區,興邦里,1448,1495,534,311,845,55,900
公投第１６案,臺北市,文山區,興邦里,1449,1446,560,264,824,68,892
公投第１６案,臺北市,文山區,興光里,1450,1450,458,312,770,88,858
公投第１６案,臺北市,文山區,興光里,1451,1486,539,311,850,60,910
公投第１６案,臺北市,文山區,興家里,1452,1259,416,294,710,43,753
公投第１６案,臺北市,文山區,興家里,1453,1317,478,293,771,36,807
公投第１６案,臺北市,文山區,興家里,1454,1321,461,321,782,46,828
公投第１６案,臺北市,文山區,興家里,1455,1475,511,303,814,53,867
公投第１６案,臺北市,文山區,興家里,1456,1271,426,262,688,49,737
公投第１６案,臺北市,文山區,興得里,1457,1609,542,376,918,53,971
公投第１６案,臺北市,文山區,興得里,1458,1501,501,284,785,42,827
公投第１６案,臺北市,文山區,興得里,1459,997,314,187,501,48,549
公投第１６案,臺北市,文山區,興得里,1460,1052,396,241,637,49,686
公投第１６案,臺北市,文山區,興業里,1461,1247,459,268,727,40,767
公投第１６案,臺北市,文山區,興業里,1462,1167,405,257,662,62,724
公投第１６案,臺北市,文山區,興業里,1463,1280,478,264,742,43,785
公投第１６案,臺北市,文山區,興業里,1464,1153,404,276,680,37,717
公投第１６案,臺北市,文山區,興安里,1465,1557,540,356,896,59,955
公投第１６案,臺北市,文山區,興安里,1466,1444,521,284,805,71,876
公投第１６案,臺北市,文山區,興安里,1467,1459,593,291,884,58,942
公投第１６案,臺北市,文山區,興安里,1468,1357,514,307,821,49,870
公投第１６案,臺北市,文山區,興福里,1469,1194,437,309,746,52,798
公投第１６案,臺北市,文山區,興福里,1470,1184,408,285,693,63,756
公投第１６案,臺北市,文山區,興福里,1471,1119,405,268,673,48,721
公投第１６案,臺北市,文山區,興福里,1472,1350,458,322,780,74,854
公投第１６案,臺北市,文山區,興旺里,1473,1502,466,317,783,63,846
公投第１６案,臺北市,文山區,興旺里,1474,1511,524,307,831,74,905
公投第１６案,臺北市,文山區,興旺里,1475,1481,534,357,891,48,939
公投第１６案,臺北市,文山區,興旺里,1476,1477,553,327,880,58,938
公投第１６案,臺北市,文山區,興旺里,1477,1294,441,310,751,54,805
公投第１６案,臺北市,文山區,興泰里,1478,1040,408,270,678,32,710
公投第１６案,臺北市,文山區,興泰里,1479,1323,484,293,777,58,835
公投第１６案,臺北市,文山區,興泰里,1480,1153,393,267,660,57,717
公投第１６案,臺北市,文山區,興昌里,1481,1525,551,289,840,67,907
公投第１６案,臺北市,文山區,興昌里,1482,1412,441,280,721,59,780
公投第１６案,臺北市,文山區,興昌里,1483,1473,540,353,893,44,937
公投第１６案,臺北市,文山區,興昌里,1484,1486,517,336,853,47,900
公投第１６案,臺北市,文山區,試院里,1485,1616,628,326,954,61,1015
公投第１６案,臺北市,文山區,試院里,1486,1489,538,343,881,71,952
公投第１６案,臺北市,文山區,試院里,1487,1414,493,286,779,68,847
公投第１６案,臺北市,文山區,試院里,1488,1494,538,356,894,68,962
公投第１６案,臺北市,文山區,華興里,1489,1547,531,357,888,72,960
公投第１６案,臺北市,文山區,華興里,1490,1587,550,351,901,69,970
公投第１６案,臺北市,文山區,華興里,1491,1515,605,322,927,45,972
公投第１６案,臺北市,文山區,華興里,1492,1573,594,332,926,61,987
公投第１６案,臺北市,文山區,華興里,1493,1542,572,343,915,48,963
公投第１６案,臺北市,文山區,明義里,1494,1465,465,266,731,71,802
公投第１６案,臺北市,文山區,明義里,1495,699,177,126,303,42,345
公投第１６案,臺北市,文山區,明義里,1496,1372,377,260,637,70,707
公投第１６案,臺北市,文山區,明興里,1497,1448,408,289,697,59,756
公投第１６案,臺北市,文山區,明興里,1498,1548,499,373,872,49,921
公投第１６案,臺北市,文山區,明興里,1499,1501,480,363,843,59,902
公投第１６案,臺北市,文山區,明興里,1500,1560,583,310,893,55,948
公投第１６案,臺北市,文山區,木柵里,1501,1567,548,320,868,52,920
公投第１６案,臺北市,文山區,木柵里,1502,1554,530,332,862,58,920
公投第１６案,臺北市,文山區,木柵里,1503,1544,535,317,852,65,917
公投第１６案,臺北市,文山區,木柵里,1504,1528,614,260,874,51,925
公投第１６案,臺北市,文山區,木柵里,1505,1543,587,327,914,48,962
公投第１６案,臺北市,文山區,木新里,1506,2754,544,345,889,72,961
公投第１６案,臺北市,文山區,木新里,1507,1709,488,308,796,98,894
公投第１６案,臺北市,文山區,木新里,1508,1515,445,346,791,81,872
公投第１６案,臺北市,文山區,木新里,1509,1571,490,316,806,69,875
公投第１６案,臺北市,文山區,木新里,1510,1578,505,333,838,75,913
公投第１６案,臺北市,文山區,順興里,1511,1454,536,235,771,52,823
公投第１６案,臺北市,文山區,順興里,1512,1436,505,291,796,63,859
公投第１６案,臺北市,文山區,順興里,1513,1402,493,334,827,60,887
公投第１６案,臺北市,文山區,順興里,1514,1117,381,257,638,53,691
公投第１６案,臺北市,文山區,順興里,1515,1094,353,234,587,63,650
公投第１６案,臺北市,文山區,忠順里,1516,1070,426,206,632,57,689
公投第１６案,臺北市,文山區,忠順里,1517,1319,521,283,804,43,847
公投第１６案,臺北市,文山區,忠順里,1518,1226,459,283,742,52,794
公投第１６案,臺北市,文山區,樟林里,1519,1385,466,277,743,53,796
公投第１６案,臺北市,文山區,樟林里,1520,1416,499,298,797,62,859
公投第１６案,臺北市,文山區,樟林里,1521,1412,530,315,845,63,908
公投第１６案,臺北市,文山區,樟林里,1522,1535,471,342,813,71,884
公投第１６案,臺北市,文山區,樟林里,1523,1654,640,351,991,62,1053
公投第１６案,臺北市,文山區,樟新里,1524,1156,428,257,685,43,728
公投第１６案,臺北市,文山區,樟新里,1525,1231,447,239,686,46,732
公投第１６案,臺北市,文山區,樟新里,1526,1218,400,282,682,46,728
公投第１６案,臺北市,文山區,樟新里,1527,1176,456,268,724,36,760
公投第１６案,臺北市,文山區,樟文里,1528,1392,472,342,814,4,818
公投第１６案,臺北市,文山區,樟文里,1529,1323,410,292,702,87,789
公投第１６案,臺北市,文山區,樟文里,1530,1297,421,279,700,48,748
公投第１６案,臺北市,文山區,樟文里,1531,1296,460,290,750,63,813
公投第１６案,臺北市,文山區,樟腳里,1532,1613,514,359,873,62,935
公投第１６案,臺北市,文山區,樟腳里,1533,1697,577,367,944,91,1035
公投第１６案,臺北市,文山區,樟腳里,1534,1579,496,375,871,75,946
公投第１６案,臺北市,文山區,樟樹里,1535,1320,484,303,787,59,846
公投第１６案,臺北市,文山區,樟樹里,1536,1438,476,304,780,49,829
公投第１６案,臺北市,文山區,樟樹里,1537,1465,453,294,747,37,784
公投第１６案,臺北市,文山區,萬芳里,1538,1646,531,390,921,72,993
公投第１６案,臺北市,文山區,萬芳里,1539,1286,425,299,724,60,784
公投第１６案,臺北市,文山區,萬芳里,1540,1219,431,272,703,46,749
公投第１６案,臺北市,文山區,萬芳里,1541,1292,463,304,767,45,812
公投第１６案,臺北市,文山區,萬芳里,1542,1489,481,310,791,64,855
公投第１６案,臺北市,文山區,萬美里,1543,1611,562,355,917,67,984
公投第１６案,臺北市,文山區,萬美里,1544,1549,423,227,650,65,715
公投第１６案,臺北市,文山區,萬美里,1545,1678,545,339,884,65,949
公投第１６案,臺北市,文山區,萬美里,1546,1660,529,354,883,72,955
公投第１６案,臺北市,文山區,博嘉里,1547,1816,516,343,859,51,910
公投第１６案,臺北市,文山區,博嘉里,1548,985,267,260,527,42,569
公投第１６案,臺北市,文山區,博嘉里,1549,1314,507,269,776,32,808
公投第１６案,臺北市,文山區,博嘉里,1550,1018,382,230,612,50,662
公投第１６案,臺北市,文山區,萬興里,1551,1578,560,331,891,52,943
公投第１６案,臺北市,文山區,萬興里,1552,1457,502,304,806,52,858
公投第１６案,臺北市,文山區,萬興里,1553,1326,485,275,760,49,809
公投第１６案,臺北市,文山區,萬興里,1554,1393,495,301,796,65,861
公投第１６案,臺北市,文山區,萬興里,1555,1377,411,322,733,56,789
公投第１６案,臺北市,文山區,政大里,1556,1448,452,357,809,59,868
公投第１６案,臺北市,文山區,政大里,1557,1447,529,338,867,54,921
公投第１６案,臺北市,文山區,政大里,1558,1739,652,412,1064,68,1132
公投第１６案,臺北市,文山區,政大里,1559,1457,511,322,833,48,881
公投第１６案,臺北市,文山區,指南里,1560,1288,438,297,735,60,795
公投第１６案,臺北市,文山區,指南里,1561,1301,360,286,646,67,713
公投第１６案,臺北市,文山區,指南里,1562,865,220,179,399,75,474
公投第１６案,臺北市,文山區,老泉里,1563,789,218,183,401,39,440
公投第１６案,高雄市,桃源區,梅山里,1,264,48,34,82,1,83
公投第１６案,高雄市,桃源區,拉芙蘭里,2,233,96,58,154,17,171
公投第１６案,高雄市,桃源區,復興里,3,279,101,67,168,8,176
公投第１６案,高雄市,桃源區,勤和里,4,223,52,55,107,6,113
公投第１６案,高雄市,桃源區,桃源里,5,783,196,112,308,17,325
公投第１６案,高雄市,桃源區,高中里,6,632,144,89,233,12,245
公投第１６案,高雄市,桃源區,建山里,7,612,246,129,375,40,415
公投第１６案,高雄市,桃源區,寶山里,8,472,141,88,229,21,250
公投第１６案,高雄市,那瑪夏區,達卡努瓦里,9,741,176,120,296,47,343
公投第１６案,高雄市,那瑪夏區,達卡努瓦里,10,585,211,125,336,81,417
公投第１６案,高雄市,那瑪夏區,瑪雅里,11,609,270,133,403,63,466
公投第１６案,高雄市,那瑪夏區,南沙魯里,12,489,88,69,157,10,167
公投第１６案,高雄市,甲仙區,東安里,13,472,97,61,158,9,167
公投第１６案,高雄市,甲仙區,西安里,14,882,284,191,475,77,552
公投第１６案,高雄市,甲仙區,和安里,15,668,177,127,304,48,352
公投第１６案,高雄市,甲仙區,大田里,16,1581,381,276,657,137,794
公投第１６案,高雄市,甲仙區,寶隆里,17,673,121,80,201,12,213
公投第１６案,高雄市,甲仙區,關山里,18,607,141,101,242,42,284
公投第１６案,高雄市,甲仙區,小林里,19,534,128,98,226,25,251
公投第１６案,高雄市,六龜區,新威里,20,760,196,143,339,35,374
公投第１６案,高雄市,六龜區,新興里,21,666,159,101,260,49,309
公投第１６案,高雄市,六龜區,新寮里,22,704,212,129,341,58,399
公投第１６案,高雄市,六龜區,新發里,23,1003,257,193,450,60,510
公投第１６案,高雄市,六龜區,荖濃里,24,1382,333,208,541,114,655
公投第１６案,高雄市,六龜區,六龜里,25,986,207,133,340,74,414
公投第１６案,高雄市,六龜區,義寶里,26,1046,284,189,473,52,525
公投第１６案,高雄市,六龜區,興龍里,27,812,181,137,318,62,380
公投第１６案,高雄市,六龜區,中興里,28,1431,338,251,589,72,661
公投第１６案,高雄市,六龜區,寶來里,29,912,254,151,405,71,476
公投第１６案,高雄市,六龜區,文武里,30,1472,321,203,524,51,575
公投第１６案,高雄市,六龜區,大津里,31,327,63,52,115,29,144
公投第１６案,高雄市,杉林區,杉林里,32,640,161,98,259,55,314
公投第１６案,高雄市,杉林區,木梓里,33,696,146,128,274,28,302
公投第１６案,高雄市,杉林區,集來里,34,1284,223,175,398,59,457
公投第１６案,高雄市,杉林區,新庄里,35,1027,221,178,399,39,438
公投第１６案,高雄市,杉林區,新庄里,36,482,126,65,191,35,226
公投第１６案,高雄市,杉林區,上平里,37,1627,444,343,787,115,902
公投第１６案,高雄市,杉林區,月眉里,38,1630,435,242,677,46,723
公投第１６案,高雄市,杉林區,大愛里,39,973,198,123,321,29,350
公投第１６案,高雄市,杉林區,大愛里,40,987,201,159,360,31,391
公投第１６案,高雄市,杉林區,月美里,41,1261,355,225,580,84,664
公投第１６案,高雄市,內門區,溝坪里,42,969,211,163,374,65,439
公投第１６案,高雄市,內門區,金竹里,43,652,130,94,224,23,247
公投第１６案,高雄市,內門區,永富里,44,961,262,168,430,82,512
公投第１６案,高雄市,內門區,永吉里,45,426,96,66,162,8,170
公投第１６案,高雄市,內門區,永興里,46,398,97,68,165,17,182
公投第１６案,高雄市,內門區,石坑里,47,508,131,68,199,19,218
公投第１６案,高雄市,內門區,內門里,48,980,312,196,508,66,574
公投第１６案,高雄市,內門區,內豊里,49,1225,269,208,477,60,537
公投第１６案,高雄市,內門區,觀亭里,50,1722,465,322,787,159,946
公投第１６案,高雄市,內門區,中埔里,51,560,130,110,240,35,275
公投第１６案,高雄市,內門區,內東里,52,801,180,116,296,22,318
公投第１６案,高雄市,內門區,內南里,53,423,103,92,195,21,216
公投第１６案,高雄市,內門區,東埔里,54,497,115,89,204,32,236
公投第１６案,高雄市,內門區,三平里,55,677,173,109,282,33,315
公投第１６案,高雄市,內門區,木柵里,56,593,110,72,182,15,197
公投第１６案,高雄市,內門區,內興里,57,597,111,82,193,54,247
公投第１６案,高雄市,內門區,瑞山里,58,343,86,43,129,14,143
公投第１６案,高雄市,內門區,光興里,59,670,190,124,314,53,367
公投第１６案,高雄市,旗山區,太平里,60,1060,358,226,584,51,635
公投第１６案,高雄市,旗山區,太平里,61,1125,305,214,519,71,590
公投第１６案,高雄市,旗山區,大德里,62,1100,387,223,610,41,651
公投第１６案,高雄市,旗山區,大德里,63,1238,417,276,693,28,721
公投第１６案,高雄市,旗山區,湄洲里,64,933,315,191,506,25,531
公投第１６案,高雄市,旗山區,湄洲里,65,727,190,144,334,18,352
公投第１６案,高雄市,旗山區,圓富里,66,1071,345,201,546,51,597
公投第１６案,高雄市,旗山區,圓富里,67,744,218,136,354,32,386
公投第１６案,高雄市,旗山區,中正里,68,1100,277,204,481,37,518
公投第１６案,高雄市,旗山區,中正里,69,369,103,67,170,23,193
公投第１６案,高雄市,旗山區,大林里,70,888,217,149,366,20,386
公投第１６案,高雄市,旗山區,大林里,71,510,113,82,195,9,204
公投第１６案,高雄市,旗山區,上洲里,72,1042,322,235,557,91,648
公投第１６案,高雄市,旗山區,新光里,73,791,235,143,378,53,431
公投第１６案,高雄市,旗山區,南勝里,74,939,308,182,490,79,569
公投第１６案,高雄市,旗山區,南勝里,75,1218,311,246,557,45,602
公投第１６案,高雄市,旗山區,中寮里,76,178,54,24,78,19,97
公投第１６案,高雄市,旗山區,東平里,77,946,317,213,530,59,589
公投第１６案,高雄市,旗山區,東平里,78,1025,295,216,511,46,557
公投第１６案,高雄市,旗山區,東昌里,79,1040,354,198,552,148,700
公投第１６案,高雄市,旗山區,竹峰里,80,900,304,217,521,56,577
公投第１６案,高雄市,旗山區,竹峰里,81,663,199,112,311,24,335
公投第１６案,高雄市,旗山區,瑞吉里,82,954,285,186,471,63,534
公投第１６案,高雄市,旗山區,瑞吉里,83,1060,309,222,531,32,563
公投第１６案,高雄市,旗山區,永和里,84,1110,360,240,600,64,664
公投第１６案,高雄市,旗山區,永和里,85,1062,345,218,563,68,631
公投第１６案,高雄市,旗山區,永和里,86,1151,369,223,592,48,640
公投第１６案,高雄市,旗山區,三協里,87,266,69,71,140,25,165
公投第１６案,高雄市,旗山區,三協里,88,633,204,139,343,43,386
公投第１６案,高雄市,旗山區,三協里,89,1307,365,221,586,44,630
公投第１６案,高雄市,旗山區,鯤洲里,90,754,188,161,349,73,422
公投第１６案,高雄市,旗山區,大山里,91,1296,362,284,646,103,749
公投第１６案,高雄市,旗山區,中洲里,92,839,215,147,362,16,378
公投第１６案,高雄市,旗山區,南洲里,93,1329,427,264,691,59,750
公投第１６案,高雄市,旗山區,廣福里,94,628,211,127,338,34,372
公投第１６案,高雄市,美濃區,福安里,95,1175,326,271,597,94,691
公投第１６案,高雄市,美濃區,福安里,96,1438,390,259,649,43,692
公投第１６案,高雄市,美濃區,合和里,97,989,255,197,452,53,505
公投第１６案,高雄市,美濃區,合和里,98,1427,430,316,746,80,826
公投第１６案,高雄市,美濃區,祿興里,99,1309,403,270,673,64,737
公投第１６案,高雄市,美濃區,祿興里,100,1263,389,316,705,64,769
公投第１６案,高雄市,美濃區,中壇里,101,997,312,203,515,82,597
公投第１６案,高雄市,美濃區,中壇里,102,1064,334,217,551,62,613
公投第１６案,高雄市,美濃區,德興里,103,1498,444,285,729,88,817
公投第１６案,高雄市,美濃區,龍山里,104,1119,330,236,566,90,656
公投第１６案,高雄市,美濃區,龍山里,105,1031,322,216,538,60,598
公投第１６案,高雄市,美濃區,獅山里,106,1437,411,273,684,83,767
公投第１６案,高雄市,美濃區,獅山里,107,1071,342,205,547,62,609
公投第１６案,高雄市,美濃區,龍肚里,108,687,208,140,348,38,386
公投第１６案,高雄市,美濃區,龍肚里,109,775,175,121,296,22,318
公投第１６案,高雄市,美濃區,廣德里,110,1353,355,265,620,79,699
公投第１６案,高雄市,美濃區,興隆里,111,1191,313,234,547,45,592
公投第１６案,高雄市,美濃區,中圳里,112,906,245,142,387,47,434
公投第１６案,高雄市,美濃區,中圳里,113,1178,386,248,634,60,694
公投第１６案,高雄市,美濃區,東門里,114,1252,353,207,560,33,593
公投第１６案,高雄市,美濃區,泰安里,115,1549,476,315,791,70,861
公投第１６案,高雄市,美濃區,瀰濃里,116,1088,311,193,504,50,554
公投第１６案,高雄市,美濃區,瀰濃里,117,1116,363,224,587,48,635
公投第１６案,高雄市,美濃區,清水里,118,977,305,182,487,41,528
公投第１６案,高雄市,美濃區,清水里,119,816,259,178,437,74,511
公投第１６案,高雄市,美濃區,吉洋里,120,955,266,133,399,32,431
公投第１６案,高雄市,美濃區,吉洋里,121,943,295,187,482,68,550
公投第１６案,高雄市,美濃區,吉和里,122,1371,397,254,651,56,707
公投第１６案,高雄市,美濃區,吉東里,123,919,263,190,453,62,515
公投第１６案,高雄市,美濃區,吉東里,124,915,304,206,510,53,563
公投第１６案,高雄市,美濃區,廣林里,125,828,214,171,385,71,456
公投第１６案,高雄市,美濃區,廣林里,126,674,134,113,247,72,319
公投第１６案,高雄市,茂林區,多納里,127,507,195,128,323,33,356
公投第１６案,高雄市,茂林區,萬山里,128,382,159,77,236,25,261
公投第１６案,高雄市,茂林區,茂林里,129,726,283,147,430,22,452
公投第１６案,高雄市,茄萣區,福德里,130,976,237,183,420,22,442
公投第１６案,高雄市,茄萣區,萬福里,131,887,255,163,418,67,485
公投第１６案,高雄市,茄萣區,白雲里,132,1710,457,343,800,49,849
公投第１６案,高雄市,茄萣區,嘉賜里,133,1280,267,242,509,53,562
公投第１６案,高雄市,茄萣區,嘉賜里,134,1314,413,272,685,42,727
公投第１６案,高雄市,茄萣區,嘉賜里,135,1157,370,279,649,37,686
公投第１６案,高雄市,茄萣區,嘉安里,136,1785,497,366,863,121,984
公投第１６案,高雄市,茄萣區,嘉樂里,137,838,213,178,391,98,489
公投第１６案,高雄市,茄萣區,嘉樂里,138,1249,400,314,714,83,797
公投第１６案,高雄市,茄萣區,嘉泰里,139,1116,300,213,513,97,610
公投第１６案,高雄市,茄萣區,嘉福里,140,978,228,194,422,56,478
公投第１６案,高雄市,茄萣區,和協里,141,1125,290,171,461,40,501
公投第１６案,高雄市,茄萣區,嘉定里,142,1139,298,260,558,65,623
公投第１６案,高雄市,茄萣區,保定里,143,1363,365,278,643,111,754
公投第１６案,高雄市,茄萣區,保定里,144,1598,457,362,819,114,933
公投第１６案,高雄市,茄萣區,大定里,145,1111,295,224,519,74,593
公投第１６案,高雄市,茄萣區,光定里,146,925,219,159,378,45,423
公投第１６案,高雄市,茄萣區,吉定里,147,1148,315,225,540,75,615
公投第１６案,高雄市,茄萣區,崎漏里,148,1353,200,424,624,46,670
公投第１６案,高雄市,茄萣區,崎漏里,149,1331,373,272,645,76,721
公投第１６案,高雄市,茄萣區,崎漏里,150,1829,476,331,807,83,890
公投第１６案,高雄市,湖內區,海山里,151,1112,327,204,531,29,560
公投第１６案,高雄市,湖內區,劉家里,152,1017,285,207,492,91,583
公投第１６案,高雄市,湖內區,太爺里,153,796,204,174,378,33,411
公投第１６案,高雄市,湖內區,公舘里,154,1079,355,256,611,38,649
公投第１６案,高雄市,湖內區,公舘里,155,1115,325,255,580,34,614
公投第１６案,高雄市,湖內區,葉厝里,156,1311,375,266,641,45,686
公投第１６案,高雄市,湖內區,葉厝里,157,1319,385,255,640,48,688
公投第１６案,高雄市,湖內區,大湖里,158,1244,406,306,712,77,789
公投第１６案,高雄市,湖內區,大湖里,159,1227,426,284,710,57,767
公投第１６案,高雄市,湖內區,大湖里,160,1163,404,241,645,67,712
公投第１６案,高雄市,湖內區,田尾里,161,981,321,229,550,41,591
公投第１６案,高雄市,湖內區,湖內里,162,780,243,141,384,20,404
公投第１６案,高雄市,湖內區,湖內里,163,832,250,168,418,56,474
公投第１６案,高雄市,湖內區,湖內里,164,1017,355,244,599,41,640
公投第１６案,高雄市,湖內區,湖內里,165,1051,338,227,565,37,602
公投第１６案,高雄市,湖內區,海埔里,166,941,265,192,457,39,496
公投第１６案,高雄市,湖內區,海埔里,167,863,229,189,418,62,480
公投第１６案,高雄市,湖內區,文賢里,168,1160,340,244,584,47,631
公投第１６案,高雄市,湖內區,中賢里,169,1090,255,180,435,27,462
公投第１６案,高雄市,湖內區,中賢里,170,1122,318,262,580,66,646
公投第１６案,高雄市,湖內區,逸賢里,171,1123,286,187,473,35,508
公投第１６案,高雄市,湖內區,忠興里,172,684,170,155,325,35,360
公投第１６案,高雄市,湖內區,湖東里,173,1249,335,239,574,39,613
公投第１６案,高雄市,湖內區,湖東里,174,1453,382,270,652,65,717
公投第１６案,高雄市,路竹區,竹滬里,175,1026,300,194,494,32,526
公投第１６案,高雄市,路竹區,竹滬里,176,1069,328,226,554,74,628
公投第１６案,高雄市,路竹區,竹滬里,177,1127,352,262,614,77,691
公投第１６案,高雄市,路竹區,頂寮里,178,1179,357,240,597,75,672
公投第１６案,高雄市,路竹區,新達里,179,1237,351,247,598,104,702
公投第１６案,高雄市,路竹區,後鄉里,180,1096,356,234,590,66,656
公投第１６案,高雄市,路竹區,北嶺里,181,1272,423,294,717,82,799
公投第１６案,高雄市,路竹區,社西里,182,1182,386,243,629,70,699
公投第１６案,高雄市,路竹區,社西里,183,1127,374,223,597,55,652
公投第１６案,高雄市,路竹區,甲北里,184,956,303,214,517,56,573
公投第１６案,高雄市,路竹區,甲北里,185,1132,354,238,592,72,664
公投第１６案,高雄市,路竹區,甲南里,186,1025,332,229,561,95,656
公投第１６案,高雄市,路竹區,甲南里,187,1007,262,247,509,35,544
公投第１６案,高雄市,路竹區,甲南里,188,1301,388,236,624,70,694
公投第１６案,高雄市,路竹區,下坑里,189,885,265,205,470,39,509
公投第１６案,高雄市,路竹區,下坑里,190,837,207,168,375,20,395
公投第１６案,高雄市,路竹區,下坑里,191,930,290,210,500,65,565
公投第１６案,高雄市,路竹區,竹園里,192,781,196,156,352,52,404
公投第１６案,高雄市,路竹區,竹園里,193,1023,297,238,535,74,609
公投第１６案,高雄市,路竹區,竹東里,194,1763,562,399,961,83,1044
公投第１６案,高雄市,路竹區,竹東里,195,1637,477,383,860,57,917
公投第１６案,高雄市,路竹區,竹西里,196,1070,295,236,531,63,594
公投第１６案,高雄市,路竹區,竹西里,197,1177,384,272,656,61,717
公投第１６案,高雄市,路竹區,文北里,198,1007,293,239,532,60,592
公投第１６案,高雄市,路竹區,文北里,199,1026,302,240,542,48,590
公投第１６案,高雄市,路竹區,文北里,200,1017,326,210,536,60,596
公投第１６案,高雄市,路竹區,文南里,201,1264,410,280,690,52,742
公投第１６案,高雄市,路竹區,文南里,202,1089,342,244,586,74,660
公投第１６案,高雄市,路竹區,三爺里,203,851,304,158,462,38,500
公投第１６案,高雄市,路竹區,鴨寮里,204,1011,307,233,540,91,631
公投第１６案,高雄市,路竹區,鴨寮里,205,937,339,231,570,33,603
公投第１６案,高雄市,路竹區,社東里,206,820,213,147,360,19,379
公投第１６案,高雄市,路竹區,社東里,207,910,275,259,534,35,569
公投第１６案,高雄市,路竹區,社中里,208,867,249,187,436,58,494
公投第１６案,高雄市,路竹區,竹南里,209,937,280,225,505,32,537
公投第１６案,高雄市,路竹區,竹南里,210,900,279,212,491,27,518
公投第１６案,高雄市,路竹區,竹南里,211,900,309,198,507,48,555
公投第１６案,高雄市,路竹區,社南里,212,918,308,201,509,44,553
公投第１６案,高雄市,路竹區,社南里,213,870,282,236,518,40,558
公投第１６案,高雄市,路竹區,社南里,214,1150,403,260,663,57,720
公投第１６案,高雄市,路竹區,社南里,215,1537,567,344,911,72,983
公投第１６案,高雄市,阿蓮區,石安里,216,1299,301,267,568,40,608
公投第１６案,高雄市,阿蓮區,中路里,217,1107,296,256,552,36,588
公投第１６案,高雄市,阿蓮區,中路里,218,898,228,180,408,38,446
公投第１６案,高雄市,阿蓮區,峯山里,219,1259,349,262,611,79,690
公投第１６案,高雄市,阿蓮區,港後里,220,1579,420,346,766,58,824
公投第１６案,高雄市,阿蓮區,港後里,221,564,179,130,309,13,322
公投第１６案,高雄市,阿蓮區,崗山里,222,768,269,177,446,50,496
公投第１６案,高雄市,阿蓮區,阿蓮里,223,1092,304,284,588,51,639
公投第１６案,高雄市,阿蓮區,阿蓮里,224,1099,309,252,561,67,628
公投第１６案,高雄市,阿蓮區,阿蓮里,225,1134,376,221,597,37,634
公投第１６案,高雄市,阿蓮區,阿蓮里,226,1561,519,229,748,34,782
公投第１６案,高雄市,阿蓮區,清蓮里,227,1533,429,352,781,120,901
公投第１６案,高雄市,阿蓮區,清蓮里,228,1116,300,223,523,37,560
公投第１６案,高雄市,阿蓮區,和蓮里,229,1054,287,224,511,50,561
公投第１６案,高雄市,阿蓮區,和蓮里,230,1260,372,247,619,63,682
公投第１６案,高雄市,阿蓮區,青旗里,231,1504,409,309,718,78,796
公投第１６案,高雄市,阿蓮區,復安里,232,848,197,185,382,24,406
公投第１６案,高雄市,阿蓮區,復安里,233,823,228,170,398,27,425
公投第１６案,高雄市,阿蓮區,玉庫里,234,1021,295,225,520,39,559
公投第１６案,高雄市,阿蓮區,南蓮里,235,1715,469,320,789,60,849
公投第１６案,高雄市,阿蓮區,南蓮里,236,1300,354,266,620,65,685
公投第１６案,高雄市,田寮區,鹿埔里,237,369,91,54,145,8,153
公投第１６案,高雄市,田寮區,南安里,238,656,164,94,258,19,277
公投第１６案,高雄市,田寮區,南安里,239,406,64,50,114,10,124
公投第１６案,高雄市,田寮區,大同里,240,380,97,75,172,21,193
公投第１６案,高雄市,田寮區,田寮里,241,379,112,69,181,14,195
公投第１６案,高雄市,田寮區,七星里,242,625,185,114,299,56,355
公投第１６案,高雄市,田寮區,崇德里,243,946,241,180,421,26,447
公投第１６案,高雄市,田寮區,西德里,244,794,206,130,336,43,379
公投第１６案,高雄市,田寮區,三和里,245,382,96,52,148,21,169
公投第１６案,高雄市,田寮區,古亭里,246,513,87,57,144,55,199
公投第１６案,高雄市,田寮區,新興里,247,601,159,117,276,18,294
公投第１６案,高雄市,田寮區,新興里,248,620,188,109,297,63,360
公投第１６案,高雄市,永安區,永安里,249,756,282,167,449,53,502
公投第１６案,高雄市,永安區,永安里,250,818,264,180,444,72,516
公投第１６案,高雄市,永安區,永華里,251,866,321,229,550,46,596
公投第１６案,高雄市,永安區,永華里,252,951,337,199,536,79,615
公投第１６案,高雄市,永安區,新港里,253,992,335,225,560,65,625
公投第１６案,高雄市,永安區,新港里,254,682,165,121,286,24,310
公投第１６案,高雄市,永安區,新港里,255,665,199,154,353,28,381
公投第１６案,高雄市,永安區,鹽田里,256,371,122,63,185,19,204
公投第１６案,高雄市,永安區,保寧里,257,1114,391,272,663,68,731
公投第１６案,高雄市,永安區,保寧里,258,1418,503,327,830,49,879
公投第１６案,高雄市,永安區,維新里,259,1477,524,340,864,98,962
公投第１６案,高雄市,永安區,維新里,260,1891,660,430,1090,98,1188
公投第１６案,高雄市,岡山區,岡山里,261,1345,533,300,833,50,883
公投第１６案,高雄市,岡山區,岡山里,262,1045,237,214,451,24,475
公投第１６案,高雄市,岡山區,岡山里,263,1051,354,241,595,44,639
公投第１６案,高雄市,岡山區,岡山里,264,917,301,218,519,23,542
公投第１６案,高雄市,岡山區,壽天里,265,934,337,229,566,41,607
公投第１６案,高雄市,岡山區,壽天里,266,1097,412,231,643,49,692
公投第１６案,高雄市,岡山區,壽天里,267,1208,473,284,757,48,805
公投第１６案,高雄市,岡山區,平安里,268,1159,405,292,697,71,768
公投第１６案,高雄市,岡山區,維仁里,269,1018,336,230,566,56,622
公投第１６案,高雄市,岡山區,大遼里,270,1316,371,265,636,43,679
公投第１６案,高雄市,岡山區,程香里,271,1345,453,282,735,39,774
公投第１６案,高雄市,岡山區,程香里,272,1295,469,289,758,51,809
公投第１６案,高雄市,岡山區,程香里,273,1425,491,297,788,54,842
公投第１６案,高雄市,岡山區,後紅里,274,1328,436,256,692,34,726
公投第１６案,高雄市,岡山區,後紅里,275,1382,475,308,783,29,812
公投第１６案,高雄市,岡山區,後紅里,276,1381,578,236,814,26,840
公投第１６案,高雄市,岡山區,碧紅里,277,1282,423,271,694,76,770
公投第１６案,高雄市,岡山區,碧紅里,278,1240,422,250,672,28,700
公投第１６案,高雄市,岡山區,碧紅里,279,1327,470,265,735,59,794
公投第１６案,高雄市,岡山區,竹圍里,280,1736,562,340,902,56,958
公投第１６案,高雄市,岡山區,竹圍里,281,1566,513,373,886,66,952
公投第１６案,高雄市,岡山區,竹圍里,282,1779,501,286,787,93,880
公投第１６案,高雄市,岡山區,竹圍里,283,1593,529,330,859,98,957
公投第１６案,高雄市,岡山區,台上里,284,1480,513,301,814,108,922
公投第１６案,高雄市,岡山區,台上里,285,1364,481,287,768,63,831
公投第１６案,高雄市,岡山區,台上里,286,1410,489,321,810,54,864
公投第１６案,高雄市,岡山區,台上里,287,1148,418,305,723,66,789
公投第１６案,高雄市,岡山區,為隨里,288,625,188,160,348,57,405
公投第１６案,高雄市,岡山區,灣裡里,289,969,326,229,555,46,601
公投第１６案,高雄市,岡山區,灣裡里,290,861,300,216,516,16,532
公投第１６案,高雄市,岡山區,本洲里,291,823,246,160,406,30,436
公投第１６案,高雄市,岡山區,本洲里,292,889,300,233,533,62,595
公投第１６案,高雄市,岡山區,前峰里,293,1283,427,292,719,55,774
公投第１６案,高雄市,岡山區,前峰里,294,1512,520,272,792,47,839
公投第１６案,高雄市,岡山區,壽峰里,295,983,348,261,609,64,673
公投第１６案,高雄市,岡山區,壽峰里,296,1262,455,246,701,54,755
公投第１６案,高雄市,岡山區,仁壽里,297,1096,406,201,607,72,679
公投第１６案,高雄市,岡山區,仁壽里,298,1066,368,237,605,44,649
公投第１６案,高雄市,岡山區,仁壽里,299,1188,400,218,618,47,665
公投第１６案,高雄市,岡山區,後協里,300,1360,485,306,791,53,844
公投第１６案,高雄市,岡山區,後協里,301,1363,490,301,791,48,839
公投第１６案,高雄市,岡山區,後協里,302,1352,503,314,817,62,879
公投第１６案,高雄市,岡山區,後協里,303,1460,493,305,798,71,869
公投第１６案,高雄市,岡山區,協和里,304,1272,419,306,725,58,783
公投第１６案,高雄市,岡山區,協和里,305,1080,422,218,640,58,698
公投第１６案,高雄市,岡山區,協和里,306,1255,453,242,695,86,781
公投第１６案,高雄市,岡山區,協榮里,307,938,347,228,575,55,630
公投第１６案,高雄市,岡山區,協榮里,308,1237,446,288,734,58,792
公投第１６案,高雄市,岡山區,劉厝里,309,1413,400,300,700,39,739
公投第１６案,高雄市,岡山區,白米里,310,765,259,177,436,16,452
公投第１６案,高雄市,岡山區,白米里,311,1043,388,243,631,43,674
公投第１６案,高雄市,岡山區,石潭里,312,844,253,142,395,44,439
公投第１６案,高雄市,岡山區,石潭里,313,993,414,259,673,55,728
公投第１６案,高雄市,岡山區,福興里,314,1038,340,251,591,80,671
公投第１６案,高雄市,岡山區,嘉興里,315,1070,334,243,577,84,661
公投第１６案,高雄市,岡山區,嘉興里,316,1023,324,283,607,82,689
公投第１６案,高雄市,岡山區,嘉興里,317,1349,453,284,737,37,774
公投第１６案,高雄市,岡山區,嘉峰里,318,1452,456,273,729,49,778
公投第１６案,高雄市,岡山區,嘉峰里,319,301,117,70,187,19,206
公投第１６案,高雄市,岡山區,潭底里,320,756,234,185,419,93,512
公投第１６案,高雄市,岡山區,華崗里,321,733,179,168,347,19,366
公投第１６案,高雄市,岡山區,華崗里,322,854,315,199,514,80,594
公投第１６案,高雄市,岡山區,三和里,323,866,222,146,368,24,392
公投第１６案,高雄市,岡山區,大莊里,324,978,312,196,508,60,568
公投第１６案,高雄市,岡山區,忠孝里,325,1336,437,331,768,52,820
公投第１６案,高雄市,岡山區,忠孝里,326,1218,570,175,745,19,764
公投第１６案,高雄市,岡山區,忠孝里,327,341,149,98,247,14,261
公投第１６案,高雄市,岡山區,仁義里,328,955,530,149,679,37,716
公投第１６案,高雄市,岡山區,仁義里,329,940,504,131,635,17,652
公投第１６案,高雄市,岡山區,信義里,330,851,343,192,535,43,578
公投第１６案,高雄市,岡山區,信義里,331,762,360,157,517,18,535
公投第１６案,高雄市,岡山區,和平里,332,318,125,100,225,16,241
公投第１６案,高雄市,燕巢區,尖山里,333,1152,378,192,570,94,664
公投第１６案,高雄市,燕巢區,瓊林里,334,1120,348,270,618,31,649
公投第１６案,高雄市,燕巢區,瓊林里,335,974,354,220,574,68,642
公投第１６案,高雄市,燕巢區,安招里,336,1019,304,222,526,25,551
公投第１６案,高雄市,燕巢區,安招里,337,1058,314,215,529,78,607
公投第１６案,高雄市,燕巢區,安招里,338,1017,240,168,408,40,448
公投第１６案,高雄市,燕巢區,安招里,339,259,15,22,37,4,41
公投第１６案,高雄市,燕巢區,角宿里,340,926,319,223,542,68,610
公投第１６案,高雄市,燕巢區,角宿里,341,624,175,105,280,32,312
公投第１６案,高雄市,燕巢區,角宿里,342,1102,386,255,641,76,717
公投第１６案,高雄市,燕巢區,鳳雄里,343,1072,312,207,519,64,583
公投第１６案,高雄市,燕巢區,鳳雄里,344,1361,411,296,707,74,781
公投第１６案,高雄市,燕巢區,金山里,345,472,155,96,251,36,287
公投第１６案,高雄市,燕巢區,東燕里,346,1197,354,229,583,56,639
公投第１６案,高雄市,燕巢區,東燕里,347,1134,389,246,635,86,721
公投第１６案,高雄市,燕巢區,南燕里,348,1148,327,248,575,46,621
公投第１６案,高雄市,燕巢區,南燕里,349,1207,354,219,573,84,657
公投第１６案,高雄市,燕巢區,南燕里,350,1402,529,301,830,60,890
公投第１６案,高雄市,燕巢區,西燕里,351,1000,289,238,527,81,608
公投第１６案,高雄市,燕巢區,西燕里,352,1110,363,246,609,67,676
公投第１６案,高雄市,燕巢區,西燕里,353,1291,413,264,677,65,742
公投第１６案,高雄市,燕巢區,橫山里,354,797,214,189,403,81,484
公投第１６案,高雄市,燕巢區,橫山里,355,1098,309,192,501,67,568
公投第１６案,高雄市,燕巢區,深水里,356,1393,403,271,674,77,751
公投第１６案,高雄市,燕巢區,深水里,357,1079,374,79,453,25,478
公投第１６案,高雄市,彌陀區,光和里,358,1246,380,301,681,70,751
公投第１６案,高雄市,彌陀區,彌靖里,359,885,271,211,482,65,547
公投第１６案,高雄市,彌陀區,彌靖里,360,955,364,210,574,73,647
公投第１６案,高雄市,彌陀區,彌仁里,361,534,156,113,269,46,315
公投第１６案,高雄市,彌陀區,彌壽里,362,738,232,176,408,40,448
公投第１６案,高雄市,彌陀區,彌陀里,363,855,317,200,517,58,575
公投第１６案,高雄市,彌陀區,彌陀里,364,877,285,207,492,65,557
公投第１６案,高雄市,彌陀區,舊港里,365,781,279,160,439,67,506
公投第１６案,高雄市,彌陀區,舊港里,366,808,249,190,439,34,473
公投第１６案,高雄市,彌陀區,文安里,367,904,239,177,416,41,457
公投第１６案,高雄市,彌陀區,文安里,368,825,279,168,447,54,501
公投第１６案,高雄市,彌陀區,過港里,369,941,200,252,452,65,517
公投第１６案,高雄市,彌陀區,鹽埕里,370,1013,296,225,521,44,565
公投第１６案,高雄市,彌陀區,鹽埕里,371,1024,353,220,573,72,645
公投第１６案,高雄市,彌陀區,海尾里,372,861,261,156,417,28,445
公投第１６案,高雄市,彌陀區,漯底里,373,1163,369,272,641,88,729
公投第１６案,高雄市,彌陀區,南寮里,374,1216,439,252,691,98,789
公投第１６案,高雄市,彌陀區,南寮里,375,861,324,214,538,86,624
公投第１６案,高雄市,梓官區,梓信里,376,1061,350,247,597,76,673
公投第１６案,高雄市,梓官區,梓信里,377,1063,337,228,565,70,635
公投第１６案,高雄市,梓官區,梓義里,378,969,254,258,512,41,553
公投第１６案,高雄市,梓官區,梓義里,379,1078,291,224,515,30,545
公投第１６案,高雄市,梓官區,梓和里,380,838,244,219,463,57,520
公投第１６案,高雄市,梓官區,梓和里,381,611,191,149,340,47,387
公投第１６案,高雄市,梓官區,梓和里,382,782,248,158,406,41,447
公投第１６案,高雄市,梓官區,梓平里,383,1451,515,330,845,101,946
公投第１６案,高雄市,梓官區,中崙里,384,1144,343,243,586,30,616
公投第１６案,高雄市,梓官區,同安里,385,975,271,187,458,27,485
公投第１６案,高雄市,梓官區,大舍里,386,1317,398,288,686,56,742
公投第１６案,高雄市,梓官區,大舍里,387,1218,378,280,658,93,751
公投第１６案,高雄市,梓官區,大舍里,388,1073,348,226,574,50,624
公投第１６案,高雄市,梓官區,赤崁里,389,1112,300,214,514,50,564
公投第１６案,高雄市,梓官區,赤崁里,390,715,196,154,350,51,401
公投第１６案,高雄市,梓官區,赤東里,391,1311,360,266,626,68,694
公投第１６案,高雄市,梓官區,赤東里,392,939,272,205,477,46,523
公投第１６案,高雄市,梓官區,赤西里,393,824,289,199,488,28,516
公投第１６案,高雄市,梓官區,禮蚵里,394,1052,359,227,586,109,695
公投第１６案,高雄市,梓官區,禮蚵里,395,1020,322,222,544,103,647
公投第１６案,高雄市,梓官區,智蚵里,396,1260,368,243,611,39,650
公投第１６案,高雄市,梓官區,智蚵里,397,1595,504,305,809,49,858
公投第１６案,高雄市,梓官區,信蚵里,398,829,282,174,456,42,498
公投第１６案,高雄市,梓官區,信蚵里,399,1532,482,295,777,28,805
公投第１６案,高雄市,梓官區,茄苳里,400,1195,368,319,687,78,765
公投第１６案,高雄市,梓官區,茄苳里,401,1143,388,232,620,87,707
公投第１６案,高雄市,梓官區,典寶里,402,1186,367,297,664,72,736
公投第１６案,高雄市,梓官區,典寶里,403,1732,515,254,769,56,825
公投第１６案,高雄市,橋頭區,橋頭里,404,1005,358,245,603,73,676
公投第１６案,高雄市,橋頭區,橋頭里,405,1073,333,296,629,54,683
公投第１６案,高雄市,橋頭區,橋南里,406,1129,347,281,628,34,662
公投第１６案,高雄市,橋頭區,仕隆里,407,1244,416,287,703,80,783
公投第１６案,高雄市,橋頭區,仕隆里,408,1091,316,275,591,39,630
公投第１６案,高雄市,橋頭區,仕豐里,409,1329,461,342,803,65,868
公投第１６案,高雄市,橋頭區,仕豐里,410,1140,373,287,660,54,714
公投第１６案,高雄市,橋頭區,芋寮里,411,1220,386,292,678,77,755
公投第１６案,高雄市,橋頭區,東林里,412,1047,397,258,655,58,713
公投第１６案,高雄市,橋頭區,東林里,413,1315,389,287,676,111,787
公投第１６案,高雄市,橋頭區,西林里,414,691,209,153,362,33,395
公投第１６案,高雄市,橋頭區,西林里,415,720,246,171,417,59,476
公投第１６案,高雄市,橋頭區,白樹里,416,1192,331,280,611,137,748
公投第１６案,高雄市,橋頭區,白樹里,417,1318,421,324,745,98,843
公投第１６案,高雄市,橋頭區,白樹里,418,761,264,167,431,59,490
公投第１６案,高雄市,橋頭區,筆秀里,419,973,291,230,521,30,551
公投第１６案,高雄市,橋頭區,筆秀里,420,587,206,124,330,34,364
公投第１６案,高雄市,橋頭區,新莊里,421,812,280,193,473,54,527
公投第１６案,高雄市,橋頭區,新莊里,422,343,98,108,206,11,217
公投第１６案,高雄市,橋頭區,新莊里,423,1266,437,340,777,41,818
公投第１６案,高雄市,橋頭區,甲北里,424,1128,378,257,635,101,736
公投第１６案,高雄市,橋頭區,甲北里,425,884,272,226,498,65,563
公投第１６案,高雄市,橋頭區,甲南里,426,1187,351,246,597,95,692
公投第１６案,高雄市,橋頭區,甲南里,427,1259,420,258,678,99,777
公投第１６案,高雄市,橋頭區,頂鹽里,428,1361,399,273,672,82,754
公投第１６案,高雄市,橋頭區,中崎里,429,671,174,156,330,33,363
公投第１６案,高雄市,橋頭區,仕和里,430,1215,426,283,709,69,778
公投第１６案,高雄市,橋頭區,仕和里,431,1255,424,310,734,84,818
公投第１６案,高雄市,橋頭區,仕和里,432,1219,415,285,700,83,783
公投第１６案,高雄市,橋頭區,德松里,433,1372,413,308,721,39,760
公投第１６案,高雄市,橋頭區,三德里,434,758,165,137,302,8,310
公投第１６案,高雄市,楠梓區,清豐里,435,1309,492,286,778,54,832
公投第１６案,高雄市,楠梓區,清豐里,436,1408,473,328,801,41,842
公投第１６案,高雄市,楠梓區,清豐里,437,1851,599,432,1031,65,1096
公投第１６案,高雄市,楠梓區,清豐里,438,1578,527,391,918,64,982
公投第１６案,高雄市,楠梓區,清豐里,439,1715,542,388,930,40,970
公投第１６案,高雄市,楠梓區,清豐里,440,1611,419,437,856,28,884
公投第１６案,高雄市,楠梓區,清豐里,441,2024,609,418,1027,78,1105
公投第１６案,高雄市,楠梓區,清豐里,442,1890,582,392,974,47,1021
公投第１６案,高雄市,楠梓區,清豐里,443,1762,529,312,841,30,871
公投第１６案,高雄市,楠梓區,清豐里,444,1888,575,395,970,66,1036
公投第１６案,高雄市,楠梓區,清豐里,445,1822,595,356,951,85,1036
公投第１６案,高雄市,楠梓區,清豐里,446,1846,605,377,982,60,1042
公投第１６案,高雄市,楠梓區,東寧里,447,1268,432,284,716,75,791
公投第１６案,高雄市,楠梓區,東寧里,448,1240,452,299,751,58,809
公投第１６案,高雄市,楠梓區,東寧里,449,1432,489,351,840,42,882
公投第１６案,高雄市,楠梓區,五常里,450,1490,471,354,825,64,889
公投第１６案,高雄市,楠梓區,五常里,451,1464,530,330,860,61,921
公投第１６案,高雄市,楠梓區,五常里,452,1435,426,316,742,77,819
公投第１６案,高雄市,楠梓區,五常里,453,1602,446,357,803,83,886
公投第１６案,高雄市,楠梓區,享平里,454,1500,455,321,776,64,840
公投第１６案,高雄市,楠梓區,享平里,455,1591,495,323,818,93,911
公投第１６案,高雄市,楠梓區,惠楠里,456,1669,346,263,609,51,660
公投第１６案,高雄市,楠梓區,惠楠里,457,1469,474,348,822,70,892
公投第１６案,高雄市,楠梓區,中陽里,458,1559,470,322,792,95,887
公投第１６案,高雄市,楠梓區,中陽里,459,1638,522,343,865,86,951
公投第１６案,高雄市,楠梓區,惠民里,460,1960,639,430,1069,101,1170
公投第１６案,高雄市,楠梓區,惠民里,461,1912,608,412,1020,127,1147
公投第１６案,高雄市,楠梓區,惠豐里,462,1559,535,341,876,66,942
公投第１６案,高雄市,楠梓區,惠豐里,463,1423,436,311,747,53,800
公投第１６案,高雄市,楠梓區,惠豐里,464,1696,589,360,949,46,995
公投第１６案,高雄市,楠梓區,錦屏里,465,1493,392,342,734,163,897
公投第１６案,高雄市,楠梓區,錦屏里,466,1527,442,366,808,116,924
公投第１６案,高雄市,楠梓區,玉屏里,467,1020,327,262,589,62,651
公投第１６案,高雄市,楠梓區,玉屏里,468,1197,372,255,627,91,718
公投第１６案,高雄市,楠梓區,金田里,469,1528,424,316,740,108,848
公投第１６案,高雄市,楠梓區,金田里,470,1918,498,400,898,107,1005
公投第１６案,高雄市,楠梓區,稔田里,471,1458,432,301,733,109,842
公投第１６案,高雄市,楠梓區,瑞屏里,472,1790,600,412,1012,111,1123
公投第１６案,高雄市,楠梓區,瑞屏里,473,1845,624,425,1049,98,1147
公投第１６案,高雄市,楠梓區,翠屏里,474,2037,706,460,1166,74,1240
公投第１６案,高雄市,楠梓區,翠屏里,475,1964,633,404,1037,68,1105
公投第１６案,高雄市,楠梓區,翠屏里,476,2006,644,430,1074,46,1120
公投第１６案,高雄市,楠梓區,翠屏里,477,1951,622,425,1047,69,1116
公投第１６案,高雄市,楠梓區,翠屏里,478,1951,628,392,1020,82,1102
公投第１６案,高雄市,楠梓區,翠屏里,479,2008,709,418,1127,82,1209
公投第１６案,高雄市,楠梓區,翠屏里,480,1923,686,372,1058,90,1148
公投第１６案,高雄市,楠梓區,翠屏里,481,1921,697,375,1072,78,1150
公投第１６案,高雄市,楠梓區,宏南里,482,832,363,183,546,35,581
公投第１６案,高雄市,楠梓區,宏毅里,483,1156,186,292,478,51,529
公投第１６案,高雄市,楠梓區,宏毅里,484,1125,378,267,645,66,711
公投第１６案,高雄市,楠梓區,宏榮里,485,1060,364,248,612,66,678
公投第１６案,高雄市,楠梓區,宏榮里,486,1502,533,317,850,69,919
公投第１６案,高雄市,楠梓區,廣昌里,487,1404,441,316,757,101,858
公投第１６案,高雄市,楠梓區,廣昌里,488,1552,472,283,755,70,825
公投第１６案,高雄市,楠梓區,久昌里,489,1460,467,303,770,70,840
公投第１６案,高雄市,楠梓區,久昌里,490,1315,415,248,663,60,723
公投第１６案,高雄市,楠梓區,大昌里,491,1062,344,248,592,77,669
公投第１６案,高雄市,楠梓區,大昌里,492,1078,359,236,595,70,665
公投第１６案,高雄市,楠梓區,福昌里,493,914,323,208,531,84,615
公投第１６案,高雄市,楠梓區,福昌里,494,1064,369,240,609,100,709
公投第１６案,高雄市,楠梓區,盛昌里,495,1705,583,365,948,94,1042
公投第１６案,高雄市,楠梓區,盛昌里,496,1728,586,390,976,69,1045
公投第１６案,高雄市,楠梓區,盛昌里,497,1917,692,387,1079,77,1156
公投第１６案,高雄市,楠梓區,泰昌里,498,1439,406,292,698,120,818
公投第１６案,高雄市,楠梓區,興昌里,499,1287,440,300,740,74,814
公投第１６案,高雄市,楠梓區,興昌里,500,1504,540,337,877,85,962
公投第１６案,高雄市,楠梓區,興昌里,501,1405,548,297,845,69,914
公投第１６案,高雄市,楠梓區,建昌里,502,1287,414,285,699,87,786
公投第１６案,高雄市,楠梓區,建昌里,503,1295,445,297,742,68,810
公投第１６案,高雄市,楠梓區,宏昌里,504,1483,529,332,861,67,928
公投第１６案,高雄市,楠梓區,宏昌里,505,1649,643,385,1028,68,1096
公投第１６案,高雄市,楠梓區,和昌里,506,998,353,234,587,60,647
公投第１６案,高雄市,楠梓區,和昌里,507,1025,365,224,589,80,669
公投第１６案,高雄市,楠梓區,慶昌里,508,1671,654,391,1045,61,1106
公投第１６案,高雄市,楠梓區,慶昌里,509,1453,505,349,854,102,956
公投第１６案,高雄市,楠梓區,隆昌里,510,1673,567,343,910,98,1008
公投第１６案,高雄市,楠梓區,隆昌里,511,1653,582,307,889,70,959
公投第１６案,高雄市,楠梓區,秀昌里,512,1034,341,245,586,57,643
公投第１６案,高雄市,楠梓區,秀昌里,513,1127,433,279,712,65,777
公投第１６案,高雄市,楠梓區,裕昌里,514,1575,507,313,820,98,918
公投第１６案,高雄市,楠梓區,裕昌里,515,1559,514,372,886,74,960
公投第１６案,高雄市,楠梓區,裕昌里,516,1378,430,304,734,76,810
公投第１６案,高雄市,楠梓區,國昌里,517,1714,556,404,960,88,1048
公投第１６案,高雄市,楠梓區,國昌里,518,1721,762,198,960,88,1048
公投第１６案,高雄市,楠梓區,加昌里,519,1628,573,334,907,82,989
公投第１６案,高雄市,楠梓區,加昌里,520,1590,584,377,961,110,1071
公投第１６案,高雄市,楠梓區,加昌里,521,1628,559,362,921,75,996
公投第１６案,高雄市,楠梓區,加昌里,522,1739,631,441,1072,59,1131
公投第１６案,高雄市,楠梓區,加昌里,523,1642,626,365,991,68,1059
公投第１６案,高雄市,楠梓區,仁昌里,524,1766,564,342,906,75,981
公投第１６案,高雄市,楠梓區,仁昌里,525,1482,508,268,776,82,858
公投第１６案,高雄市,楠梓區,仁昌里,526,1749,549,325,874,42,916
公投第１６案,高雄市,楠梓區,藍田里,527,1591,541,367,908,62,970
公投第１６案,高雄市,楠梓區,藍田里,528,1545,577,370,947,51,998
公投第１６案,高雄市,楠梓區,藍田里,529,1651,639,385,1024,49,1073
公投第１６案,高雄市,楠梓區,藍田里,530,1646,591,387,978,65,1043
公投第１６案,高雄市,楠梓區,中興里,531,1496,491,384,875,88,963
公投第１６案,高雄市,楠梓區,中和里,532,1403,435,271,706,96,802
公投第１６案,高雄市,楠梓區,中和里,533,1624,535,342,877,58,935
公投第１６案,高雄市,左營區,進學里,534,2604,502,301,803,78,881
公投第１６案,高雄市,左營區,尾西里,535,1037,324,230,554,89,643
公投第１６案,高雄市,左營區,頂北里,536,542,176,128,304,55,359
公投第１６案,高雄市,左營區,中北里,537,635,183,145,328,59,387
公投第１６案,高雄市,左營區,中南里,538,518,121,104,225,21,246
公投第１６案,高雄市,左營區,廟東里,539,813,223,154,377,71,448
公投第１６案,高雄市,左營區,廟北里,540,889,344,99,443,92,535
公投第１６案,高雄市,左營區,尾南里,541,731,218,178,396,75,471
公投第１６案,高雄市,左營區,尾北里,542,1592,433,311,744,60,804
公投第１６案,高雄市,左營區,尾北里,543,1709,547,370,917,54,971
公投第１６案,高雄市,左營區,屏山里,544,1588,556,292,848,81,929
公投第１６案,高雄市,左營區,祥和里,545,358,129,49,178,16,194
公投第１６案,高雄市,左營區,永清里,546,666,292,144,436,20,456
公投第１６案,高雄市,左營區,莒光里,547,1748,575,329,904,89,993
公投第１６案,高雄市,左營區,光輝里,548,1196,462,242,704,63,767
公投第１６案,高雄市,左營區,光輝里,549,1240,433,285,718,70,788
公投第１６案,高雄市,左營區,合群里,550,1402,621,206,827,46,873
公投第１６案,高雄市,左營區,合群里,551,1173,546,181,727,32,759
公投第１６案,高雄市,左營區,明建里,552,641,257,170,427,30,457
公投第１６案,高雄市,左營區,頂西里,553,951,245,234,479,56,535
公投第１６案,高雄市,左營區,聖后里,554,732,221,153,374,52,426
公投第１６案,高雄市,左營區,聖西里,555,339,85,73,158,22,180
公投第１６案,高雄市,左營區,聖南里,556,519,152,126,278,16,294
公投第１６案,高雄市,左營區,城南里,557,514,135,145,280,62,342
公投第１６案,高雄市,左營區,路東里,558,720,232,159,391,69,460
公投第１６案,高雄市,左營區,廍北里,559,411,115,101,216,53,269
公投第１６案,高雄市,左營區,廍南里,560,603,188,148,336,59,395
公投第１６案,高雄市,左營區,埤西里,561,904,282,200,482,74,556
公投第１６案,高雄市,左營區,埤北里,562,1318,385,240,625,47,672
公投第１６案,高雄市,左營區,埤東里,563,966,251,207,458,34,492
公投第１６案,高雄市,左營區,海勝里,564,1440,534,269,803,46,849
公投第１６案,高雄市,左營區,海勝里,565,1990,745,305,1050,57,1107
公投第１６案,高雄市,左營區,海勝里,566,1090,435,195,630,44,674
公投第１６案,高雄市,左營區,海勝里,567,1272,498,214,712,84,796
公投第１６案,高雄市,左營區,崇實里,568,1558,621,332,953,30,983
公投第１６案,高雄市,左營區,崇實里,569,1501,555,368,923,44,967
公投第１６案,高雄市,左營區,自助里,570,360,159,78,237,11,248
公投第１６案,高雄市,左營區,果貿里,571,1335,566,193,759,29,788
公投第１６案,高雄市,左營區,果貿里,572,1359,531,241,772,22,794
公投第１６案,高雄市,左營區,果惠里,573,1487,584,292,876,64,940
公投第１６案,高雄市,左營區,果峰里,574,1637,567,306,873,63,936
公投第１６案,高雄市,左營區,新下里,575,1553,564,349,913,51,964
公投第１６案,高雄市,左營區,新下里,576,1564,575,363,938,69,1007
公投第１６案,高雄市,左營區,新下里,577,1788,676,430,1106,58,1164
公投第１６案,高雄市,左營區,新下里,578,2028,698,449,1147,96,1243
公投第１６案,高雄市,左營區,新下里,579,2037,665,471,1136,110,1246
公投第１６案,高雄市,左營區,新下里,580,2101,762,475,1237,65,1302
公投第１６案,高雄市,左營區,新下里,581,2018,728,448,1176,62,1238
公投第１６案,高雄市,左營區,新上里,582,1925,648,511,1159,81,1240
公投第１６案,高雄市,左營區,新上里,583,1989,660,446,1106,39,1145
公投第１６案,高雄市,左營區,新上里,584,1780,566,336,902,36,938
公投第１６案,高雄市,左營區,新上里,585,1778,620,418,1038,43,1081
公投第１６案,高雄市,左營區,新上里,586,1496,560,313,873,40,913
公投第１６案,高雄市,左營區,新上里,587,1538,540,372,912,53,965
公投第１６案,高雄市,左營區,新上里,588,2058,710,472,1182,74,1256
公投第１６案,高雄市,左營區,新上里,589,1992,668,487,1155,39,1194
公投第１６案,高雄市,左營區,新上里,590,2058,709,468,1177,93,1270
公投第１６案,高雄市,左營區,新上里,591,2090,718,490,1208,69,1277
公投第１６案,高雄市,左營區,新上里,592,2157,699,498,1197,41,1238
公投第１６案,高雄市,左營區,新上里,593,2096,786,499,1285,53,1338
公投第１６案,高雄市,左營區,新上里,594,2101,691,540,1231,97,1328
公投第１６案,高雄市,左營區,新中里,595,1649,523,369,892,102,994
公投第１６案,高雄市,左營區,新中里,596,1516,468,336,804,97,901
公投第１６案,高雄市,左營區,新中里,597,1678,591,389,980,90,1070
公投第１６案,高雄市,左營區,新光里,598,1898,662,393,1055,102,1157
公投第１６案,高雄市,左營區,新光里,599,1837,595,423,1018,65,1083
公投第１６案,高雄市,左營區,新光里,600,1922,624,404,1028,37,1065
公投第１６案,高雄市,左營區,新光里,601,1785,646,403,1049,72,1121
公投第１６案,高雄市,左營區,新光里,602,1886,628,407,1035,35,1070
公投第１６案,高雄市,左營區,新光里,603,1895,674,434,1108,61,1169
公投第１６案,高雄市,左營區,新光里,604,1831,706,377,1083,41,1124
公投第１６案,高雄市,左營區,菜公里,605,2050,727,396,1123,61,1184
公投第１６案,高雄市,左營區,菜公里,606,2251,887,539,1426,58,1484
公投第１６案,高雄市,左營區,菜公里,607,2126,754,531,1285,45,1330
公投第１６案,高雄市,左營區,菜公里,608,1928,626,393,1019,42,1061
公投第１６案,高雄市,左營區,菜公里,609,2166,714,476,1190,64,1254
公投第１６案,高雄市,左營區,菜公里,610,2031,694,444,1138,73,1211
公投第１６案,高雄市,左營區,菜公里,611,1987,698,467,1165,64,1229
公投第１６案,高雄市,左營區,菜公里,612,2166,785,495,1280,50,1330
公投第１６案,高雄市,左營區,菜公里,613,1856,614,413,1027,117,1144
公投第１６案,高雄市,左營區,菜公里,614,2289,817,541,1358,45,1403
公投第１６案,高雄市,左營區,菜公里,615,1973,696,427,1123,53,1176
公投第１６案,高雄市,左營區,菜公里,616,1818,677,361,1038,89,1127
公投第１６案,高雄市,左營區,菜公里,617,1565,524,333,857,48,905
公投第１６案,高雄市,左營區,菜公里,618,1608,652,349,1001,57,1058
公投第１６案,高雄市,左營區,福山里,619,1812,668,443,1111,68,1179
公投第１６案,高雄市,左營區,福山里,620,1821,613,338,951,36,987
公投第１６案,高雄市,左營區,福山里,621,1907,677,439,1116,79,1195
公投第１６案,高雄市,左營區,福山里,622,1812,633,383,1016,64,1080
公投第１６案,高雄市,左營區,福山里,623,1833,716,404,1120,38,1158
公投第１６案,高雄市,左營區,福山里,624,1850,680,402,1082,68,1150
公投第１６案,高雄市,左營區,福山里,625,1738,608,351,959,72,1031
公投第１６案,高雄市,左營區,福山里,626,1864,714,437,1151,62,1213
公投第１６案,高雄市,左營區,福山里,627,1887,684,444,1128,68,1196
公投第１６案,高雄市,左營區,福山里,628,1870,646,374,1020,31,1051
公投第１６案,高雄市,左營區,福山里,629,1866,746,361,1107,51,1158
公投第１６案,高雄市,左營區,福山里,630,1862,708,330,1038,27,1065
公投第１６案,高雄市,左營區,福山里,631,1816,619,430,1049,50,1099
公投第１６案,高雄市,左營區,福山里,632,1833,662,392,1054,52,1106
公投第１６案,高雄市,左營區,福山里,633,1676,584,402,986,67,1053
公投第１６案,高雄市,左營區,福山里,634,1843,638,437,1075,60,1135
公投第１６案,高雄市,左營區,福山里,635,1872,690,432,1122,40,1162
公投第１６案,高雄市,左營區,福山里,636,2259,730,468,1198,48,1246
公投第１６案,高雄市,大社區,嘉誠里,637,950,276,181,457,78,535
公投第１６案,高雄市,大社區,保社里,638,1306,342,281,623,43,666
公投第１６案,高雄市,大社區,保社里,639,1856,491,294,785,48,833
公投第１６案,高雄市,大社區,大社里,640,986,301,264,565,67,632
公投第１６案,高雄市,大社區,大社里,641,1116,294,210,504,69,573
公投第１６案,高雄市,大社區,大社里,642,1253,394,318,712,94,806
公投第１６案,高雄市,大社區,大社里,643,1613,533,346,879,56,935
公投第１６案,高雄市,大社區,保安里,644,1455,400,317,717,61,778
公投第１６案,高雄市,大社區,保安里,645,1674,505,419,924,60,984
公投第１６案,高雄市,大社區,三奶里,646,1004,312,225,537,70,607
公投第１６案,高雄市,大社區,三奶里,647,879,271,193,464,40,504
公投第１６案,高雄市,大社區,三奶里,648,778,224,161,385,23,408
公投第１６案,高雄市,大社區,觀音里,649,1110,356,255,611,67,678
公投第１６案,高雄市,大社區,觀音里,650,1432,423,332,755,52,807
公投第１６案,高雄市,大社區,觀音里,651,1466,493,319,812,54,866
公投第１６案,高雄市,大社區,觀音里,652,1383,427,388,815,89,904
公投第１６案,高雄市,大社區,神農里,653,1645,558,357,915,73,988
公投第１６案,高雄市,大社區,神農里,654,1555,428,289,717,66,783
公投第１６案,高雄市,大社區,神農里,655,1750,544,393,937,81,1018
公投第１６案,高雄市,大社區,中里里,656,1111,322,256,578,74,652
公投第１６案,高雄市,大社區,中里里,657,1133,345,280,625,70,695
公投第１６案,高雄市,大社區,中里里,658,912,301,204,505,41,546
公投第１６案,高雄市,大社區,翠屏里,659,745,194,131,325,21,346
公投第１６案,高雄市,大社區,翠屏里,660,934,280,227,507,37,544
公投第１６案,高雄市,仁武區,大灣里,661,1777,629,439,1068,51,1119
公投第１６案,高雄市,仁武區,大灣里,662,2273,836,471,1307,80,1387
公投第１６案,高雄市,仁武區,灣內里,663,1384,526,305,831,82,913
公投第１６案,高雄市,仁武區,灣內里,664,1170,392,235,627,62,689
公投第１６案,高雄市,仁武區,灣內里,665,1216,418,323,741,73,814
公投第１６案,高雄市,仁武區,灣內里,666,1598,528,331,859,36,895
公投第１６案,高雄市,仁武區,灣內里,667,2143,808,489,1297,50,1347
公投第１６案,高雄市,仁武區,考潭里,668,1300,393,283,676,75,751
公投第１６案,高雄市,仁武區,考潭里,669,1338,405,318,723,94,817
公投第１６案,高雄市,仁武區,烏林里,670,1217,363,258,621,31,652
公投第１６案,高雄市,仁武區,烏林里,671,1202,306,225,531,87,618
公投第１６案,高雄市,仁武區,烏林里,672,1404,415,259,674,50,724
公投第１６案,高雄市,仁武區,仁福里,673,830,261,166,427,55,482
公投第１６案,高雄市,仁武區,仁武里,674,1802,442,289,731,52,783
公投第１６案,高雄市,仁武區,仁武里,675,1877,557,339,896,83,979
公投第１６案,高雄市,仁武區,仁武里,676,1738,456,333,789,45,834
公投第１６案,高雄市,仁武區,文武里,677,1549,460,333,793,67,860
公投第１６案,高雄市,仁武區,文武里,678,1579,498,360,858,68,926
公投第１６案,高雄市,仁武區,文武里,679,1406,434,280,714,43,757
公投第１６案,高雄市,仁武區,文武里,680,1461,508,291,799,34,833
公投第１６案,高雄市,仁武區,文武里,681,1311,445,311,756,65,821
公投第１６案,高雄市,仁武區,文武里,682,1373,427,297,724,39,763
公投第１６案,高雄市,仁武區,竹後里,683,1035,255,228,483,22,505
公投第１６案,高雄市,仁武區,竹後里,684,1181,337,262,599,45,644
公投第１６案,高雄市,仁武區,八卦里,685,1670,513,340,853,55,908
公投第１６案,高雄市,仁武區,八卦里,686,1576,481,340,821,40,861
公投第１６案,高雄市,仁武區,八卦里,687,1576,538,364,902,82,984
公投第１６案,高雄市,仁武區,八卦里,688,1915,688,422,1110,53,1163
公投第１６案,高雄市,仁武區,八卦里,689,1758,537,378,915,40,955
公投第１６案,高雄市,仁武區,八卦里,690,1892,692,436,1128,63,1191
公投第１６案,高雄市,仁武區,八卦里,691,2025,697,451,1148,78,1226
公投第１６案,高雄市,仁武區,八卦里,692,2014,742,440,1182,66,1248
公投第１６案,高雄市,仁武區,八卦里,693,1473,552,380,932,64,996
公投第１６案,高雄市,仁武區,高楠里,694,979,292,204,496,33,529
公投第１６案,高雄市,仁武區,高楠里,695,944,307,203,510,37,547
公投第１６案,高雄市,仁武區,後安里,696,1153,364,237,601,117,718
公投第１６案,高雄市,仁武區,後安里,697,1328,403,265,668,51,719
公投第１６案,高雄市,仁武區,中華里,698,1657,743,179,922,76,998
公投第１６案,高雄市,仁武區,五和里,699,1545,440,311,751,72,823
公投第１６案,高雄市,仁武區,五和里,700,1417,460,348,808,62,870
公投第１６案,高雄市,仁武區,五和里,701,1602,611,356,967,59,1026
公投第１６案,高雄市,仁武區,仁和里,702,1823,643,446,1089,79,1168
公投第１６案,高雄市,仁武區,仁和里,703,1914,616,384,1000,40,1040
公投第１６案,高雄市,仁武區,赤山里,704,1992,686,400,1086,57,1143
公投第１６案,高雄市,仁武區,赤山里,705,2045,589,436,1025,43,1068
公投第１６案,高雄市,仁武區,赤山里,706,1982,707,443,1150,55,1205
公投第１６案,高雄市,仁武區,仁慈里,707,2167,641,465,1106,66,1172
公投第１６案,高雄市,鳥松區,鳥松里,708,1678,543,374,917,71,988
公投第１６案,高雄市,鳥松區,鳥松里,709,1682,510,316,826,87,913
公投第１６案,高雄市,鳥松區,鳥松里,710,1225,392,309,701,55,756
公投第１６案,高雄市,鳥松區,鳥松里,711,1322,400,267,667,67,734
公投第１６案,高雄市,鳥松區,鳥松里,712,1215,198,485,683,54,737
公投第１６案,高雄市,鳥松區,鳥松里,713,1779,497,422,919,62,981
公投第１６案,高雄市,鳥松區,鳥松里,714,1129,349,360,709,27,736
公投第１６案,高雄市,鳥松區,夢裡里,715,1374,414,345,759,66,825
公投第１６案,高雄市,鳥松區,夢裡里,716,1089,329,261,590,45,635
公投第１６案,高雄市,鳥松區,夢裡里,717,2219,745,544,1289,77,1366
公投第１６案,高雄市,鳥松區,大華里,718,1634,544,364,908,44,952
公投第１６案,高雄市,鳥松區,大華里,719,1553,543,365,908,79,987
公投第１６案,高雄市,鳥松區,大華里,720,1572,563,386,949,60,1009
公投第１６案,高雄市,鳥松區,大華里,721,1688,597,417,1014,47,1061
公投第１６案,高雄市,鳥松區,大華里,722,1626,566,391,957,54,1011
公投第１６案,高雄市,鳥松區,大華里,723,1744,609,464,1073,62,1135
公投第１６案,高雄市,鳥松區,坔埔里,724,1230,375,264,639,53,692
公投第１６案,高雄市,鳥松區,坔埔里,725,1201,496,180,676,98,774
公投第１６案,高雄市,鳥松區,坔埔里,726,1117,396,280,676,46,722
公投第１６案,高雄市,鳥松區,仁美里,727,1255,383,242,625,90,715
公投第１６案,高雄市,鳥松區,仁美里,728,1432,399,308,707,48,755
公投第１６案,高雄市,鳥松區,仁美里,729,1370,411,257,668,40,708
公投第１６案,高雄市,鳥松區,仁美里,730,1364,434,319,753,99,852
公投第１６案,高雄市,鳥松區,仁美里,731,1041,343,252,595,59,654
公投第１６案,高雄市,鳥松區,大竹里,732,702,276,182,458,45,503
公投第１６案,高雄市,鳥松區,華美里,733,1212,402,278,680,54,734
公投第１６案,高雄市,鳥松區,華美里,734,1289,410,283,693,64,757
公投第１６案,高雄市,鳥松區,華美里,735,1449,501,391,892,35,927
公投第１６案,高雄市,大樹區,竹寮里,736,1386,425,303,728,36,764
公投第１６案,高雄市,大樹區,竹寮里,737,1315,474,325,799,45,844
公投第１６案,高雄市,大樹區,九曲里,738,2461,755,486,1241,81,1322
公投第１６案,高雄市,大樹區,九曲里,739,1274,380,261,641,46,687
公投第１６案,高雄市,大樹區,九曲里,740,1265,423,218,641,74,715
公投第１６案,高雄市,大樹區,久堂里,741,1504,463,282,745,85,830
公投第１６案,高雄市,大樹區,久堂里,742,1049,276,207,483,35,518
公投第１６案,高雄市,大樹區,久堂里,743,1573,487,318,805,40,845
公投第１６案,高雄市,大樹區,水安里,744,1121,294,209,503,41,544
公投第１６案,高雄市,大樹區,水安里,745,1207,410,189,599,58,657
公投第１６案,高雄市,大樹區,水寮里,746,1134,350,215,565,26,591
公投第１６案,高雄市,大樹區,水寮里,747,1124,366,257,623,42,665
公投第１６案,高雄市,大樹區,檨腳里,748,1259,378,240,618,102,720
公投第１６案,高雄市,大樹區,檨腳里,749,1105,395,225,620,76,696
公投第１６案,高雄市,大樹區,檨腳里,750,1128,340,241,581,70,651
公投第１６案,高雄市,大樹區,興山里,751,1079,311,194,505,89,594
公投第１６案,高雄市,大樹區,和山里,752,1025,86,374,460,54,514
公投第１６案,高雄市,大樹區,姑山里,753,950,279,188,467,61,528
公投第１６案,高雄市,大樹區,大坑里,754,1433,413,279,692,115,807
公投第１６案,高雄市,大樹區,井腳里,755,794,214,129,343,35,378
公投第１６案,高雄市,大樹區,井腳里,756,781,165,116,281,23,304
公投第１６案,高雄市,大樹區,小坪里,757,1318,342,259,601,32,633
公投第１６案,高雄市,大樹區,龍目里,758,736,223,122,345,61,406
公投第１６案,高雄市,大樹區,龍目里,759,1047,268,176,444,41,485
公投第１６案,高雄市,大樹區,大樹里,760,1271,385,273,658,93,751
公投第１６案,高雄市,大樹區,大樹里,761,1186,305,231,536,38,574
公投第１６案,高雄市,大樹區,三和里,762,1007,307,208,515,66,581
公投第１６案,高雄市,大樹區,溪埔里,763,859,281,169,450,67,517
公投第１６案,高雄市,大樹區,溪埔里,764,735,197,116,313,26,339
公投第１６案,高雄市,大樹區,興田里,765,1046,314,235,549,91,640
公投第１６案,高雄市,大樹區,興田里,766,880,451,155,606,45,651
公投第１６案,高雄市,大樹區,統嶺里,767,720,203,132,335,27,362
公投第１６案,高雄市,鼓山區,鼓峰里,768,959,289,178,467,32,499
公投第１６案,高雄市,鼓山區,鼓峰里,769,1000,374,236,610,53,663
公投第１６案,高雄市,鼓山區,雄峰里,770,910,289,196,485,22,507
公投第１６案,高雄市,鼓山區,雄峰里,771,1085,402,248,650,61,711
公投第１６案,高雄市,鼓山區,前峰里,772,1484,359,258,617,53,670
公投第１６案,高雄市,鼓山區,前峰里,773,1393,490,298,788,38,826
公投第１６案,高雄市,鼓山區,前峰里,774,1270,503,274,777,76,853
公投第１６案,高雄市,鼓山區,光榮里,775,1055,303,243,546,43,589
公投第１６案,高雄市,鼓山區,光榮里,776,1172,360,278,638,38,676
公投第１６案,高雄市,鼓山區,光榮里,777,1175,407,275,682,56,738
公投第１６案,高雄市,鼓山區,民族里,778,1274,393,293,686,54,740
公投第１６案,高雄市,鼓山區,內惟里,779,1085,276,220,496,63,559
公投第１６案,高雄市,鼓山區,建國里,780,1470,481,289,770,73,843
公投第１６案,高雄市,鼓山區,建國里,781,974,346,244,590,51,641
公投第１６案,高雄市,鼓山區,忠正里,782,1275,414,283,697,99,796
公投第１６案,高雄市,鼓山區,忠正里,783,1206,361,267,628,63,691
公投第１６案,高雄市,鼓山區,忠正里,784,1238,423,253,676,39,715
公投第１６案,高雄市,鼓山區,自強里,785,721,371,109,480,18,498
公投第１６案,高雄市,鼓山區,龍井里,786,1220,360,257,617,38,655
公投第１６案,高雄市,鼓山區,正德里,787,1966,524,363,887,51,938
公投第１６案,高雄市,鼓山區,平和里,788,1722,426,375,801,121,922
公投第１６案,高雄市,鼓山區,平和里,789,1720,522,329,851,42,893
公投第１６案,高雄市,鼓山區,民強里,790,1287,437,253,690,115,805
公投第１６案,高雄市,鼓山區,民強里,791,1369,338,243,581,49,630
公投第１６案,高雄市,鼓山區,厚生里,792,1222,403,292,695,52,747
公投第１６案,高雄市,鼓山區,厚生里,793,1770,540,359,899,62,961
公投第１６案,高雄市,鼓山區,龍子里,794,1860,729,299,1028,53,1081
公投第１６案,高雄市,鼓山區,龍子里,795,1857,590,406,996,60,1056
公投第１６案,高雄市,鼓山區,龍子里,796,1841,606,418,1024,58,1082
公投第１６案,高雄市,鼓山區,龍子里,797,1830,657,439,1096,74,1170
公投第１６案,高雄市,鼓山區,龍子里,798,1809,598,414,1012,71,1083
公投第１６案,高雄市,鼓山區,龍子里,799,1894,663,439,1102,52,1154
公投第１６案,高雄市,鼓山區,龍子里,800,1882,630,482,1112,38,1150
公投第１６案,高雄市,鼓山區,龍子里,801,1894,677,485,1162,53,1215
公投第１６案,高雄市,鼓山區,龍水里,802,1745,607,354,961,54,1015
公投第１６案,高雄市,鼓山區,龍水里,803,1887,614,401,1015,30,1045
公投第１６案,高雄市,鼓山區,龍水里,804,1891,713,453,1166,69,1235
公投第１６案,高雄市,鼓山區,龍水里,805,1903,647,455,1102,54,1156
公投第１６案,高雄市,鼓山區,龍水里,806,1998,654,513,1167,52,1219
公投第１６案,高雄市,鼓山區,龍水里,807,1912,714,415,1129,53,1182
公投第１６案,高雄市,鼓山區,龍水里,808,1923,660,459,1119,85,1204
公投第１６案,高雄市,鼓山區,龍水里,809,1888,800,467,1267,35,1302
公投第１６案,高雄市,鼓山區,龍水里,810,1873,682,450,1132,24,1156
公投第１６案,高雄市,鼓山區,龍水里,811,1959,760,495,1255,49,1304
公投第１６案,高雄市,鼓山區,龍水里,812,1897,720,465,1185,58,1243
公投第１６案,高雄市,鼓山區,明誠里,813,2362,873,318,1191,55,1246
公投第１６案,高雄市,鼓山區,明誠里,814,1850,676,401,1077,85,1162
公投第１６案,高雄市,鼓山區,明誠里,815,1928,664,489,1153,37,1190
公投第１６案,高雄市,鼓山區,明誠里,816,1937,671,402,1073,33,1106
公投第１６案,高雄市,鼓山區,明誠里,817,2123,749,456,1205,63,1268
公投第１６案,高雄市,鼓山區,明誠里,818,1861,635,426,1061,45,1106
公投第１６案,高雄市,鼓山區,明誠里,819,1892,660,401,1061,40,1101
公投第１６案,高雄市,鼓山區,明誠里,820,2147,783,479,1262,63,1325
公投第１６案,高雄市,鼓山區,華豐里,821,1897,686,440,1126,43,1169
公投第１６案,高雄市,鼓山區,華豐里,822,2041,674,464,1138,50,1188
公投第１６案,高雄市,鼓山區,裕興里,823,1309,454,275,729,59,788
公投第１６案,高雄市,鼓山區,裕興里,824,1867,604,449,1053,67,1120
公投第１６案,高雄市,鼓山區,裕豐里,825,1152,472,277,749,38,787
公投第１６案,高雄市,鼓山區,裕豐里,826,1404,530,316,846,61,907
公投第１６案,高雄市,鼓山區,鼓岩里,827,1210,263,188,451,28,479
公投第１６案,高雄市,鼓山區,樹德里,828,1135,335,252,587,50,637
公投第１６案,高雄市,鼓山區,寶樹里,829,1831,345,233,578,87,665
公投第１６案,高雄市,鼓山區,興宗里,830,1288,417,285,702,60,762
公投第１６案,高雄市,鼓山區,光化里,831,1241,451,154,605,52,657
公投第１６案,高雄市,鼓山區,山下里,832,1342,459,293,752,73,825
公投第１６案,高雄市,鼓山區,河邊里,833,1422,438,306,744,129,873
公投第１６案,高雄市,鼓山區,綠川里,834,1453,475,313,788,126,914
公投第１６案,高雄市,鼓山區,登山里,835,616,194,150,344,55,399
公投第１６案,高雄市,鼓山區,峰南里,836,834,237,180,417,84,501
公投第１６案,高雄市,鼓山區,麗興里,837,969,268,233,501,75,576
公投第１６案,高雄市,鼓山區,新民里,838,978,277,217,494,89,583
公投第１６案,高雄市,鼓山區,延平里,839,760,229,201,430,61,491
公投第１６案,高雄市,鼓山區,維生里,840,1248,358,317,675,80,755
公投第１６案,高雄市,鼓山區,惠安里,841,1143,292,233,525,34,559
公投第１６案,高雄市,鼓山區,壽山里,842,1358,329,268,597,84,681
公投第１６案,高雄市,鼓山區,哨船頭里,843,1036,285,210,495,26,521
公投第１６案,高雄市,鼓山區,桃源里,844,580,180,111,291,13,304
公投第１６案,高雄市,鹽埕區,藍橋里,845,1304,400,345,745,63,808
公投第１６案,高雄市,鹽埕區,慈愛里,846,357,111,79,190,28,218
公投第１６案,高雄市,鹽埕區,博愛里,847,651,177,175,352,35,387
公投第１６案,高雄市,鹽埕區,壽星里,848,1322,358,252,610,33,643
公投第１６案,高雄市,鹽埕區,中山里,849,1056,346,237,583,24,607
公投第１６案,高雄市,鹽埕區,教仁里,850,904,280,227,507,24,531
公投第１６案,高雄市,鹽埕區,教仁里,851,1130,335,245,580,37,617
公投第１６案,高雄市,鹽埕區,新樂里,852,840,292,199,491,21,512
公投第１６案,高雄市,鹽埕區,中原里,853,616,225,178,403,35,438
公投第１６案,高雄市,鹽埕區,光明里,854,1397,407,279,686,41,727
公投第１６案,高雄市,鹽埕區,育仁里,855,766,221,203,424,19,443
公投第１６案,高雄市,鹽埕區,河濱里,856,839,255,221,476,45,521
公投第１６案,高雄市,鹽埕區,河濱里,857,805,291,185,476,19,495
公投第１６案,高雄市,鹽埕區,沙地里,858,750,229,160,389,19,408
公投第１６案,高雄市,鹽埕區,南端里,859,986,271,244,515,36,551
公投第１６案,高雄市,鹽埕區,港都里,860,1068,303,224,527,13,540
公投第１６案,高雄市,鹽埕區,江西里,861,1060,324,258,582,47,629
公投第１６案,高雄市,鹽埕區,新豐里,862,805,228,178,406,37,443
公投第１６案,高雄市,鹽埕區,府北里,863,1073,307,201,508,23,531
公投第１６案,高雄市,鹽埕區,府北里,864,921,253,179,432,38,470
公投第１６案,高雄市,鹽埕區,陸橋里,865,1171,362,255,617,24,641
公投第１６案,高雄市,鹽埕區,瀨南里,866,594,165,162,327,17,344
公投第１６案,高雄市,鹽埕區,新化里,867,592,186,142,328,24,352
公投第１６案,高雄市,鹽埕區,江南里,868,610,169,129,298,16,314
公投第１６案,高雄市,旗津區,旗下里,869,1177,325,283,608,125,733
公投第１６案,高雄市,旗津區,永安里,870,1109,281,203,484,61,545
公投第１６案,高雄市,旗津區,振興里,871,1642,404,300,704,31,735
公投第１６案,高雄市,旗津區,慈愛里,872,1209,302,239,541,115,656
公投第１６案,高雄市,旗津區,慈愛里,873,1112,256,209,465,65,530
公投第１６案,高雄市,旗津區,復興里,874,1483,417,328,745,107,852
公投第１６案,高雄市,旗津區,復興里,875,1460,368,249,617,41,658
公投第１６案,高雄市,旗津區,中華里,876,1572,458,341,799,173,972
公投第１６案,高雄市,旗津區,實踐里,877,1384,368,230,598,37,635
公投第１６案,高雄市,旗津區,北汕里,878,1390,333,252,585,50,635
公投第１６案,高雄市,旗津區,北汕里,879,1239,307,234,541,69,610
公投第１６案,高雄市,旗津區,南汕里,880,2045,486,416,902,148,1050
公投第１６案,高雄市,旗津區,上竹里,881,893,206,185,391,28,419
公投第１６案,高雄市,旗津區,上竹里,882,1866,551,290,841,132,973
公投第１６案,高雄市,旗津區,中洲里,883,1874,391,319,710,51,761
公投第１６案,高雄市,旗津區,安順里,884,893,203,189,392,66,458
公投第１６案,高雄市,旗津區,中興里,885,1215,322,277,599,45,644
公投第１６案,高雄市,旗津區,中興里,886,1297,353,212,565,50,615
公投第１６案,高雄市,三民區,鼎金里,887,1893,578,418,996,95,1091
公投第１６案,高雄市,三民區,鼎金里,888,1982,586,378,964,117,1081
公投第１６案,高雄市,三民區,鼎盛里,889,1661,520,359,879,93,972
公投第１６案,高雄市,三民區,鼎盛里,890,1894,567,412,979,33,1012
公投第１６案,高雄市,三民區,鼎盛里,891,1839,604,376,980,65,1045
公投第１６案,高雄市,三民區,鼎盛里,892,2014,642,435,1077,74,1151
公投第１６案,高雄市,三民區,鼎強里,893,1897,573,424,997,124,1121
公投第１６案,高雄市,三民區,鼎強里,894,2016,582,416,998,55,1053
公投第１６案,高雄市,三民區,鼎力里,895,1924,564,426,990,67,1057
公投第１６案,高雄市,三民區,鼎力里,896,1749,577,379,956,77,1033
公投第１６案,高雄市,三民區,鼎西里,897,1845,674,419,1093,77,1170
公投第１６案,高雄市,三民區,鼎西里,898,1724,516,345,861,52,913
公投第１６案,高雄市,三民區,鼎西里,899,1889,628,398,1026,58,1084
公投第１６案,高雄市,三民區,鼎西里,900,1622,530,346,876,77,953
公投第１６案,高雄市,三民區,鼎中里,901,1870,574,456,1030,45,1075
公投第１６案,高雄市,三民區,鼎中里,902,1523,527,366,893,70,963
公投第１６案,高雄市,三民區,鼎泰里,903,2006,564,407,971,71,1042
公投第１６案,高雄市,三民區,鼎泰里,904,2076,747,488,1235,73,1308
公投第１６案,高雄市,三民區,鼎泰里,905,2073,707,440,1147,36,1183
公投第１６案,高雄市,三民區,鼎泰里,906,2045,689,447,1136,72,1208
公投第１６案,高雄市,三民區,鼎泰里,907,2070,584,359,943,82,1025
公投第１６案,高雄市,三民區,鼎泰里,908,2035,638,422,1060,80,1140
公投第１６案,高雄市,三民區,鼎泰里,909,2075,767,480,1247,50,1297
公投第１６案,高雄市,三民區,鼎泰里,910,2053,737,410,1147,61,1208
公投第１６案,高雄市,三民區,鼎泰里,911,2063,739,473,1212,69,1281
公投第１６案,高雄市,三民區,鼎泰里,912,2143,804,481,1285,64,1349
公投第１６案,高雄市,三民區,本館里,913,1746,549,445,994,93,1087
公投第１６案,高雄市,三民區,本館里,914,1735,500,342,842,37,879
公投第１６案,高雄市,三民區,本館里,915,1655,503,338,841,72,913
公投第１６案,高雄市,三民區,本館里,916,1583,555,323,878,71,949
公投第１６案,高雄市,三民區,本館里,917,1800,591,365,956,63,1019
公投第１６案,高雄市,三民區,本和里,918,1730,588,378,966,50,1016
公投第１６案,高雄市,三民區,本和里,919,1715,536,375,911,49,960
公投第１６案,高雄市,三民區,本和里,920,1691,536,406,942,65,1007
公投第１６案,高雄市,三民區,本和里,921,1865,649,390,1039,70,1109
公投第１６案,高雄市,三民區,本文里,922,1073,367,273,640,55,695
公投第１６案,高雄市,三民區,本文里,923,917,306,258,564,73,637
公投第１６案,高雄市,三民區,本武里,924,1647,538,386,924,62,986
公投第１６案,高雄市,三民區,本元里,925,1654,538,390,928,88,1016
公投第１６案,高雄市,三民區,本元里,926,1639,561,394,955,66,1021
公投第１６案,高雄市,三民區,本元里,927,1833,601,422,1023,81,1104
公投第１６案,高雄市,三民區,本安里,928,1362,508,335,843,47,890
公投第１６案,高雄市,三民區,本安里,929,1557,555,357,912,75,987
公投第１６案,高雄市,三民區,本安里,930,1482,528,34,562,33,595
公投第１６案,高雄市,三民區,本上里,931,1563,523,393,916,69,985
公投第１６案,高雄市,三民區,本上里,932,1497,508,362,870,50,920
公投第１６案,高雄市,三民區,本上里,933,1523,547,380,927,38,965
公投第１６案,高雄市,三民區,本揚里,934,1293,483,327,810,56,866
公投第１６案,高雄市,三民區,本揚里,935,1662,617,373,990,63,1053
公投第１６案,高雄市,三民區,本揚里,936,1441,400,403,803,60,863
公投第１６案,高雄市,三民區,本揚里,937,1326,461,372,833,56,889
公投第１６案,高雄市,三民區,本揚里,938,1476,516,403,919,35,954
公投第１６案,高雄市,三民區,寶獅里,939,1968,595,378,973,35,1008
公投第１６案,高雄市,三民區,寶獅里,940,1618,443,346,789,54,843
公投第１６案,高雄市,三民區,寶德里,941,1873,678,336,1014,70,1084
公投第１６案,高雄市,三民區,寶德里,942,1487,447,370,817,79,896
公投第１６案,高雄市,三民區,寶德里,943,1640,500,366,866,28,894
公投第１６案,高雄市,三民區,寶泰里,944,1889,586,413,999,35,1034
公投第１６案,高雄市,三民區,寶泰里,945,1969,710,304,1014,55,1069
公投第１６案,高雄市,三民區,寶興里,946,1466,454,316,770,112,882
公投第１６案,高雄市,三民區,寶興里,947,1697,561,405,966,74,1040
公投第１６案,高雄市,三民區,寶興里,948,1663,547,386,933,81,1014
公投第１６案,高雄市,三民區,寶興里,949,1649,504,390,894,70,964
公投第１６案,高雄市,三民區,寶中里,950,1486,474,319,793,55,848
公投第１６案,高雄市,三民區,寶中里,951,1495,484,306,790,31,821
公投第１６案,高雄市,三民區,寶華里,952,1548,590,349,939,33,972
公投第１６案,高雄市,三民區,寶華里,953,1493,468,336,804,43,847
公投第１６案,高雄市,三民區,寶國里,954,1445,532,324,856,43,899
公投第１６案,高雄市,三民區,寶國里,955,1529,564,266,830,47,877
公投第１６案,高雄市,三民區,寶國里,956,1506,473,354,827,27,854
公投第１６案,高雄市,三民區,寶國里,957,1549,569,355,924,51,975
公投第１６案,高雄市,三民區,寶國里,958,1620,584,375,959,74,1033
公投第１６案,高雄市,三民區,寶民里,959,1550,537,370,907,79,986
公投第１６案,高雄市,三民區,寶民里,960,1488,507,372,879,61,940
公投第１６案,高雄市,三民區,寶慶里,961,1335,580,293,873,65,938
公投第１６案,高雄市,三民區,寶慶里,962,1332,457,288,745,70,815
公投第１６案,高雄市,三民區,寶業里,963,1764,559,422,981,96,1077
公投第１６案,高雄市,三民區,寶業里,964,1811,599,400,999,46,1045
公投第１６案,高雄市,三民區,寶業里,965,1693,595,415,1010,69,1079
公投第１６案,高雄市,三民區,寶盛里,966,1684,562,436,998,100,1098
公投第１６案,高雄市,三民區,寶盛里,967,1464,486,303,789,65,854
公投第１６案,高雄市,三民區,寶盛里,968,1719,625,433,1058,56,1114
公投第１６案,高雄市,三民區,寶安里,969,1749,558,403,961,52,1013
公投第１６案,高雄市,三民區,寶安里,970,1908,629,358,987,53,1040
公投第１６案,高雄市,三民區,寶安里,971,1573,543,350,893,74,967
公投第１６案,高雄市,三民區,寶安里,972,1628,513,366,879,54,933
公投第１６案,高雄市,三民區,寶龍里,973,1377,386,268,654,65,719
公投第１６案,高雄市,三民區,寶龍里,974,1530,558,355,913,61,974
公投第１６案,高雄市,三民區,寶龍里,975,1188,333,281,614,64,678
公投第１６案,高雄市,三民區,寶珠里,976,2791,439,336,775,52,827
公投第１６案,高雄市,三民區,寶珠里,977,1840,587,436,1023,73,1096
公投第１６案,高雄市,三民區,寶珠里,978,1671,563,374,937,109,1046
公投第１６案,高雄市,三民區,寶玉里,979,1624,537,378,915,66,981
公投第１６案,高雄市,三民區,寶玉里,980,1555,608,385,993,67,1060
公投第１６案,高雄市,三民區,寶玉里,981,1489,561,365,926,57,983
公投第１６案,高雄市,三民區,寶玉里,982,1662,599,362,961,76,1037
公投第１６案,高雄市,三民區,寶玉里,983,1639,539,357,896,31,927
公投第１６案,高雄市,三民區,灣子里,984,1872,540,456,996,99,1095
公投第１６案,高雄市,三民區,灣子里,985,1968,653,422,1075,82,1157
公投第１６案,高雄市,三民區,灣愛里,986,1471,391,266,657,129,786
公投第１６案,高雄市,三民區,灣愛里,987,1534,460,332,792,84,876
公投第１６案,高雄市,三民區,灣中里,988,1659,481,332,813,94,907
公投第１６案,高雄市,三民區,灣中里,989,1815,517,350,867,48,915
公投第１６案,高雄市,三民區,灣中里,990,1808,543,381,924,60,984
公投第１６案,高雄市,三民區,灣華里,991,1224,373,236,609,47,656
公投第１６案,高雄市,三民區,灣華里,992,1406,452,293,745,34,779
公投第１６案,高雄市,三民區,灣勝里,993,945,287,211,498,36,534
公投第１６案,高雄市,三民區,灣勝里,994,944,314,244,558,45,603
公投第１６案,高雄市,三民區,灣利里,995,1669,510,379,889,92,981
公投第１６案,高雄市,三民區,灣利里,996,1473,457,359,816,100,916
公投第１６案,高雄市,三民區,灣復里,997,1876,546,342,888,69,957
公投第１６案,高雄市,三民區,灣復里,998,1682,250,350,600,66,666
公投第１６案,高雄市,三民區,正興里,999,1791,543,374,917,53,970
公投第１６案,高雄市,三民區,正興里,1000,1808,598,421,1019,75,1094
公投第１６案,高雄市,三民區,正興里,1001,1798,582,341,923,76,999
公投第１６案,高雄市,三民區,正興里,1002,2030,659,466,1125,80,1205
公投第１６案,高雄市,三民區,正興里,1003,2034,711,418,1129,36,1165
公投第１６案,高雄市,三民區,正興里,1004,1998,670,438,1108,48,1156
公投第１６案,高雄市,三民區,正順里,1005,1914,579,381,960,57,1017
公投第１６案,高雄市,三民區,正順里,1006,1965,609,416,1025,56,1081
公投第１６案,高雄市,三民區,灣興里,1007,1885,571,426,997,100,1097
公投第１６案,高雄市,三民區,灣成里,1008,1220,433,277,710,21,731
公投第１６案,高雄市,三民區,灣成里,1009,1057,318,231,549,85,634
公投第１６案,高雄市,三民區,安康里,1010,1434,457,227,684,41,725
公投第１６案,高雄市,三民區,安康里,1011,1350,373,226,599,53,652
公投第１６案,高雄市,三民區,安寧里,1012,872,232,166,398,23,421
公投第１６案,高雄市,三民區,安寧里,1013,954,245,216,461,31,492
公投第１６案,高雄市,三民區,安吉里,1014,1689,582,354,936,36,972
公投第１６案,高雄市,三民區,安吉里,1015,1390,454,285,739,40,779
公投第１６案,高雄市,三民區,安吉里,1016,1336,438,309,747,85,832
公投第１６案,高雄市,三民區,安發里,1017,1437,508,376,884,72,956
公投第１６案,高雄市,三民區,安發里,1018,1452,486,320,806,42,848
公投第１６案,高雄市,三民區,安發里,1019,1513,494,349,843,99,942
公投第１６案,高雄市,三民區,安東里,1020,1467,466,381,847,119,966
公投第１６案,高雄市,三民區,安東里,1021,1381,468,388,856,84,940
公投第１６案,高雄市,三民區,安和里,1022,1117,347,262,609,55,664
公投第１６案,高雄市,三民區,安和里,1023,1327,439,370,809,41,850
公投第１６案,高雄市,三民區,達德里,1024,1304,416,330,746,51,797
公投第１６案,高雄市,三民區,達明里,1025,1483,401,343,744,47,791
公投第１６案,高雄市,三民區,達仁里,1026,1473,477,373,850,62,912
公投第１６案,高雄市,三民區,達勇里,1027,980,310,240,550,54,604
公投第１６案,高雄市,三民區,同德里,1028,1409,362,437,799,74,873
公投第１６案,高雄市,三民區,同德里,1029,1230,374,315,689,66,755
公投第１６案,高雄市,三民區,德智里,1030,1024,334,287,621,65,686
公投第１６案,高雄市,三民區,德智里,1031,1130,368,274,642,71,713
公投第１６案,高雄市,三民區,德仁里,1032,1889,541,391,932,50,982
公投第１６案,高雄市,三民區,安生里,1033,1427,457,324,781,49,830
公投第１６案,高雄市,三民區,德東里,1034,791,241,206,447,32,479
公投第１６案,高雄市,三民區,德行里,1035,1079,365,299,664,98,762
公投第１６案,高雄市,三民區,精華里,1036,1492,451,374,825,79,904
公投第１６案,高雄市,三民區,民享里,1037,1020,326,260,586,72,658
公投第１６案,高雄市,三民區,民享里,1038,1001,321,257,578,11,589
公投第１６案,高雄市,三民區,安宜里,1039,1581,508,361,869,55,924
公投第１６案,高雄市,三民區,安宜里,1040,1471,507,254,761,58,819
公投第１６案,高雄市,三民區,安泰里,1041,1151,343,314,657,32,689
公投第１６案,高雄市,三民區,安泰里,1042,1334,454,316,770,73,843
公投第１６案,高雄市,三民區,安泰里,1043,1275,432,285,717,56,773
公投第１６案,高雄市,三民區,安邦里,1044,1688,393,334,727,40,767
公投第１６案,高雄市,三民區,安邦里,1045,1214,385,294,679,39,718
公投第１６案,高雄市,三民區,安邦里,1046,1149,407,291,698,36,734
公投第１６案,高雄市,三民區,十全里,1047,1667,517,390,907,107,1014
公投第１６案,高雄市,三民區,十美里,1048,1786,506,380,886,50,936
公投第１６案,高雄市,三民區,德北里,1049,896,190,335,525,23,548
公投第１６案,高雄市,三民區,德北里,1050,925,316,198,514,67,581
公投第１６案,高雄市,三民區,立誠里,1051,684,233,183,416,54,470
公投第１６案,高雄市,三民區,立業里,1052,981,333,247,580,75,655
公投第１６案,高雄市,三民區,港東里,1053,1383,382,300,682,85,767
公投第１６案,高雄市,三民區,港新里,1054,1382,422,323,745,62,807
公投第１６案,高雄市,三民區,港西里,1055,808,252,174,426,41,467
公投第１６案,高雄市,三民區,博愛里,1056,1197,377,307,684,33,717
公投第１６案,高雄市,三民區,博惠里,1057,1344,410,300,710,65,775
公投第１６案,高雄市,三民區,博惠里,1058,1344,420,339,759,65,824
公投第１６案,高雄市,三民區,博惠里,1059,1359,458,321,779,32,811
公投第１６案,高雄市,三民區,長明里,1060,1073,347,271,618,67,685
公投第１６案,高雄市,三民區,建東里,1061,1186,344,270,614,61,675
公投第１６案,高雄市,三民區,興德里,1062,1749,567,396,963,80,1043
公投第１６案,高雄市,三民區,鳳南里,1063,877,235,197,432,23,455
公投第１６案,高雄市,三民區,鳳北里,1064,1402,467,327,794,119,913
公投第１６案,高雄市,三民區,德西里,1065,769,260,208,468,26,494
公投第１６案,高雄市,三民區,豐裕里,1066,1207,422,265,687,66,753
公投第１６案,高雄市,三民區,豐裕里,1067,1270,354,245,599,55,654
公投第１６案,高雄市,三民區,川東里,1068,1248,402,257,659,64,723
公投第１６案,高雄市,三民區,裕民里,1069,1263,419,257,676,108,784
公投第１６案,高雄市,三民區,力行里,1070,1101,348,256,604,38,642
公投第１６案,高雄市,三民區,千歲里,1071,1116,384,258,642,36,678
公投第１６案,高雄市,三民區,立德里,1072,1152,379,276,655,40,695
公投第１６案,高雄市,三民區,千北里,1073,1057,344,250,594,73,667
公投第１６案,高雄市,三民區,千秋里,1074,971,289,190,479,55,534
公投第１６案,高雄市,三民區,千秋里,1075,1062,305,253,558,35,593
公投第１６案,高雄市,前金區,三川里,1076,673,187,159,346,17,363
公投第１６案,高雄市,前金區,草江里,1077,1022,366,228,594,34,628
公投第１６案,高雄市,前金區,長城里,1078,1324,401,284,685,44,729
公投第１６案,高雄市,前金區,北金里,1079,839,272,190,462,48,510
公投第１６案,高雄市,前金區,東金里,1080,975,293,229,522,77,599
公投第１６案,高雄市,前金區,新生里,1081,1806,620,383,1003,65,1068
公投第１６案,高雄市,前金區,新生里,1082,1781,587,416,1003,46,1049
公投第１６案,高雄市,前金區,後金里,1083,717,220,194,414,39,453
公投第１６案,高雄市,前金區,長興里,1084,1097,334,263,597,27,624
公投第１６案,高雄市,前金區,青山里,1085,1633,542,360,902,41,943
公投第１６案,高雄市,前金區,民生里,1086,759,267,215,482,39,521
公投第１６案,高雄市,前金區,復元里,1087,948,317,257,574,57,631
公投第１６案,高雄市,前金區,林投里,1088,1009,276,216,492,72,564
公投第１６案,高雄市,前金區,國民里,1089,945,293,236,529,46,575
公投第１６案,高雄市,前金區,社東里,1090,772,278,175,453,24,477
公投第１６案,高雄市,前金區,社東里,1091,757,249,207,456,34,490
公投第１６案,高雄市,前金區,社西里,1092,1047,381,242,623,39,662
公投第１６案,高雄市,前金區,博孝里,1093,985,316,263,579,50,629
公投第１６案,高雄市,前金區,長生里,1094,1674,540,348,888,29,917
公投第１６案,高雄市,前金區,榮復里,1095,1088,326,262,588,43,631
公投第１６案,高雄市,前金區,文西里,1096,893,306,239,545,58,603
公投第１６案,高雄市,前金區,文東里,1097,1184,364,276,640,46,686
公投第１６案,高雄市,新興區,浩然里,1098,828,284,182,466,26,492
公投第１６案,高雄市,新興區,浩然里,1099,963,339,240,579,58,637
公投第１６案,高雄市,新興區,振成里,1100,1075,309,242,551,33,584
公投第１６案,高雄市,新興區,德生里,1101,1488,505,329,834,38,872
公投第１６案,高雄市,新興區,德生里,1102,1438,455,362,817,40,857
公投第１６案,高雄市,新興區,振華里,1103,1049,348,264,612,38,650
公投第１６案,高雄市,新興區,正氣里,1104,1378,446,402,848,73,921
公投第１６案,高雄市,新興區,德政里,1105,666,236,161,397,41,438
公投第１６案,高雄市,新興區,仁聲里,1106,981,308,241,549,30,579
公投第１６案,高雄市,新興區,德望里,1107,933,294,274,568,41,609
公投第１６案,高雄市,新興區,德望里,1108,987,306,242,548,28,576
公投第１６案,高雄市,新興區,華聲里,1109,988,355,224,579,42,621
公投第１６案,高雄市,新興區,蕉園里,1110,735,255,188,443,42,485
公投第１６案,高雄市,新興區,永寧里,1111,1317,422,336,758,33,791
公投第１６案,高雄市,新興區,玉衡里,1112,800,231,179,410,21,431
公投第１６案,高雄市,新興區,順昌里,1113,968,314,253,567,44,611
公投第１６案,高雄市,新興區,順昌里,1114,913,307,217,524,39,563
公投第１６案,高雄市,新興區,文昌里,1115,1389,477,371,848,30,878
公投第１６案,高雄市,新興區,文昌里,1116,1228,435,336,771,56,827
公投第１６案,高雄市,新興區,光耀里,1117,1211,407,285,692,79,771
公投第１６案,高雄市,新興區,光耀里,1118,1101,380,246,626,26,652
公投第１６案,高雄市,新興區,興昌里,1119,752,265,184,449,25,474
公投第１６案,高雄市,新興區,興昌里,1120,873,318,252,570,50,620
公投第１６案,高雄市,新興區,開平里,1121,1609,489,436,925,59,984
公投第１６案,高雄市,新興區,開平里,1122,1736,574,456,1030,67,1097
公投第１６案,高雄市,新興區,成功里,1123,1258,429,264,693,27,720
公投第１６案,高雄市,新興區,新江里,1124,1105,362,269,631,59,690
公投第１６案,高雄市,新興區,黎明里,1125,851,289,193,482,52,534
公投第１６案,高雄市,新興區,愛平里,1126,1011,327,257,584,53,637
公投第１６案,高雄市,新興區,南港里,1127,888,285,260,545,76,621
公投第１６案,高雄市,新興區,南港里,1128,1005,295,253,548,29,577
公投第１６案,高雄市,新興區,中東里,1129,1375,350,242,592,16,608
公投第１６案,高雄市,新興區,中東里,1130,1388,449,343,792,65,857
公投第１６案,高雄市,新興區,明莊里,1131,719,230,154,384,50,434
公投第１６案,高雄市,新興區,大明里,1132,1077,335,239,574,76,650
公投第１６案,高雄市,新興區,秋山里,1133,875,221,196,417,18,435
公投第１６案,高雄市,新興區,長驛里,1134,936,274,211,485,25,510
公投第１６案,高雄市,新興區,建興里,1135,944,289,215,504,57,561
公投第１６案,高雄市,新興區,建華里,1136,833,232,185,417,33,450
公投第１６案,高雄市,新興區,漢民里,1137,708,222,182,404,19,423
公投第１６案,高雄市,新興區,榮治里,1138,741,250,154,404,22,426
公投第１６案,高雄市,新興區,東坡里,1139,1235,315,288,603,37,640
公投第１６案,高雄市,苓雅區,博仁里,1140,718,240,189,429,29,458
公投第１６案,高雄市,苓雅區,苓洲里,1141,1492,471,335,806,53,859
公投第１６案,高雄市,苓雅區,苓昇里,1142,1210,399,273,672,60,732
公投第１６案,高雄市,苓雅區,苓中里,1143,1617,442,340,782,32,814
公投第１６案,高雄市,苓雅區,苓雅里,1144,1428,463,331,794,94,888
公投第１６案,高雄市,苓雅區,苓東里,1145,1444,495,196,691,53,744
公投第１６案,高雄市,苓雅區,城北里,1146,1452,434,340,774,76,850
公投第１６案,高雄市,苓雅區,城西里,1147,554,185,135,320,39,359
公投第１６案,高雄市,苓雅區,城東里,1148,950,296,217,513,23,536
公投第１６案,高雄市,苓雅區,城東里,1149,978,278,226,504,25,529
公投第１６案,高雄市,苓雅區,意誠里,1150,1673,500,300,800,62,862
公投第１６案,高雄市,苓雅區,意誠里,1151,2045,600,424,1024,64,1088
公投第１６案,高雄市,苓雅區,鼓中里,1152,939,331,191,522,67,589
公投第１６案,高雄市,苓雅區,田西里,1153,1284,357,301,658,43,701
公投第１６案,高雄市,苓雅區,人和里,1154,908,318,197,515,34,549
公投第１６案,高雄市,苓雅區,人和里,1155,838,251,201,452,18,470
公投第１６案,高雄市,苓雅區,仁政里,1156,1267,394,323,717,44,761
公投第１６案,高雄市,苓雅區,廣澤里,1157,994,354,239,593,62,655
公投第１６案,高雄市,苓雅區,廣澤里,1158,774,206,192,398,19,417
公投第１６案,高雄市,苓雅區,美田里,1159,1121,373,269,642,32,674
公投第１６案,高雄市,苓雅區,華堂里,1160,1474,462,351,813,63,876
公投第１６案,高雄市,苓雅區,華堂里,1161,1525,512,350,862,77,939
公投第１６案,高雄市,苓雅區,日中里,1162,1147,381,249,630,38,668
公投第１６案,高雄市,苓雅區,日中里,1163,1014,258,262,520,44,564
公投第１６案,高雄市,苓雅區,普照里,1164,1496,467,400,867,47,914
公投第１６案,高雄市,苓雅區,普照里,1165,1499,603,275,878,69,947
公投第１６案,高雄市,苓雅區,和煦里,1166,1138,394,285,679,28,707
公投第１６案,高雄市,苓雅區,和煦里,1167,839,309,232,541,43,584
公投第１６案,高雄市,苓雅區,晴朗里,1168,2088,387,307,694,45,739
公投第１６案,高雄市,苓雅區,普天里,1169,1648,550,397,947,40,987
公投第１６案,高雄市,苓雅區,普天里,1170,1623,534,357,891,67,958
公投第１６案,高雄市,苓雅區,林富里,1171,1932,693,485,1178,61,1239
公投第１６案,高雄市,苓雅區,林圍里,1172,1127,448,298,746,27,773
公投第１６案,高雄市,苓雅區,林圍里,1173,1156,443,321,764,26,790
公投第１６案,高雄市,苓雅區,林安里,1174,1465,481,391,872,41,913
公投第１６案,高雄市,苓雅區,光華里,1175,690,219,128,347,20,367
公投第１６案,高雄市,苓雅區,林興里,1176,1283,358,285,643,99,742
公投第１６案,高雄市,苓雅區,林華里,1177,1432,459,341,800,81,881
公投第１６案,高雄市,苓雅區,林華里,1178,1313,440,306,746,36,782
公投第１６案,高雄市,苓雅區,林西里,1179,1579,442,364,806,35,841
公投第１６案,高雄市,苓雅區,林中里,1180,1385,438,340,778,67,845
公投第１６案,高雄市,苓雅區,林中里,1181,1449,508,336,844,67,911
公投第１６案,高雄市,苓雅區,林泉里,1182,1834,679,422,1101,63,1164
公投第１６案,高雄市,苓雅區,林南里,1183,1436,498,348,846,61,907
公投第１６案,高雄市,苓雅區,林南里,1184,1431,616,250,866,56,922
公投第１６案,高雄市,苓雅區,中正里,1185,1248,460,320,780,29,809
公投第１６案,高雄市,苓雅區,中正里,1186,1470,555,337,892,47,939
公投第１６案,高雄市,苓雅區,尚義里,1187,1540,585,358,943,82,1025
公投第１６案,高雄市,苓雅區,同慶里,1188,1374,475,368,843,29,872
公投第１６案,高雄市,苓雅區,同慶里,1189,839,293,233,526,30,556
公投第１６案,高雄市,苓雅區,凱旋里,1190,1022,382,274,656,44,700
公投第１６案,高雄市,苓雅區,凱旋里,1191,1062,411,253,664,15,679
公投第１６案,高雄市,苓雅區,安祥里,1192,1078,401,241,642,27,669
公投第１６案,高雄市,苓雅區,安祥里,1193,1117,386,288,674,41,715
公投第１６案,高雄市,苓雅區,奏捷里,1194,1516,544,347,891,49,940
公投第１６案,高雄市,苓雅區,福壽里,1195,1440,409,362,771,120,891
公投第１６案,高雄市,苓雅區,福南里,1196,839,266,211,477,38,515
公投第１６案,高雄市,苓雅區,福南里,1197,888,265,204,469,23,492
公投第１６案,高雄市,苓雅區,五權里,1198,1101,370,309,679,30,709
公投第１６案,高雄市,苓雅區,五權里,1199,1004,358,297,655,62,717
公投第１６案,高雄市,苓雅區,民主里,1200,1427,476,346,822,57,879
公投第１６案,高雄市,苓雅區,民主里,1201,1168,405,267,672,30,702
公投第１６案,高雄市,苓雅區,民主里,1202,1184,424,308,732,66,798
公投第１６案,高雄市,苓雅區,林德里,1203,974,347,249,596,39,635
公投第１６案,高雄市,苓雅區,林德里,1204,849,265,174,439,17,456
公投第１６案,高雄市,苓雅區,林貴里,1205,1821,607,434,1041,67,1108
公投第１６案,高雄市,苓雅區,林榮里,1206,1306,395,289,684,58,742
公投第１６案,高雄市,苓雅區,林榮里,1207,1185,413,302,715,27,742
公投第１６案,高雄市,苓雅區,林榮里,1208,1415,474,322,796,53,849
公投第１６案,高雄市,苓雅區,英明里,1209,962,348,258,606,36,642
公投第１６案,高雄市,苓雅區,英明里,1210,964,300,232,532,59,591
公投第１６案,高雄市,苓雅區,林靖里,1211,1524,552,347,899,34,933
公投第１６案,高雄市,苓雅區,朝陽里,1212,1455,469,374,843,36,879
公投第１６案,高雄市,苓雅區,福隆里,1213,1272,358,275,633,48,681
公投第１６案,高雄市,苓雅區,福隆里,1214,1256,370,295,665,23,688
公投第１６案,高雄市,苓雅區,福祥里,1215,1203,376,263,639,31,670
公投第１６案,高雄市,苓雅區,福海里,1216,1062,391,240,631,24,655
公投第１６案,高雄市,苓雅區,福康里,1217,850,282,221,503,59,562
公投第１６案,高雄市,苓雅區,福康里,1218,1010,340,269,609,81,690
公投第１６案,高雄市,苓雅區,福人里,1219,1118,365,240,605,32,637
公投第１６案,高雄市,苓雅區,福人里,1220,937,318,222,540,55,595
公投第１６案,高雄市,苓雅區,福地里,1221,1493,405,319,724,31,755
公投第１６案,高雄市,苓雅區,福地里,1222,1183,445,233,678,36,714
公投第１６案,高雄市,苓雅區,福居里,1223,1318,383,245,628,39,667
公投第１６案,高雄市,苓雅區,福居里,1224,1362,456,295,751,53,804
公投第１６案,高雄市,苓雅區,福東里,1225,1102,326,273,599,75,674
公投第１６案,高雄市,苓雅區,福東里,1226,1481,473,342,815,62,877
公投第１６案,高雄市,苓雅區,福西里,1227,878,297,230,527,53,580
公投第１６案,高雄市,苓雅區,福西里,1228,908,268,182,450,27,477
公投第１６案,高雄市,苓雅區,永康里,1229,1056,395,233,628,61,689
公投第１６案,高雄市,苓雅區,永康里,1230,1091,326,237,563,34,597
公投第１６案,高雄市,苓雅區,正文里,1231,976,335,260,595,26,621
公投第１６案,高雄市,苓雅區,正文里,1232,1063,370,293,663,47,710
公投第１６案,高雄市,苓雅區,正言里,1233,1484,520,359,879,68,947
公投第１６案,高雄市,苓雅區,正言里,1234,1290,398,350,748,42,790
公投第１６案,高雄市,苓雅區,正大里,1235,1740,624,395,1019,63,1082
公投第１６案,高雄市,苓雅區,正大里,1236,1594,511,382,893,66,959
公投第１６案,高雄市,苓雅區,正大里,1237,1648,560,348,908,32,940
公投第１６案,高雄市,苓雅區,五福里,1238,1236,475,270,745,59,804
公投第１６案,高雄市,苓雅區,五福里,1239,1211,404,303,707,48,755
公投第１６案,高雄市,苓雅區,五福里,1240,1283,414,297,711,30,741
公投第１６案,高雄市,苓雅區,正心里,1241,1804,644,410,1054,85,1139
公投第１６案,高雄市,苓雅區,正心里,1242,1718,609,392,1001,76,1077
公投第１６案,高雄市,苓雅區,正道里,1243,1297,452,315,767,59,826
公投第１６案,高雄市,苓雅區,正道里,1244,1449,466,349,815,81,896
公投第１６案,高雄市,苓雅區,正道里,1245,1307,441,296,737,43,780
公投第１６案,高雄市,苓雅區,正義里,1246,1184,411,282,693,61,754
公投第１６案,高雄市,苓雅區,正義里,1247,1250,447,315,762,82,844
公投第１６案,高雄市,苓雅區,正仁里,1248,1248,267,424,691,36,727
公投第１６案,高雄市,苓雅區,正仁里,1249,1283,426,316,742,22,764
公投第１６案,高雄市,苓雅區,文昌里,1250,1121,370,280,650,30,680
公投第１６案,高雄市,苓雅區,文昌里,1251,1258,419,299,718,29,747
公投第１６案,高雄市,苓雅區,文昌里,1252,1339,452,334,786,40,826
公投第１６案,高雄市,苓雅區,建軍里,1253,1986,586,481,1067,58,1125
公投第１６案,高雄市,苓雅區,衛武里,1254,1028,347,217,564,33,597
公投第１６案,高雄市,苓雅區,衛武里,1255,948,310,244,554,21,575
公投第１６案,高雄市,鳳山區,鳳崗里,1256,1080,386,260,646,65,711
公投第１６案,高雄市,鳳山區,縣衙里,1257,819,285,187,472,43,515
公投第１６案,高雄市,鳳山區,曹公里,1258,851,267,204,471,61,532
公投第１６案,高雄市,鳳山區,曹公里,1259,1075,377,258,635,43,678
公投第１６案,高雄市,鳳山區,鎮西里,1260,1223,443,285,728,43,771
公投第１６案,高雄市,鳳山區,鎮西里,1261,1207,396,306,702,48,750
公投第１６案,高雄市,鳳山區,鎮西里,1262,1339,395,287,682,51,733
公投第１６案,高雄市,鳳山區,鎮西里,1263,1188,355,218,573,42,615
公投第１６案,高雄市,鳳山區,北門里,1264,1055,380,208,588,55,643
公投第１６案,高雄市,鳳山區,北門里,1265,1109,365,200,565,73,638
公投第１６案,高雄市,鳳山區,北門里,1266,756,271,204,475,44,519
公投第１６案,高雄市,鳳山區,北門里,1267,1182,353,249,602,54,656
公投第１６案,高雄市,鳳山區,鎮北里,1268,1496,469,338,807,73,880
公投第１６案,高雄市,鳳山區,鎮北里,1269,2094,602,370,972,76,1048
公投第１６案,高雄市,鳳山區,鎮北里,1270,1672,538,348,886,31,917
公投第１６案,高雄市,鳳山區,鎮北里,1271,1761,566,352,918,38,956
公投第１６案,高雄市,鳳山區,鎮北里,1272,1450,452,329,781,84,865
公投第１６案,高雄市,鳳山區,武松里,1273,1455,443,271,714,45,759
公投第１６案,高雄市,鳳山區,武松里,1274,1234,386,278,664,71,735
公投第１６案,高雄市,鳳山區,忠誠里,1275,1713,588,413,1001,71,1072
公投第１６案,高雄市,鳳山區,忠誠里,1276,1698,516,333,849,36,885
公投第１６案,高雄市,鳳山區,文英里,1277,1247,403,304,707,66,773
公投第１６案,高雄市,鳳山區,文英里,1278,1087,374,243,617,45,662
公投第１６案,高雄市,鳳山區,文英里,1279,1199,415,268,683,32,715
公投第１６案,高雄市,鳳山區,文華里,1280,1559,580,261,841,59,900
公投第１６案,高雄市,鳳山區,文華里,1281,1233,414,281,695,47,742
公投第１６案,高雄市,鳳山區,文華里,1282,1277,418,302,720,52,772
公投第１６案,高雄市,鳳山區,文華里,1283,1481,531,281,812,24,836
公投第１６案,高雄市,鳳山區,文華里,1284,1154,421,294,715,24,739
公投第１６案,高雄市,鳳山區,文華里,1285,1475,422,344,766,37,803
公投第１６案,高雄市,鳳山區,文山里,1286,1247,391,221,612,37,649
公投第１６案,高雄市,鳳山區,文山里,1287,1538,458,320,778,70,848
公投第１６案,高雄市,鳳山區,文山里,1288,1097,335,245,580,44,624
公投第１６案,高雄市,鳳山區,文山里,1289,1221,364,246,610,41,651
公投第１６案,高雄市,鳳山區,文山里,1290,1075,435,233,668,64,732
公投第１６案,高雄市,鳳山區,文德里,1291,1751,637,375,1012,51,1063
公投第１６案,高雄市,鳳山區,文德里,1292,1758,611,394,1005,47,1052
公投第１６案,高雄市,鳳山區,文德里,1293,1749,604,341,945,91,1036
公投第１６案,高雄市,鳳山區,文德里,1294,1746,587,354,941,33,974
公投第１６案,高雄市,鳳山區,文德里,1295,1712,590,331,921,49,970
公投第１６案,高雄市,鳳山區,文衡里,1296,1247,413,310,723,28,751
公投第１６案,高雄市,鳳山區,文衡里,1297,1409,480,314,794,63,857
公投第１６案,高雄市,鳳山區,文衡里,1298,1347,451,308,759,52,811
公投第１６案,高雄市,鳳山區,文福里,1299,1771,625,352,977,25,1002
公投第１６案,高雄市,鳳山區,文福里,1300,1537,513,342,855,23,878
公投第１６案,高雄市,鳳山區,文福里,1301,1605,571,344,915,36,951
公投第１６案,高雄市,鳳山區,文福里,1302,1375,483,288,771,57,828
公投第１６案,高雄市,鳳山區,文福里,1303,1393,514,304,818,57,875
公投第１６案,高雄市,鳳山區,文福里,1304,1584,530,297,827,32,859
公投第１６案,高雄市,鳳山區,成功里,1305,618,171,169,340,22,362
公投第１６案,高雄市,鳳山區,縣口里,1306,423,156,94,250,11,261
公投第１６案,高雄市,鳳山區,光明里,1307,1312,415,288,703,63,766
公投第１６案,高雄市,鳳山區,和德里,1308,769,257,176,433,30,463
公投第１６案,高雄市,鳳山區,和德里,1309,1213,434,308,742,30,772
公投第１６案,高雄市,鳳山區,和興里,1310,1107,410,278,688,44,732
公投第１６案,高雄市,鳳山區,和興里,1311,1188,388,289,677,37,714
公投第１６案,高雄市,鳳山區,和興里,1312,1183,475,222,697,38,735
公投第１６案,高雄市,鳳山區,和興里,1313,1264,401,333,734,46,780
公投第１６案,高雄市,鳳山區,南興里,1314,882,279,202,481,43,524
公投第１６案,高雄市,鳳山區,三民里,1315,1007,391,256,647,62,709
公投第１６案,高雄市,鳳山區,新興里,1316,853,261,207,468,69,537
公投第１６案,高雄市,鳳山區,新興里,1317,1660,237,182,419,58,477
公投第１６案,高雄市,鳳山區,興仁里,1318,1124,391,263,654,42,696
公投第１６案,高雄市,鳳山區,興仁里,1319,1112,352,284,636,57,693
公投第１６案,高雄市,鳳山區,興仁里,1320,1182,373,240,613,52,665
公投第１６案,高雄市,鳳山區,興中里,1321,875,340,219,559,68,627
公投第１６案,高雄市,鳳山區,協和里,1322,1040,336,249,585,56,641
公投第１６案,高雄市,鳳山區,協和里,1323,1094,401,266,667,33,700
公投第１６案,高雄市,鳳山區,協和里,1324,1217,457,242,699,58,757
公投第１６案,高雄市,鳳山區,忠義里,1325,974,374,252,626,41,667
公投第１６案,高雄市,鳳山區,忠義里,1326,987,349,204,553,49,602
公投第１６案,高雄市,鳳山區,忠義里,1327,1210,488,264,752,33,785
公投第１６案,高雄市,鳳山區,忠義里,1328,1391,462,314,776,56,832
公投第１６案,高雄市,鳳山區,忠孝里,1329,1241,339,262,601,25,626
公投第１６案,高雄市,鳳山區,忠孝里,1330,1000,361,241,602,44,646
公投第１６案,高雄市,鳳山區,忠孝里,1331,1092,398,233,631,40,671
公投第１６案,高雄市,鳳山區,忠孝里,1332,1308,531,239,770,45,815
公投第１６案,高雄市,鳳山區,忠孝里,1333,1031,373,217,590,59,649
公投第１６案,高雄市,鳳山區,中和里,1334,1159,461,200,661,74,735
公投第１６案,高雄市,鳳山區,中和里,1335,1127,375,241,616,63,679
公投第１６案,高雄市,鳳山區,中和里,1336,1109,437,303,740,57,797
公投第１６案,高雄市,鳳山區,誠義里,1337,1879,709,422,1131,71,1202
公投第１６案,高雄市,鳳山區,誠義里,1338,1803,760,391,1151,53,1204
公投第１６案,高雄市,鳳山區,生明里,1339,2045,676,338,1014,95,1109
公投第１６案,高雄市,鳳山區,鎮東里,1340,1432,467,286,753,65,818
公投第１６案,高雄市,鳳山區,鎮東里,1341,1033,313,201,514,24,538
公投第１６案,高雄市,鳳山區,瑞竹里,1342,1253,417,288,705,95,800
公投第１６案,高雄市,鳳山區,瑞竹里,1343,1217,397,280,677,37,714
公投第１６案,高雄市,鳳山區,瑞竹里,1344,1267,482,283,765,53,818
公投第１６案,高雄市,鳳山區,瑞竹里,1345,1251,410,251,661,44,705
公投第１６案,高雄市,鳳山區,瑞興里,1346,1563,540,325,865,89,954
公投第１６案,高雄市,鳳山區,瑞興里,1347,1888,700,300,1000,72,1072
公投第１６案,高雄市,鳳山區,瑞興里,1348,1368,465,332,797,40,837
公投第１６案,高雄市,鳳山區,東門里,1349,1588,500,313,813,49,862
公投第１６案,高雄市,鳳山區,東門里,1350,1255,528,206,734,71,805
公投第１６案,高雄市,鳳山區,東門里,1351,1264,422,282,704,64,768
公投第１６案,高雄市,鳳山區,東門里,1352,1291,449,284,733,87,820
公投第１６案,高雄市,鳳山區,誠德里,1353,1224,431,232,663,41,704
公投第１６案,高雄市,鳳山區,誠德里,1354,1296,441,271,712,46,758
公投第１６案,高雄市,鳳山區,誠信里,1355,826,316,188,504,52,556
公投第１６案,高雄市,鳳山區,誠信里,1356,1229,457,241,698,53,751
公投第１６案,高雄市,鳳山區,誠智里,1357,1467,555,287,842,57,899
公投第１６案,高雄市,鳳山區,誠智里,1358,1218,414,274,688,57,745
公投第１６案,高雄市,鳳山區,鳳東里,1359,2173,664,433,1097,80,1177
公投第１６案,高雄市,鳳山區,鳳東里,1360,2255,768,467,1235,77,1312
公投第１６案,高雄市,鳳山區,鳳東里,1361,1556,545,341,886,40,926
公投第１６案,高雄市,鳳山區,埤頂里,1362,1521,466,321,787,58,845
公投第１６案,高雄市,鳳山區,埤頂里,1363,1407,423,271,694,50,744
公投第１６案,高雄市,鳳山區,埤頂里,1364,1542,551,326,877,61,938
公投第１６案,高雄市,鳳山區,埤頂里,1365,1502,491,267,758,35,793
公投第１６案,高雄市,鳳山區,中正里,1366,1320,495,274,769,66,835
公投第１６案,高雄市,鳳山區,中正里,1367,1507,568,240,808,43,851
公投第１６案,高雄市,鳳山區,中正里,1368,1284,551,228,779,49,828
公投第１６案,高雄市,鳳山區,海光里,1369,1441,454,286,740,53,793
公投第１６案,高雄市,鳳山區,海光里,1370,1485,522,305,827,92,919
公投第１６案,高雄市,鳳山區,國泰里,1371,1205,363,286,649,62,711
公投第１６案,高雄市,鳳山區,國泰里,1372,1284,373,296,669,35,704
公投第１６案,高雄市,鳳山區,國泰里,1373,1326,469,297,766,64,830
公投第１６案,高雄市,鳳山區,國光里,1374,1096,366,256,622,32,654
公投第１６案,高雄市,鳳山區,國光里,1375,1182,397,278,675,85,760
公投第１６案,高雄市,鳳山區,國光里,1376,1017,260,375,635,61,696
公投第１６案,高雄市,鳳山區,國隆里,1377,1198,343,291,634,86,720
公投第１６案,高雄市,鳳山區,國隆里,1378,1281,370,259,629,44,673
公投第１６案,高雄市,鳳山區,國富里,1379,1358,449,367,816,46,862
公投第１６案,高雄市,鳳山區,國富里,1380,1226,467,293,760,53,813
公投第１６案,高雄市,鳳山區,武慶里,1381,1098,382,264,646,71,717
公投第１６案,高雄市,鳳山區,武慶里,1382,1200,399,283,682,39,721
公投第１６案,高雄市,鳳山區,武漢里,1383,942,291,229,520,49,569
公投第１６案,高雄市,鳳山區,武漢里,1384,1206,379,240,619,40,659
公投第１６案,高雄市,鳳山區,武漢里,1385,1159,408,300,708,39,747
公投第１６案,高雄市,鳳山區,武漢里,1386,1401,505,328,833,53,886
公投第１６案,高雄市,鳳山區,新甲里,1387,1525,487,320,807,30,837
公投第１６案,高雄市,鳳山區,新甲里,1388,1345,416,315,731,47,778
公投第１６案,高雄市,鳳山區,新武里,1389,1180,402,313,715,32,747
公投第１６案,高雄市,鳳山區,新武里,1390,1106,328,237,565,24,589
公投第１６案,高雄市,鳳山區,新泰里,1391,1442,512,325,837,79,916
公投第１６案,高雄市,鳳山區,新泰里,1392,1376,467,324,791,67,858
公投第１６案,高雄市,鳳山區,新泰里,1393,1243,407,298,705,36,741
公投第１６案,高雄市,鳳山區,新樂里,1394,1361,467,288,755,30,785
公投第１６案,高雄市,鳳山區,新樂里,1395,1416,481,336,817,71,888
公投第１６案,高雄市,鳳山區,新樂里,1396,1536,600,348,948,60,1008
公投第１６案,高雄市,鳳山區,新強里,1397,1388,411,293,704,34,738
公投第１６案,高雄市,鳳山區,新強里,1398,1241,409,279,688,89,777
公投第１６案,高雄市,鳳山區,新強里,1399,1394,499,317,816,63,879
公投第１６案,高雄市,鳳山區,新強里,1400,1188,454,295,749,28,777
公投第１６案,高雄市,鳳山區,海洋里,1401,1112,362,265,627,49,676
公投第１６案,高雄市,鳳山區,海洋里,1402,1198,413,322,735,54,789
公投第１６案,高雄市,鳳山區,海洋里,1403,1475,494,311,805,49,854
公投第１６案,高雄市,鳳山區,新富里,1404,1216,367,239,606,49,655
公投第１６案,高雄市,鳳山區,新富里,1405,1318,365,261,626,41,667
公投第１６案,高雄市,鳳山區,新富里,1406,1465,463,339,802,32,834
公投第１６案,高雄市,鳳山區,老爺里,1407,1314,383,261,644,52,696
公投第１６案,高雄市,鳳山區,老爺里,1408,1649,474,291,765,50,815
公投第１６案,高雄市,鳳山區,老爺里,1409,1601,484,303,787,111,898
公投第１６案,高雄市,鳳山區,老爺里,1410,1155,392,227,619,32,651
公投第１６案,高雄市,鳳山區,老爺里,1411,1050,338,247,585,58,643
公投第１６案,高雄市,鳳山區,中民里,1412,1417,431,275,706,24,730
公投第１６案,高雄市,鳳山區,中民里,1413,1525,485,319,804,83,887
公投第１６案,高雄市,鳳山區,中民里,1414,1514,523,331,854,68,922
公投第１６案,高雄市,鳳山區,中崙里,1415,1190,405,243,648,59,707
公投第１６案,高雄市,鳳山區,中崙里,1416,1325,429,264,693,33,726
公投第１６案,高雄市,鳳山區,中榮里,1417,1049,349,246,595,60,655
公投第１６案,高雄市,鳳山區,中榮里,1418,1026,359,214,573,37,610
公投第１６案,高雄市,鳳山區,中榮里,1419,1152,392,271,663,60,723
公投第１６案,高雄市,鳳山區,中榮里,1420,1254,365,260,625,29,654
公投第１６案,高雄市,鳳山區,過埤里,1421,1688,493,335,828,55,883
公投第１６案,高雄市,鳳山區,過埤里,1422,1657,576,314,890,80,970
公投第１６案,高雄市,鳳山區,過埤里,1423,1729,515,347,862,44,906
公投第１６案,高雄市,鳳山區,過埤里,1424,1628,578,354,932,59,991
公投第１６案,高雄市,鳳山區,過埤里,1425,1891,566,345,911,26,937
公投第１６案,高雄市,鳳山區,過埤里,1426,1594,580,358,938,53,991
公投第１６案,高雄市,鳳山區,過埤里,1427,1342,527,291,818,20,838
公投第１６案,高雄市,鳳山區,過埤里,1428,1448,577,316,893,55,948
公投第１６案,高雄市,鳳山區,正義里,1429,1405,490,314,804,64,868
公投第１６案,高雄市,鳳山區,正義里,1430,1097,353,278,631,81,712
公投第１６案,高雄市,鳳山區,正義里,1431,1248,405,310,715,99,814
公投第１６案,高雄市,鳳山區,正義里,1432,1225,407,278,685,77,762
公投第１６案,高雄市,鳳山區,正義里,1433,1214,375,270,645,34,679
公投第１６案,高雄市,鳳山區,保安里,1434,2032,702,458,1160,102,1262
公投第１６案,高雄市,鳳山區,保安里,1435,1927,644,429,1073,81,1154
公投第１６案,高雄市,鳳山區,保安里,1436,2097,958,270,1228,78,1306
公投第１６案,高雄市,鳳山區,一甲里,1437,968,272,232,504,64,568
公投第１６案,高雄市,鳳山區,一甲里,1438,1200,375,242,617,66,683
公投第１６案,高雄市,鳳山區,一甲里,1439,1101,347,254,601,72,673
公投第１６案,高雄市,鳳山區,二甲里,1440,1369,404,287,691,58,749
公投第１６案,高雄市,鳳山區,二甲里,1441,1542,481,332,813,77,890
公投第１６案,高雄市,鳳山區,二甲里,1442,1536,532,360,892,57,949
公投第１６案,高雄市,鳳山區,龍成里,1443,1382,420,277,697,43,740
公投第１６案,高雄市,鳳山區,龍成里,1444,1452,410,374,784,98,882
公投第１６案,高雄市,鳳山區,鎮南里,1445,1058,353,227,580,53,633
公投第１６案,高雄市,鳳山區,鎮南里,1446,976,366,214,580,63,643
公投第１６案,高雄市,鳳山區,鎮南里,1447,1545,446,301,747,56,803
公投第１６案,高雄市,鳳山區,鎮南里,1448,1143,341,274,615,59,674
公投第１６案,高雄市,鳳山區,富甲里,1449,1301,187,132,319,18,337
公投第１６案,高雄市,鳳山區,富甲里,1450,1250,334,227,561,43,604
公投第１６案,高雄市,鳳山區,善美里,1451,1208,389,251,640,68,708
公投第１６案,高雄市,鳳山區,善美里,1452,1202,402,256,658,86,744
公投第１６案,高雄市,鳳山區,善美里,1453,1499,476,310,786,88,874
公投第１６案,高雄市,鳳山區,善美里,1454,1522,471,311,782,71,853
公投第１６案,高雄市,鳳山區,富榮里,1455,1125,397,251,648,70,718
公投第１６案,高雄市,鳳山區,富榮里,1456,1307,429,304,733,41,774
公投第１６案,高雄市,鳳山區,南和里,1457,1405,459,303,762,76,838
公投第１６案,高雄市,鳳山區,南和里,1458,1252,424,249,673,80,753
公投第１６案,高雄市,鳳山區,南成里,1459,1291,470,288,758,35,793
公投第１６案,高雄市,鳳山區,南成里,1460,938,315,204,519,75,594
公投第１６案,高雄市,鳳山區,南成里,1461,1783,603,395,998,52,1050
公投第１６案,高雄市,鳳山區,南成里,1462,1105,367,265,632,42,674
公投第１６案,高雄市,鳳山區,南成里,1463,1392,421,304,725,98,823
公投第１６案,高雄市,鳳山區,南成里,1464,1244,457,327,784,47,831
公投第１６案,高雄市,鳳山區,天興里,1465,1154,330,256,586,69,655
公投第１６案,高雄市,鳳山區,天興里,1466,1153,380,251,631,65,696
公投第１６案,高雄市,鳳山區,天興里,1467,1148,331,206,537,26,563
公投第１６案,高雄市,鳳山區,大德里,1468,1432,416,273,689,137,826
公投第１６案,高雄市,鳳山區,大德里,1469,1429,337,235,572,38,610
公投第１６案,高雄市,鳳山區,大德里,1470,1479,474,312,786,35,821
公投第１６案,高雄市,鳳山區,五福里,1471,1026,338,253,591,50,641
公投第１６案,高雄市,鳳山區,五福里,1472,993,301,267,568,106,674
公投第１６案,高雄市,鳳山區,五福里,1473,947,325,214,539,82,621
公投第１６案,高雄市,鳳山區,福興里,1474,1042,336,211,547,61,608
公投第１６案,高雄市,鳳山區,福興里,1475,1098,346,250,596,65,661
公投第１６案,高雄市,鳳山區,福興里,1476,1284,354,273,627,32,659
公投第１６案,高雄市,鳳山區,福興里,1477,1242,359,261,620,54,674
公投第１６案,高雄市,鳳山區,福興里,1478,1093,359,245,604,83,687
公投第１６案,高雄市,鳳山區,福祥里,1479,1353,396,302,698,61,759
公投第１６案,高雄市,鳳山區,福祥里,1480,1353,410,273,683,23,706
公投第１６案,高雄市,鳳山區,福誠里,1481,1309,439,302,741,66,807
公投第１６案,高雄市,鳳山區,福誠里,1482,1627,530,360,890,63,953
公投第１６案,高雄市,鳳山區,福誠里,1483,1372,435,315,750,95,845
公投第１６案,高雄市,前鎮區,草衙里,1484,1809,491,383,874,126,1000
公投第１６案,高雄市,前鎮區,草衙里,1485,1835,507,403,910,83,993
公投第１６案,高雄市,前鎮區,草衙里,1486,1890,439,318,757,78,835
公投第１６案,高雄市,前鎮區,草衙里,1487,2013,519,409,928,63,991
公投第１６案,高雄市,前鎮區,草衙里,1488,1776,506,363,869,81,950
公投第１６案,高雄市,前鎮區,明孝里,1489,1705,429,327,756,87,843
公投第１６案,高雄市,前鎮區,明孝里,1490,672,203,140,343,79,422
公投第１６案,高雄市,前鎮區,明正里,1491,1726,461,303,764,85,849
公投第１６案,高雄市,前鎮區,明正里,1492,1597,475,377,852,50,902
公投第１６案,高雄市,前鎮區,明正里,1493,1690,540,370,910,96,1006
公投第１６案,高雄市,前鎮區,明義里,1494,1080,363,250,613,77,690
公投第１６案,高雄市,前鎮區,明義里,1495,1159,410,280,690,82,772
公投第１６案,高雄市,前鎮區,仁愛里,1496,1314,396,242,638,81,719
公投第１６案,高雄市,前鎮區,德昌里,1497,896,306,188,494,68,562
公投第１６案,高雄市,前鎮區,德昌里,1498,1002,312,234,546,49,595
公投第１６案,高雄市,前鎮區,平等里,1499,2765,573,373,946,121,1067
公投第１６案,高雄市,前鎮區,平昌里,1500,600,186,129,315,63,378
公投第１６案,高雄市,前鎮區,明禮里,1501,1466,266,217,483,45,528
公投第１６案,高雄市,前鎮區,信義里,1502,1449,408,312,720,56,776
公投第１６案,高雄市,前鎮區,信德里,1503,991,299,184,483,65,548
公投第１６案,高雄市,前鎮區,信德里,1504,1248,412,260,672,86,758
公投第１６案,高雄市,前鎮區,明道里,1505,1066,359,211,570,108,678
公投第１６案,高雄市,前鎮區,興化里,1506,706,185,115,300,39,339
公投第１６案,高雄市,前鎮區,興仁里,1507,713,189,151,340,33,373
公投第１６案,高雄市,前鎮區,前鎮里,1508,1344,370,281,651,47,698
公投第１６案,高雄市,前鎮區,鎮東里,1509,856,244,219,463,61,524
公投第１６案,高雄市,前鎮區,鎮東里,1510,873,223,186,409,49,458
公投第１６案,高雄市,前鎮區,鎮榮里,1511,1114,296,224,520,54,574
公投第１６案,高雄市,前鎮區,鎮榮里,1512,1112,260,240,500,14,514
公投第１６案,高雄市,前鎮區,鎮昌里,1513,1044,292,232,524,68,592
公投第１６案,高雄市,前鎮區,鎮昌里,1514,940,258,220,478,40,518
公投第１６案,高雄市,前鎮區,鎮海里,1515,1342,353,270,623,83,706
公投第１６案,高雄市,前鎮區,鎮海里,1516,1402,518,350,868,60,928
公投第１６案,高雄市,前鎮區,鎮海里,1517,1320,453,314,767,44,811
公投第１６案,高雄市,前鎮區,鎮陽里,1518,958,293,221,514,62,576
公投第１６案,高雄市,前鎮區,興邦里,1519,1276,460,360,820,51,871
公投第１６案,高雄市,前鎮區,興邦里,1520,1459,495,322,817,98,915
公投第１６案,高雄市,前鎮區,鎮中里,1521,761,200,142,342,30,372
公投第１６案,高雄市,前鎮區,鎮北里,1522,1093,309,228,537,28,565
公投第１６案,高雄市,前鎮區,忠純里,1523,1521,638,273,911,55,966
公投第１６案,高雄市,前鎮區,忠純里,1524,1557,638,284,922,40,962
公投第１６案,高雄市,前鎮區,忠純里,1525,1821,580,368,948,35,983
公投第１６案,高雄市,前鎮區,忠誠里,1526,1066,476,212,688,49,737
公投第１６案,高雄市,前鎮區,忠誠里,1527,1046,438,218,656,24,680
公投第１６案,高雄市,前鎮區,西山里,1528,1709,538,388,926,72,998
公投第１６案,高雄市,前鎮區,西山里,1529,1723,573,394,967,97,1064
公投第１６案,高雄市,前鎮區,民權里,1530,1202,438,297,735,51,786
公投第１６案,高雄市,前鎮區,民權里,1531,1279,476,324,800,44,844
公投第１６案,高雄市,前鎮區,民權里,1532,1513,596,336,932,48,980
公投第１６案,高雄市,前鎮區,建隆里,1533,1260,416,277,693,26,719
公投第１６案,高雄市,前鎮區,振興里,1534,1139,418,246,664,91,755
公投第１６案,高雄市,前鎮區,振興里,1535,1140,436,274,710,53,763
公投第１６案,高雄市,前鎮區,良和里,1536,1462,477,353,830,97,927
公投第１６案,高雄市,前鎮區,良和里,1537,1359,483,324,807,44,851
公投第１６案,高雄市,前鎮區,西甲里,1538,2037,535,442,977,83,1060
公投第１６案,高雄市,前鎮區,盛興里,1539,1410,458,285,743,30,773
公投第１６案,高雄市,前鎮區,盛興里,1540,1307,429,275,704,30,734
公投第１６案,高雄市,前鎮區,盛豐里,1541,1512,459,339,798,87,885
公投第１６案,高雄市,前鎮區,盛豐里,1542,1491,450,374,824,92,916
公投第１６案,高雄市,前鎮區,興中里,1543,1621,519,332,851,98,949
公投第１６案,高雄市,前鎮區,興中里,1544,1522,443,298,741,71,812
公投第１６案,高雄市,前鎮區,興東里,1545,1593,507,373,880,70,950
公投第１６案,高雄市,前鎮區,興東里,1546,1885,642,416,1058,95,1153
公投第１６案,高雄市,前鎮區,興東里,1547,1870,626,450,1076,92,1168
公投第１６案,高雄市,前鎮區,忠孝里,1548,1388,496,292,788,33,821
公投第１６案,高雄市,前鎮區,忠孝里,1549,1348,462,286,748,68,816
公投第１６案,高雄市,前鎮區,復國里,1550,1341,388,274,662,110,772
公投第１６案,高雄市,前鎮區,復國里,1551,1364,460,365,825,52,877
公投第１６案,高雄市,前鎮區,竹內里,1552,1367,463,279,742,88,830
公投第１６案,高雄市,前鎮區,竹內里,1553,1326,409,289,698,85,783
公投第１６案,高雄市,前鎮區,竹東里,1554,1059,331,245,576,43,619
公投第１６案,高雄市,前鎮區,竹東里,1555,1119,379,272,651,24,675
公投第１６案,高雄市,前鎮區,竹南里,1556,1565,479,321,800,48,848
公投第１６案,高雄市,前鎮區,竹南里,1557,1549,488,343,831,69,900
公投第１６案,高雄市,前鎮區,竹南里,1558,1691,650,403,1053,49,1102
公投第１６案,高雄市,前鎮區,竹南里,1559,1837,667,398,1065,42,1107
公投第１６案,高雄市,前鎮區,竹北里,1560,1092,378,284,662,22,684
公投第１６案,高雄市,前鎮區,竹北里,1561,1126,387,259,646,60,706
公投第１６案,高雄市,前鎮區,竹西里,1562,1215,366,257,623,80,703
公投第１６案,高雄市,前鎮區,竹西里,1563,1443,465,344,809,46,855
公投第１６案,高雄市,前鎮區,竹西里,1564,1448,578,351,929,37,966
公投第１６案,高雄市,前鎮區,竹中里,1565,1648,555,385,940,73,1013
公投第１６案,高雄市,前鎮區,竹中里,1566,1603,469,352,821,86,907
公投第１６案,高雄市,前鎮區,瑞竹里,1567,1596,448,320,768,29,797
公投第１６案,高雄市,前鎮區,瑞南里,1568,1450,422,263,685,41,726
公投第１６案,高雄市,前鎮區,瑞南里,1569,1510,458,287,745,98,843
公投第１６案,高雄市,前鎮區,瑞南里,1570,1647,536,405,941,96,1037
公投第１６案,高雄市,前鎮區,瑞豐里,1571,1342,430,275,705,69,774
公投第１６案,高雄市,前鎮區,瑞豐里,1572,1384,430,266,696,53,749
公投第１６案,高雄市,前鎮區,瑞祥里,1573,1479,424,319,743,80,823
公投第１６案,高雄市,前鎮區,瑞祥里,1574,1546,497,323,820,45,865
公投第１６案,高雄市,前鎮區,瑞祥里,1575,1595,562,345,907,61,968
公投第１６案,高雄市,前鎮區,瑞東里,1576,1201,421,262,683,61,744
公投第１６案,高雄市,前鎮區,瑞東里,1577,1082,315,236,551,33,584
公投第１６案,高雄市,前鎮區,瑞和里,1578,996,313,186,499,41,540
公投第１６案,高雄市,前鎮區,瑞和里,1579,932,292,211,503,77,580
公投第１６案,高雄市,前鎮區,瑞平里,1580,1146,359,284,643,47,690
公投第１６案,高雄市,前鎮區,瑞平里,1581,1096,395,225,620,37,657
公投第１６案,高雄市,前鎮區,瑞平里,1582,1332,505,301,806,24,830
公投第１６案,高雄市,前鎮區,瑞隆里,1583,1175,384,247,631,53,684
公投第１６案,高雄市,前鎮區,瑞隆里,1584,986,309,225,534,65,599
公投第１６案,高雄市,前鎮區,瑞隆里,1585,1316,409,342,751,75,826
公投第１６案,高雄市,前鎮區,瑞北里,1586,1559,438,310,748,76,824
公投第１６案,高雄市,前鎮區,瑞北里,1587,1622,510,392,902,89,991
公投第１６案,高雄市,前鎮區,瑞西里,1588,1310,391,290,681,39,720
公投第１６案,高雄市,前鎮區,瑞西里,1589,1299,398,288,686,100,786
公投第１６案,高雄市,前鎮區,瑞崗里,1590,1191,429,292,721,73,794
公投第１６案,高雄市,前鎮區,瑞崗里,1591,1375,427,257,684,41,725
公投第１６案,高雄市,前鎮區,瑞興里,1592,1338,435,298,733,40,773
公投第１６案,高雄市,前鎮區,瑞興里,1593,1175,339,262,601,48,649
公投第１６案,高雄市,前鎮區,瑞誠里,1594,1357,415,299,714,35,749
公投第１６案,高雄市,前鎮區,瑞誠里,1595,1187,412,300,712,71,783
公投第１６案,高雄市,前鎮區,瑞文里,1596,1164,365,253,618,52,670
公投第１６案,高雄市,前鎮區,瑞文里,1597,1219,403,301,704,73,777
公投第１６案,高雄市,前鎮區,瑞華里,1598,1428,464,293,757,21,778
公投第１６案,高雄市,前鎮區,瑞華里,1599,1495,469,311,780,100,880
公投第１６案,高雄市,前鎮區,瑞華里,1600,1531,535,338,873,41,914
公投第１６案,高雄市,前鎮區,瑞昌里,1601,1509,479,367,846,77,923
公投第１６案,高雄市,前鎮區,瑞昌里,1602,1591,479,353,832,78,910
公投第１６案,高雄市,小港區,小港里,1603,1108,392,276,668,41,709
公投第１６案,高雄市,小港區,小港里,1604,1171,378,260,638,79,717
公投第１６案,高雄市,小港區,港口里,1605,1557,585,364,949,29,978
公投第１６案,高雄市,小港區,港口里,1606,1668,467,358,825,31,856
公投第１６案,高雄市,小港區,港正里,1607,1183,431,255,686,40,726
公投第１６案,高雄市,小港區,港正里,1608,1372,452,302,754,33,787
公投第１６案,高雄市,小港區,港墘里,1609,1737,591,377,968,80,1048
公投第１６案,高雄市,小港區,港明里,1610,1586,449,365,814,88,902
公投第１６案,高雄市,小港區,港明里,1611,1558,485,283,768,81,849
公投第１６案,高雄市,小港區,港后里,1612,1284,494,294,788,69,857
公投第１６案,高雄市,小港區,港后里,1613,1249,408,311,719,60,779
公投第１６案,高雄市,小港區,港南里,1614,2400,644,381,1025,112,1137
公投第１６案,高雄市,小港區,港興里,1615,1181,369,305,674,44,718
公投第１６案,高雄市,小港區,港興里,1616,1079,365,218,583,36,619
公投第１６案,高雄市,小港區,鳳宮里,1617,1335,400,329,729,57,786
公投第１６案,高雄市,小港區,鳳宮里,1618,1241,408,286,694,74,768
公投第１６案,高雄市,小港區,店鎮里,1619,1513,501,322,823,72,895
公投第１６案,高雄市,小港區,店鎮里,1620,1349,454,299,753,79,832
公投第１６案,高雄市,小港區,店鎮里,1621,1483,445,335,780,53,833
公投第１６案,高雄市,小港區,店鎮里,1622,1451,480,323,803,39,842
公投第１６案,高雄市,小港區,大苓里,1623,1241,379,260,639,32,671
公投第１６案,高雄市,小港區,大苓里,1624,1262,443,326,769,77,846
公投第１６案,高雄市,小港區,二苓里,1625,1813,578,417,995,109,1104
公投第１６案,高雄市,小港區,二苓里,1626,1877,537,345,882,50,932
公投第１６案,高雄市,小港區,三苓里,1627,1391,444,314,758,27,785
公投第１６案,高雄市,小港區,三苓里,1628,1453,488,339,827,50,877
公投第１６案,高雄市,小港區,正苓里,1629,1374,406,430,836,47,883
公投第１６案,高雄市,小港區,正苓里,1630,1348,434,295,729,61,790
公投第１６案,高雄市,小港區,正苓里,1631,1334,500,271,771,64,835
公投第１６案,高雄市,小港區,順苓里,1632,1433,452,322,774,39,813
公投第１６案,高雄市,小港區,順苓里,1633,1448,420,285,705,31,736
公投第１６案,高雄市,小港區,順苓里,1634,1488,524,336,860,92,952
公投第１６案,高雄市,小港區,六苓里,1635,1278,424,288,712,77,789
公投第１６案,高雄市,小港區,六苓里,1636,1306,486,320,806,61,867
公投第１６案,高雄市,小港區,宏亮里,1637,1625,516,362,878,95,973
公投第１６案,高雄市,小港區,宏亮里,1638,1640,563,394,957,89,1046
公投第１６案,高雄市,小港區,山東里,1639,1506,515,300,815,59,874
公投第１６案,高雄市,小港區,山東里,1640,1438,468,269,737,62,799
公投第１６案,高雄市,小港區,青島里,1641,1105,424,271,695,45,740
公投第１６案,高雄市,小港區,青島里,1642,1167,395,223,618,28,646
公投第１６案,高雄市,小港區,濟南里,1643,1420,528,309,837,37,874
公投第１６案,高雄市,小港區,濟南里,1644,1380,548,299,847,60,907
公投第１６案,高雄市,小港區,濟南里,1645,1239,432,253,685,34,719
公投第１６案,高雄市,小港區,泰山里,1646,1563,702,188,890,80,970
公投第１６案,高雄市,小港區,泰山里,1647,1644,455,447,902,81,983
公投第１６案,高雄市,小港區,山明里,1648,1895,602,396,998,87,1085
公投第１６案,高雄市,小港區,山明里,1649,1748,549,343,892,109,1001
公投第１６案,高雄市,小港區,山明里,1650,1579,490,398,888,86,974
公投第１６案,高雄市,小港區,山明里,1651,2135,649,467,1116,53,1169
公投第１６案,高雄市,小港區,山明里,1652,1728,559,369,928,85,1013
公投第１６案,高雄市,小港區,山明里,1653,2022,582,406,988,73,1061
公投第１６案,高雄市,小港區,高松里,1654,1329,359,232,591,37,628
公投第１６案,高雄市,小港區,高松里,1655,1320,410,275,685,44,729
公投第１６案,高雄市,小港區,高松里,1656,1267,375,309,684,91,775
公投第１６案,高雄市,小港區,松金里,1657,1298,421,324,745,83,828
公投第１６案,高雄市,小港區,松金里,1658,1289,426,318,744,50,794
公投第１６案,高雄市,小港區,松山里,1659,1534,488,373,861,47,908
公投第１６案,高雄市,小港區,松山里,1660,1494,501,327,828,63,891
公投第１６案,高雄市,小港區,大坪里,1661,1377,450,291,741,84,825
公投第１６案,高雄市,小港區,大坪里,1662,1344,495,285,780,82,862
公投第１６案,高雄市,小港區,坪頂里,1663,1508,478,313,791,71,862
公投第１６案,高雄市,小港區,坪頂里,1664,1400,375,342,717,35,752
公投第１６案,高雄市,小港區,坪頂里,1665,1457,504,318,822,68,890
公投第１６案,高雄市,小港區,坪頂里,1666,1392,458,282,740,37,777
公投第１６案,高雄市,小港區,孔宅里,1667,1983,594,401,995,92,1087
公投第１６案,高雄市,小港區,孔宅里,1668,1204,413,226,639,37,676
公投第１６案,高雄市,小港區,孔宅里,1669,1300,509,292,801,58,859
公投第１６案,高雄市,小港區,廈莊里,1670,1857,587,450,1037,115,1152
公投第１６案,高雄市,小港區,廈莊里,1671,1566,336,537,873,39,912
公投第１６案,高雄市,小港區,合作里,1672,1343,474,329,803,82,885
公投第１６案,高雄市,小港區,合作里,1673,1236,422,300,722,89,811
公投第１６案,高雄市,小港區,桂林里,1674,1564,536,342,878,104,982
公投第１６案,高雄市,小港區,桂林里,1675,1484,453,327,780,42,822
公投第１６案,高雄市,小港區,桂林里,1676,1477,469,323,792,41,833
公投第１６案,高雄市,小港區,桂林里,1677,1482,511,363,874,45,919
公投第１６案,高雄市,小港區,桂林里,1678,1708,522,353,875,34,909
公投第１６案,高雄市,小港區,中厝里,1679,1867,579,419,998,75,1073
公投第１６案,高雄市,小港區,中厝里,1680,1709,470,338,808,32,840
公投第１６案,高雄市,小港區,鳳鳴里,1681,1425,406,297,703,82,785
公投第１６案,高雄市,小港區,鳳鳴里,1682,1696,439,313,752,57,809
公投第１６案,高雄市,小港區,龍鳳里,1683,1522,419,268,687,58,745
公投第１６案,高雄市,小港區,龍鳳里,1684,1531,499,286,785,119,904
公投第１６案,高雄市,小港區,鳳森里,1685,2215,609,454,1063,165,1228
公投第１６案,高雄市,小港區,鳳林里,1686,1515,411,342,753,53,806
公投第１６案,高雄市,小港區,鳳林里,1687,1535,405,309,714,37,751
公投第１６案,高雄市,小港區,鳳興里,1688,1276,390,266,656,39,695
公投第１６案,高雄市,小港區,鳳興里,1689,1217,337,235,572,41,613
公投第１６案,高雄市,小港區,鳳源里,1690,1707,483,292,775,76,851
公投第１６案,高雄市,小港區,鳳源里,1691,1920,527,355,882,145,1027
公投第１６案,高雄市,大寮區,拷潭里,1692,727,196,136,332,34,366
公投第１６案,高雄市,大寮區,拷潭里,1693,718,163,156,319,20,339
公投第１６案,高雄市,大寮區,內坑里,1694,1340,369,233,602,63,665
公投第１６案,高雄市,大寮區,內坑里,1695,1575,410,264,674,65,739
公投第１６案,高雄市,大寮區,內坑里,1696,444,128,107,235,27,262
公投第１６案,高雄市,大寮區,內坑里,1697,2374,604,390,994,63,1057
公投第１６案,高雄市,大寮區,大寮里,1698,1291,423,224,647,82,729
公投第１６案,高雄市,大寮區,大寮里,1699,1400,417,300,717,95,812
公投第１６案,高雄市,大寮區,大寮里,1700,1390,413,289,702,35,737
公投第１６案,高雄市,大寮區,大寮里,1701,1401,419,279,698,82,780
公投第１６案,高雄市,大寮區,大寮里,1702,1199,363,216,579,38,617
公投第１６案,高雄市,大寮區,上寮里,1703,1210,304,246,550,37,587
公投第１６案,高雄市,大寮區,上寮里,1704,1195,363,253,616,49,665
公投第１６案,高雄市,大寮區,三隆里,1705,1166,319,247,566,34,600
公投第１６案,高雄市,大寮區,三隆里,1706,1353,392,307,699,46,745
公投第１６案,高雄市,大寮區,三隆里,1707,1052,332,242,574,82,656
公投第１６案,高雄市,大寮區,三隆里,1708,1024,289,142,431,31,462
公投第１６案,高雄市,大寮區,琉球里,1709,1189,359,272,631,31,662
公投第１６案,高雄市,大寮區,琉球里,1710,1512,514,299,813,103,916
公投第１６案,高雄市,大寮區,琉球里,1711,1633,446,346,792,88,880
公投第１６案,高雄市,大寮區,翁園里,1712,1214,366,283,649,81,730
公投第１６案,高雄市,大寮區,翁園里,1713,1258,445,270,715,91,806
公投第１６案,高雄市,大寮區,翁園里,1714,1323,417,304,721,32,753
公投第１６案,高雄市,大寮區,前庄里,1715,1253,447,261,708,50,758
公投第１６案,高雄市,大寮區,前庄里,1716,1035,342,297,639,84,723
公投第１６案,高雄市,大寮區,中庄里,1717,1106,330,242,572,40,612
公投第１６案,高雄市,大寮區,中庄里,1718,1195,374,262,636,51,687
公投第１６案,高雄市,大寮區,中庄里,1719,1051,231,345,576,22,598
公投第１６案,高雄市,大寮區,中庄里,1720,1425,450,312,762,91,853
公投第１６案,高雄市,大寮區,中庄里,1721,1635,510,333,843,71,914
公投第１６案,高雄市,大寮區,中庄里,1722,1359,478,267,745,65,810
公投第１６案,高雄市,大寮區,中庄里,1723,1361,439,295,734,72,806
公投第１６案,高雄市,大寮區,中庄里,1724,1629,524,338,862,59,921
公投第１６案,高雄市,大寮區,後庄里,1725,1518,455,382,837,49,886
公投第１６案,高雄市,大寮區,後庄里,1726,1620,482,338,820,77,897
公投第１６案,高雄市,大寮區,後庄里,1727,1648,498,338,836,26,862
公投第１６案,高雄市,大寮區,後庄里,1728,1385,480,265,745,55,800
公投第１６案,高雄市,大寮區,後庄里,1729,1435,435,294,729,40,769
公投第１６案,高雄市,大寮區,義仁里,1730,1046,320,226,546,22,568
公投第１６案,高雄市,大寮區,義仁里,1731,789,221,157,378,43,421
公投第１６案,高雄市,大寮區,新厝里,1732,909,255,194,449,43,492
公投第１６案,高雄市,大寮區,新厝里,1733,733,232,165,397,36,433
公投第１６案,高雄市,大寮區,過溪里,1734,1553,409,418,827,18,845
公投第１６案,高雄市,大寮區,過溪里,1735,922,269,207,476,27,503
公投第１６案,高雄市,大寮區,潮寮里,1736,1012,287,222,509,83,592
公投第１６案,高雄市,大寮區,潮寮里,1737,968,177,295,472,70,542
公投第１６案,高雄市,大寮區,潮寮里,1738,1021,320,199,519,34,553
公投第１６案,高雄市,大寮區,會結里,1739,1554,412,269,681,80,761
公投第１６案,高雄市,大寮區,會社里,1740,1120,384,234,618,69,687
公投第１６案,高雄市,大寮區,會社里,1741,1225,441,266,707,60,767
公投第１６案,高雄市,大寮區,會社里,1742,1320,279,203,482,31,513
公投第１６案,高雄市,大寮區,會社里,1743,1317,430,269,699,46,745
公投第１６案,高雄市,大寮區,會社里,1744,1119,342,233,575,26,601
公投第１６案,高雄市,大寮區,山頂里,1745,1190,392,271,663,60,723
公投第１６案,高雄市,大寮區,山頂里,1746,1229,405,285,690,61,751
公投第１６案,高雄市,大寮區,山頂里,1747,1178,417,289,706,48,754
公投第１６案,高雄市,大寮區,山頂里,1748,1272,245,520,765,27,792
公投第１６案,高雄市,大寮區,山頂里,1749,1413,433,313,746,32,778
公投第１６案,高雄市,大寮區,山頂里,1750,1185,406,277,683,56,739
公投第１６案,高雄市,大寮區,忠義里,1751,553,189,107,296,10,306
公投第１６案,高雄市,大寮區,永芳里,1752,1121,315,232,547,81,628
公投第１６案,高雄市,大寮區,永芳里,1753,1227,420,242,662,34,696
公投第１６案,高雄市,大寮區,永芳里,1754,1058,388,248,636,82,718
公投第１６案,高雄市,大寮區,永芳里,1755,1209,392,259,651,46,697
公投第１６案,高雄市,大寮區,永芳里,1756,1100,392,227,619,18,637
公投第１６案,高雄市,大寮區,永芳里,1757,1122,323,235,558,33,591
公投第１６案,高雄市,大寮區,義和里,1758,983,316,241,557,87,644
公投第１６案,高雄市,大寮區,義和里,1759,1192,341,234,575,35,610
公投第１６案,高雄市,大寮區,溪寮里,1760,719,185,173,358,28,386
公投第１６案,高雄市,大寮區,溪寮里,1761,829,273,182,455,28,483
公投第１６案,高雄市,大寮區,江山里,1762,771,266,197,463,70,533
公投第１６案,高雄市,大寮區,江山里,1763,1075,318,275,593,83,676
公投第１６案,高雄市,大寮區,昭明里,1764,1280,408,292,700,90,790
公投第１６案,高雄市,大寮區,昭明里,1765,1179,309,269,578,118,696
公投第１６案,高雄市,大寮區,昭明里,1766,1210,357,241,598,45,643
公投第１６案,高雄市,大寮區,光武里,1767,189,74,31,105,11,116
公投第１６案,高雄市,大寮區,中興里,1768,1228,422,262,684,67,751
公投第１６案,高雄市,大寮區,中興里,1769,1170,413,211,624,49,673
公投第１６案,高雄市,大寮區,中興里,1770,1416,518,290,808,66,874
公投第１６案,高雄市,大寮區,中興里,1771,1482,547,304,851,58,909
公投第１６案,高雄市,大寮區,中興里,1772,1478,480,263,743,76,819
公投第１６案,高雄市,林園區,東林里,1773,1262,391,279,670,93,763
公投第１６案,高雄市,林園區,東林里,1774,1562,459,287,746,80,826
公投第１６案,高雄市,林園區,林園里,1775,1078,343,222,565,33,598
公投第１６案,高雄市,林園區,林園里,1776,979,351,220,571,58,629
公投第１６案,高雄市,林園區,林園里,1777,1195,343,277,620,58,678
公投第１６案,高雄市,林園區,溪州里,1778,1380,383,291,674,81,755
公投第１６案,高雄市,林園區,溪州里,1779,1280,372,270,642,90,732
公投第１６案,高雄市,林園區,溪州里,1780,1269,388,215,603,50,653
公投第１６案,高雄市,林園區,潭頭里,1781,1568,379,260,639,29,668
公投第１６案,高雄市,林園區,潭頭里,1782,1226,443,233,676,59,735
公投第１６案,高雄市,林園區,中厝里,1783,1480,486,263,749,64,813
公投第１６案,高雄市,林園區,中厝里,1784,1459,497,290,787,77,864
公投第１６案,高雄市,林園區,中門里,1785,1593,452,306,758,67,825
公投第１６案,高雄市,林園區,中門里,1786,895,279,190,469,72,541
公投第１６案,高雄市,林園區,頂厝里,1787,1110,307,227,534,44,578
公投第１６案,高雄市,林園區,頂厝里,1788,1348,386,268,654,80,734
公投第１６案,高雄市,林園區,頂厝里,1789,912,286,204,490,56,546
公投第１６案,高雄市,林園區,頂厝里,1790,1085,390,244,634,70,704
公投第１６案,高雄市,林園區,港埔里,1791,955,284,194,478,40,518
公投第１６案,高雄市,林園區,港埔里,1792,879,280,194,474,70,544
公投第１６案,高雄市,林園區,西溪里,1793,1103,361,211,572,75,647
公投第１６案,高雄市,林園區,西溪里,1794,1054,376,225,601,82,683
公投第１６案,高雄市,林園區,西溪里,1795,1292,356,232,588,20,608
公投第１６案,高雄市,林園區,港嘴里,1796,1683,440,288,728,40,768
公投第１６案,高雄市,林園區,北汕里,1797,607,195,116,311,39,350
公投第１６案,高雄市,林園區,北汕里,1798,1012,297,205,502,90,592
公投第１６案,高雄市,林園區,林內里,1799,1046,341,209,550,70,620
公投第１６案,高雄市,林園區,林內里,1800,914,253,146,399,29,428
公投第１６案,高雄市,林園區,王公里,1801,1405,431,308,739,84,823
公投第１６案,高雄市,林園區,王公里,1802,1299,444,261,705,87,792
公投第１６案,高雄市,林園區,王公里,1803,1170,354,239,593,46,639
公投第１６案,高雄市,林園區,林家里,1804,1299,322,239,561,41,602
公投第１６案,高雄市,林園區,龔厝里,1805,1031,317,219,536,50,586
公投第１６案,高雄市,林園區,龔厝里,1806,849,243,164,407,31,438
公投第１６案,高雄市,林園區,鳳芸里,1807,838,207,179,386,74,460
公投第１６案,高雄市,林園區,鳳芸里,1808,938,313,166,479,44,523
公投第１６案,高雄市,林園區,中芸里,1809,1051,291,184,475,48,523
公投第１６案,高雄市,林園區,中芸里,1810,786,228,187,415,63,478
公投第１６案,高雄市,林園區,東汕里,1811,894,274,206,480,71,551
公投第１６案,高雄市,林園區,西汕里,1812,749,171,81,252,25,277
公投第１６案,高雄市,林園區,仁愛里,1813,1485,502,323,825,50,875
公投第１６案,高雄市,林園區,仁愛里,1814,1478,470,299,769,125,894
公投第１６案,高雄市,林園區,文賢里,1815,1345,482,304,786,72,858
公投第１６案,高雄市,林園區,文賢里,1816,1038,309,214,523,51,574
公投第１６案,高雄市,林園區,廣應里,1817,1203,403,259,662,33,695
公投第１６案,高雄市,林園區,廣應里,1818,1138,342,262,604,39,643
公投第１６案,高雄市,林園區,廣應里,1819,1025,284,187,471,27,498
公投第１６案,高雄市,林園區,五福里,1820,1341,423,276,699,90,789
公投第１６案,高雄市,林園區,五福里,1821,1218,405,111,516,42,558
公投第１６案,高雄市,林園區,中汕里,1822,1147,284,176,460,32,492
公投第１６案,高雄市,林園區,中汕里,1823,1176,281,194,475,35,510
公投第１６案,新北市,石門區,德茂里,1,1121,281,229,510,70,580
公投第１６案,新北市,石門區,富基里,2,1389,329,259,588,84,672
公投第１６案,新北市,石門區,老梅里,3,933,257,185,442,52,494
公投第１６案,新北市,石門區,老梅里,4,1244,328,212,540,79,619
公投第１６案,新北市,石門區,山溪里,5,883,231,146,377,108,485
公投第１６案,新北市,石門區,石門里,6,1564,444,311,755,78,833
公投第１６案,新北市,石門區,尖鹿里,7,1500,413,303,716,82,798
公投第１６案,新北市,石門區,乾華里,8,328,88,40,128,23,151
公投第１６案,新北市,石門區,茂林里,9,651,197,176,373,31,404
公投第１６案,新北市,石門區,草里里,10,915,208,144,352,60,412
公投第１６案,新北市,三芝區,八賢里,11,312,83,51,134,13,147
公投第１６案,新北市,三芝區,埔頭里,12,1421,403,244,647,38,685
公投第１６案,新北市,三芝區,埔頭里,13,1557,468,276,744,59,803
公投第１６案,新北市,三芝區,埔頭里,14,1828,465,380,845,85,930
公投第１６案,新北市,三芝區,古庄里,15,1060,265,221,486,54,540
公投第１６案,新北市,三芝區,新庄里,16,819,189,120,309,49,358
公投第１６案,新北市,三芝區,埔坪里,17,1701,403,273,676,42,718
公投第１６案,新北市,三芝區,埔坪里,18,1740,433,326,759,80,839
公投第１６案,新北市,三芝區,埔坪里,19,1451,334,285,619,60,679
公投第１６案,新北市,三芝區,埔坪里,20,1248,300,202,502,72,574
公投第１６案,新北市,三芝區,茂長里,21,629,171,130,301,22,323
公投第１６案,新北市,三芝區,橫山里,22,504,123,85,208,24,232
公投第１６案,新北市,三芝區,錫板里,23,698,151,138,289,22,311
公投第１６案,新北市,三芝區,後厝里,24,2069,528,352,880,74,954
公投第１６案,新北市,三芝區,福德里,25,784,216,155,371,45,416
公投第１６案,新北市,三芝區,圓山里,26,522,122,108,230,33,263
公投第１６案,新北市,三芝區,店子里,27,587,127,97,224,80,304
公投第１６案,新北市,三芝區,興華里,28,1189,306,243,549,57,606
公投第１６案,新北市,淡水區,中和里,29,544,139,106,245,43,288
公投第１６案,新北市,淡水區,屯山里,30,1044,305,197,502,80,582
公投第１６案,新北市,淡水區,賢孝里,31,1462,417,260,677,58,735
公投第１６案,新北市,淡水區,興仁里,32,1525,416,291,707,93,800
公投第１６案,新北市,淡水區,蕃薯里,33,986,240,179,419,47,466
公投第１６案,新北市,淡水區,忠山里,34,806,245,155,400,45,445
公投第１６案,新北市,淡水區,義山里,35,1173,340,224,564,94,658
公投第１６案,新北市,淡水區,義山里,36,1343,338,219,557,68,625
公投第１６案,新北市,淡水區,水源里,37,1153,282,185,467,28,495
公投第１６案,新北市,淡水區,水源里,38,874,188,181,369,55,424
公投第１６案,新北市,淡水區,忠寮里,39,1063,258,238,496,92,588
公投第１６案,新北市,淡水區,樹興里,40,1309,346,236,582,59,641
公投第１６案,新北市,淡水區,坪頂里,41,1290,347,279,626,67,693
公投第１６案,新北市,淡水區,福德里,42,1675,565,342,907,52,959
公投第１６案,新北市,淡水區,福德里,43,1589,493,331,824,60,884
公投第１６案,新北市,淡水區,福德里,44,1624,559,322,881,63,944
公投第１６案,新北市,淡水區,福德里,45,1241,372,249,621,44,665
公投第１６案,新北市,淡水區,竹圍里,46,1317,355,284,639,71,710
公投第１６案,新北市,淡水區,竹圍里,47,1225,395,260,655,41,696
公投第１６案,新北市,淡水區,竹圍里,48,1426,431,306,737,52,789
公投第１６案,新北市,淡水區,竹圍里,49,1610,542,357,899,40,939
公投第１６案,新北市,淡水區,民權里,50,1982,601,414,1015,68,1083
公投第１６案,新北市,淡水區,民權里,51,1924,493,335,828,64,892
公投第１６案,新北市,淡水區,民生里,52,1822,504,369,873,52,925
公投第１６案,新北市,淡水區,民生里,53,1232,338,292,630,92,722
公投第１６案,新北市,淡水區,民生里,54,1588,473,342,815,91,906
公投第１６案,新北市,淡水區,民生里,55,1784,506,337,843,59,902
公投第１６案,新北市,淡水區,八勢里,56,1762,481,382,863,64,927
公投第１６案,新北市,淡水區,八勢里,57,1546,466,302,768,51,819
公投第１６案,新北市,淡水區,八勢里,58,1897,559,406,965,56,1021
公投第１６案,新北市,淡水區,竿蓁里,59,1489,453,295,748,51,799
公投第１６案,新北市,淡水區,竿蓁里,60,1679,502,311,813,62,875
公投第１６案,新北市,淡水區,竿蓁里,61,1693,479,315,794,52,846
公投第１６案,新北市,淡水區,竿蓁里,62,1674,507,326,833,29,862
公投第１６案,新北市,淡水區,竿蓁里,63,1330,419,271,690,39,729
公投第１６案,新北市,淡水區,竿蓁里,64,1467,449,291,740,28,768
公投第１６案,新北市,淡水區,崁頂里,65,1837,585,341,926,43,969
公投第１６案,新北市,淡水區,崁頂里,66,1924,378,248,626,27,653
公投第１６案,新北市,淡水區,崁頂里,67,2340,692,446,1138,39,1177
公投第１６案,新北市,淡水區,崁頂里,68,1704,387,301,688,99,787
公投第１６案,新北市,淡水區,崁頂里,69,1363,414,257,671,48,719
公投第１６案,新北市,淡水區,崁頂里,70,3068,844,520,1364,52,1416
公投第１６案,新北市,淡水區,埤島里,71,1528,393,305,698,50,748
公投第１６案,新北市,淡水區,水碓里,72,1600,429,304,733,80,813
公投第１６案,新北市,淡水區,水碓里,73,1874,576,393,969,90,1059
公投第１６案,新北市,淡水區,水碓里,74,1567,454,300,754,80,834
公投第１６案,新北市,淡水區,北新里,75,1245,410,258,668,32,700
公投第１６案,新北市,淡水區,北新里,76,1211,329,250,579,43,622
公投第１６案,新北市,淡水區,正德里,77,1992,631,417,1048,62,1110
公投第１６案,新北市,淡水區,正德里,78,2028,643,376,1019,52,1071
公投第１６案,新北市,淡水區,新興里,79,1373,426,275,701,79,780
公投第１６案,新北市,淡水區,新興里,80,1732,539,325,864,62,926
公投第１６案,新北市,淡水區,新興里,81,1519,401,298,699,58,757
公投第１６案,新北市,淡水區,新興里,82,1727,447,336,783,35,818
公投第１６案,新北市,淡水區,新義里,83,1297,364,279,643,70,713
公投第１６案,新北市,淡水區,新義里,84,1066,298,215,513,56,569
公投第１６案,新北市,淡水區,新義里,85,1387,419,287,706,65,771
公投第１６案,新北市,淡水區,新春里,86,1909,571,404,975,64,1039
公投第１６案,新北市,淡水區,新春里,87,1770,544,353,897,54,951
公投第１６案,新北市,淡水區,新春里,88,2049,567,383,950,80,1030
公投第１６案,新北市,淡水區,新春里,89,1680,477,357,834,71,905
公投第１６案,新北市,淡水區,新民里,90,1433,449,335,784,67,851
公投第１６案,新北市,淡水區,新民里,91,1365,388,298,686,46,732
公投第１６案,新北市,淡水區,新民里,92,1452,463,295,758,61,819
公投第１６案,新北市,淡水區,北投里,93,1804,561,350,911,59,970
公投第１６案,新北市,淡水區,北投里,94,1322,375,279,654,45,699
公投第１６案,新北市,淡水區,北投里,95,2019,601,399,1000,45,1045
公投第１６案,新北市,淡水區,北投里,96,1696,541,395,936,49,985
公投第１６案,新北市,淡水區,北投里,97,1576,497,338,835,47,882
公投第１６案,新北市,淡水區,鄧公里,98,1781,578,367,945,53,998
公投第１６案,新北市,淡水區,鄧公里,99,1665,555,361,916,59,975
公投第１６案,新北市,淡水區,鄧公里,100,2013,579,397,976,74,1050
公投第１６案,新北市,淡水區,幸福里,101,1108,295,243,538,54,592
公投第１６案,新北市,淡水區,幸福里,102,1305,386,261,647,65,712
公投第１６案,新北市,淡水區,幸福里,103,1199,328,284,612,25,637
公投第１６案,新北市,淡水區,學府里,104,2017,615,392,1007,67,1074
公投第１６案,新北市,淡水區,學府里,105,2125,561,401,962,73,1035
公投第１６案,新北市,淡水區,中興里,106,1289,318,234,552,32,584
公投第１６案,新北市,淡水區,中興里,107,1319,427,288,715,69,784
公投第１６案,新北市,淡水區,中興里,108,1051,309,233,542,38,580
公投第１６案,新北市,淡水區,長庚里,109,1348,368,300,668,53,721
公投第１６案,新北市,淡水區,清文里,110,1106,314,218,532,38,570
公投第１６案,新北市,淡水區,草東里,111,717,206,171,377,43,420
公投第１６案,新北市,淡水區,協元里,112,1385,377,297,674,50,724
公投第１６案,新北市,淡水區,永吉里,113,841,247,214,461,45,506
公投第１６案,新北市,淡水區,民安里,114,665,192,155,347,35,382
公投第１６案,新北市,淡水區,新生里,115,419,126,101,227,24,251
公投第１６案,新北市,淡水區,文化里,116,1599,490,351,841,42,883
公投第１６案,新北市,淡水區,油車里,117,1670,469,348,817,64,881
公投第１６案,新北市,淡水區,油車里,118,1683,552,328,880,72,952
公投第１６案,新北市,淡水區,油車里,119,1577,430,294,724,71,795
公投第１６案,新北市,淡水區,沙崙里,120,1618,442,320,762,47,809
公投第１６案,新北市,淡水區,沙崙里,121,2214,576,375,951,72,1023
公投第１６案,新北市,淡水區,大庄里,122,1832,515,348,863,88,951
公投第１６案,新北市,淡水區,大庄里,123,2123,653,371,1024,85,1109
公投第１６案,新北市,淡水區,大庄里,124,2998,808,457,1265,35,1300
公投第１６案,新北市,八里區,龍源里,125,1498,393,269,662,80,742
公投第１６案,新北市,八里區,龍源里,126,1939,497,349,846,56,902
公投第１６案,新北市,八里區,龍源里,127,1516,402,322,724,84,808
公投第１６案,新北市,八里區,龍源里,128,1642,512,342,854,83,937
公投第１６案,新北市,八里區,米倉里,129,1927,473,368,841,96,937
公投第１６案,新北市,八里區,米倉里,130,1276,372,249,621,69,690
公投第１６案,新北市,八里區,大崁里,131,1349,430,291,721,69,790
公投第１６案,新北市,八里區,大崁里,132,1403,421,295,716,73,789
公投第１６案,新北市,八里區,埤頭里,133,1644,471,336,807,83,890
公投第１６案,新北市,八里區,埤頭里,134,1853,539,380,919,68,987
公投第１６案,新北市,八里區,頂罟里,135,1793,568,382,950,90,1040
公投第１６案,新北市,八里區,舊城里,136,1644,446,357,803,80,883
公投第１６案,新北市,八里區,舊城里,137,1846,486,400,886,77,963
公投第１６案,新北市,八里區,舊城里,138,1346,375,267,642,77,719
公投第１６案,新北市,八里區,舊城里,139,1621,471,334,805,68,873
公投第１６案,新北市,八里區,訊塘里,140,2110,528,325,853,86,939
公投第１６案,新北市,八里區,訊塘里,141,1967,522,382,904,98,1002
公投第１６案,新北市,八里區,荖阡里,142,1626,478,338,816,82,898
公投第１６案,新北市,八里區,長坑里,143,1514,447,305,752,81,833
公投第１６案,新北市,八里區,下罟里,144,1456,449,271,720,114,834
公投第１６案,新北市,林口區,東林里,145,1268,350,268,618,62,680
公投第１６案,新北市,林口區,東林里,146,1171,319,226,545,62,607
公投第１６案,新北市,林口區,東林里,147,1218,373,267,640,58,698
公投第１６案,新北市,林口區,林口里,148,1788,522,396,918,65,983
公投第１６案,新北市,林口區,林口里,149,1625,436,308,744,83,827
公投第１６案,新北市,林口區,林口里,150,1448,413,264,677,79,756
公投第１６案,新北市,林口區,西林里,151,1328,341,251,592,90,682
公投第１６案,新北市,林口區,西林里,152,1523,367,266,633,75,708
公投第１６案,新北市,林口區,西林里,153,1245,390,235,625,59,684
公投第１６案,新北市,林口區,西林里,154,1329,477,311,788,37,825
公投第１６案,新北市,林口區,西林里,155,1465,488,319,807,57,864
公投第１６案,新北市,林口區,西林里,156,1369,446,327,773,33,806
公投第１６案,新北市,林口區,菁湖里,157,1346,406,330,736,54,790
公投第１６案,新北市,林口區,菁湖里,158,1181,332,243,575,75,650
公投第１６案,新北市,林口區,菁湖里,159,1291,446,313,759,40,799
公投第１６案,新北市,林口區,中湖里,160,1213,357,253,610,63,673
公投第１６案,新北市,林口區,中湖里,161,1256,418,253,671,61,732
公投第１６案,新北市,林口區,中湖里,162,1185,317,259,576,67,643
公投第１６案,新北市,林口區,湖北里,163,1361,416,266,682,60,742
公投第１６案,新北市,林口區,湖南里,164,1756,578,286,864,37,901
公投第１６案,新北市,林口區,湖南里,165,1676,533,293,826,35,861
公投第１６案,新北市,林口區,湖南里,166,1540,530,300,830,41,871
公投第１６案,新北市,林口區,湖南里,167,1569,536,277,813,39,852
公投第１６案,新北市,林口區,湖南里,168,1514,505,298,803,35,838
公投第１６案,新北市,林口區,湖南里,169,1193,353,309,662,33,695
公投第１６案,新北市,林口區,湖南里,170,1610,564,320,884,34,918
公投第１６案,新北市,林口區,湖南里,171,1338,441,286,727,45,772
公投第１６案,新北市,林口區,湖南里,172,1141,343,252,595,60,655
公投第１６案,新北市,林口區,湖南里,173,1307,424,265,689,49,738
公投第１６案,新北市,林口區,湖南里,174,1327,403,315,718,42,760
公投第１６案,新北市,林口區,湖南里,175,1285,430,262,692,51,743
公投第１６案,新北市,林口區,南勢里,176,1481,440,334,774,49,823
公投第１６案,新北市,林口區,南勢里,177,1510,480,343,823,36,859
公投第１６案,新北市,林口區,南勢里,178,1785,549,355,904,45,949
公投第１６案,新北市,林口區,南勢里,179,1792,567,368,935,38,973
公投第１６案,新北市,林口區,南勢里,180,1517,528,296,824,35,859
公投第１６案,新北市,林口區,南勢里,181,1564,560,300,860,37,897
公投第１６案,新北市,林口區,南勢里,182,1560,549,305,854,42,896
公投第１６案,新北市,林口區,南勢里,183,1544,490,304,794,44,838
公投第１６案,新北市,林口區,南勢里,184,1593,500,318,818,49,867
公投第１６案,新北市,林口區,南勢里,185,1431,454,305,759,41,800
公投第１６案,新北市,林口區,仁愛里,186,1571,483,310,793,56,849
公投第１６案,新北市,林口區,仁愛里,187,1439,463,324,787,45,832
公投第１６案,新北市,林口區,仁愛里,188,1451,483,306,789,53,842
公投第１６案,新北市,林口區,仁愛里,189,1391,467,314,781,60,841
公投第１６案,新北市,林口區,麗林里,190,1461,471,293,764,47,811
公投第１６案,新北市,林口區,麗林里,191,1691,528,336,864,48,912
公投第１６案,新北市,林口區,麗林里,192,1524,449,324,773,82,855
公投第１６案,新北市,林口區,麗林里,193,1343,478,310,788,51,839
公投第１６案,新北市,林口區,麗林里,194,1398,463,317,780,54,834
公投第１６案,新北市,林口區,東勢里,195,1380,457,309,766,57,823
公投第１６案,新北市,林口區,東勢里,196,1367,418,288,706,59,765
公投第１６案,新北市,林口區,東勢里,197,1350,421,301,722,51,773
公投第１６案,新北市,林口區,東勢里,198,1194,380,273,653,46,699
公投第１６案,新北市,林口區,麗園里,199,1344,386,272,658,79,737
公投第１６案,新北市,林口區,麗園里,200,1154,342,263,605,48,653
公投第１６案,新北市,林口區,麗園里,201,1119,375,269,644,53,697
公投第１６案,新北市,林口區,頂福里,202,1026,238,209,447,54,501
公投第１６案,新北市,林口區,下福里,203,1210,336,263,599,76,675
公投第１６案,新北市,林口區,嘉寶里,204,912,244,196,440,74,514
公投第１６案,新北市,林口區,瑞平里,205,824,239,190,429,50,479
公投第１６案,新北市,林口區,太平里,206,1411,425,316,741,91,832
公投第１６案,新北市,五股區,興珍里,207,1456,369,316,685,112,797
公投第１６案,新北市,五股區,興珍里,208,1482,404,300,704,83,787
公投第１６案,新北市,五股區,興珍里,209,1287,341,323,664,61,725
公投第１６案,新北市,五股區,更寮里,210,1106,259,256,515,48,563
公投第１６案,新北市,五股區,觀音里,211,1283,336,253,589,91,680
公投第１６案,新北市,五股區,集福里,212,1833,492,370,862,60,922
公投第１６案,新北市,五股區,集福里,213,1141,351,246,597,61,658
公投第１６案,新北市,五股區,集福里,214,463,137,103,240,45,285
公投第１６案,新北市,五股區,集賢里,215,1786,526,340,866,88,954
公投第１６案,新北市,五股區,集賢里,216,1660,419,360,779,68,847
公投第１６案,新北市,五股區,成德里,217,1534,400,333,733,110,843
公投第１６案,新北市,五股區,成德里,218,1285,357,276,633,95,728
公投第１６案,新北市,五股區,成州里,219,1832,475,338,813,150,963
公投第１６案,新北市,五股區,成州里,220,1542,406,332,738,65,803
公投第１６案,新北市,五股區,成州里,221,1897,406,377,783,80,863
公投第１６案,新北市,五股區,成功里,222,1964,474,336,810,142,952
公投第１６案,新北市,五股區,成功里,223,1779,447,335,782,103,885
公投第１６案,新北市,五股區,成功里,224,1735,505,348,853,42,895
公投第１６案,新北市,五股區,成泰里,225,2299,618,445,1063,70,1133
公投第１６案,新北市,五股區,成泰里,226,1755,429,339,768,78,846
公投第１６案,新北市,五股區,成泰里,227,1674,456,374,830,91,921
公投第１６案,新北市,五股區,成泰里,228,1661,444,358,802,116,918
公投第１６案,新北市,五股區,五龍里,229,1281,306,244,550,53,603
公投第１６案,新北市,五股區,五福里,230,1566,422,320,742,101,843
公投第１６案,新北市,五股區,五福里,231,1560,405,252,657,48,705
公投第１６案,新北市,五股區,六福里,232,1622,475,332,807,59,866
公投第１６案,新北市,五股區,六福里,233,1779,518,377,895,60,955
公投第１６案,新北市,五股區,民義里,234,1487,382,302,684,88,772
公投第１６案,新北市,五股區,民義里,235,1567,472,329,801,61,862
公投第１６案,新北市,五股區,五股里,236,1333,257,216,473,48,521
公投第１６案,新北市,五股區,五股里,237,1263,392,279,671,87,758
公投第１６案,新北市,五股區,五股里,238,1314,373,400,773,95,868
公投第１６案,新北市,五股區,德音里,239,1513,413,294,707,58,765
公投第１６案,新北市,五股區,德音里,240,1517,457,306,763,66,829
公投第１６案,新北市,五股區,德音里,241,1613,446,340,786,89,875
公投第１６案,新北市,五股區,水碓里,242,1616,469,313,782,91,873
公投第１６案,新北市,五股區,水碓里,243,1616,417,366,783,83,866
公投第１６案,新北市,五股區,水碓里,244,1689,485,338,823,97,920
公投第１６案,新北市,五股區,水碓里,245,1894,513,436,949,38,987
公投第１６案,新北市,五股區,福德里,246,1210,408,266,674,84,758
公投第１６案,新北市,五股區,福德里,247,1643,455,308,763,81,844
公投第１６案,新北市,五股區,德泰里,248,1441,421,286,707,41,748
公投第１６案,新北市,五股區,德泰里,249,1305,399,288,687,67,754
公投第１６案,新北市,五股區,德泰里,250,1170,365,266,631,90,721
公投第１６案,新北市,五股區,貿商里,251,1397,512,259,771,80,851
公投第１６案,新北市,五股區,貿商里,252,1312,464,257,721,72,793
公投第１６案,新北市,五股區,陸一里,253,1127,358,175,533,37,570
公投第１６案,新北市,五股區,陸一里,254,1154,365,185,550,51,601
公投第１６案,新北市,泰山區,大科里,255,643,159,128,287,39,326
公投第１６案,新北市,泰山區,大科里,256,186,59,44,103,12,115
公投第１６案,新北市,泰山區,黎明里,257,1457,428,262,690,51,741
公投第１６案,新北市,泰山區,黎明里,258,1594,495,312,807,83,890
公投第１６案,新北市,泰山區,山腳里,259,1598,451,288,739,69,808
公投第１６案,新北市,泰山區,山腳里,260,1503,450,255,705,53,758
公投第１６案,新北市,泰山區,山腳里,261,1436,389,262,651,98,749
公投第１６案,新北市,泰山區,山腳里,262,1384,402,290,692,73,765
公投第１６案,新北市,泰山區,福泰里,263,1231,359,255,614,74,688
公投第１６案,新北市,泰山區,福泰里,264,1295,358,262,620,45,665
公投第１６案,新北市,泰山區,福興里,265,1563,513,308,821,77,898
公投第１６案,新北市,泰山區,福興里,266,1610,533,314,847,80,927
公投第１６案,新北市,泰山區,楓樹里,267,1253,348,285,633,42,675
公投第１６案,新北市,泰山區,楓樹里,268,1294,348,259,607,58,665
公投第１６案,新北市,泰山區,楓樹里,269,1354,423,304,727,63,790
公投第１６案,新北市,泰山區,同榮里,270,1259,405,241,646,44,690
公投第１６案,新北市,泰山區,同榮里,271,1252,389,263,652,53,705
公投第１６案,新北市,泰山區,同榮里,272,1094,312,213,525,47,572
公投第１６案,新北市,泰山區,同興里,273,1590,482,350,832,61,893
公投第１６案,新北市,泰山區,同興里,274,1634,468,352,820,88,908
公投第１６案,新北市,泰山區,全興里,275,1536,371,307,678,51,729
公投第１６案,新北市,泰山區,全興里,276,1534,450,368,818,68,886
公投第１６案,新北市,泰山區,全興里,277,1545,532,349,881,67,948
公投第１６案,新北市,泰山區,全興里,278,1399,435,284,719,64,783
公投第１６案,新北市,泰山區,全興里,279,1315,407,258,665,34,699
公投第１６案,新北市,泰山區,義學里,280,1201,396,268,664,70,734
公投第１６案,新北市,泰山區,義學里,281,1182,332,256,588,69,657
公投第１６案,新北市,泰山區,義學里,282,1665,419,341,760,111,871
公投第１６案,新北市,泰山區,義仁里,283,1855,516,392,908,103,1011
公投第１６案,新北市,泰山區,義仁里,284,1866,537,383,920,111,1031
公投第１６案,新北市,泰山區,義仁里,285,1935,585,368,953,78,1031
公投第１６案,新北市,泰山區,義仁里,286,1589,436,321,757,62,819
公投第１６案,新北市,泰山區,明志里,287,1152,350,203,553,55,608
公投第１６案,新北市,泰山區,明志里,288,1114,328,234,562,61,623
公投第１６案,新北市,泰山區,明志里,289,1040,348,228,576,72,648
公投第１６案,新北市,泰山區,泰友里,290,1003,300,240,540,59,599
公投第１６案,新北市,泰山區,泰友里,291,975,305,246,551,33,584
公投第１６案,新北市,泰山區,新明里,292,1440,428,296,724,60,784
公投第１６案,新北市,泰山區,新明里,293,1480,425,309,734,47,781
公投第１６案,新北市,泰山區,貴子里,294,1211,352,279,631,49,680
公投第１６案,新北市,泰山區,貴子里,295,1237,430,219,649,42,691
公投第１６案,新北市,泰山區,貴子里,296,1069,315,207,522,57,579
公投第１６案,新北市,泰山區,貴賢里,297,1680,511,406,917,79,996
公投第１６案,新北市,泰山區,貴賢里,298,1651,474,395,869,62,931
公投第１６案,新北市,泰山區,貴和里,299,1420,408,284,692,49,741
公投第１６案,新北市,泰山區,貴和里,300,1337,414,294,708,59,767
公投第１６案,新北市,泰山區,貴和里,301,1591,478,381,859,48,907
公投第１６案,新北市,新莊區,海山里,302,1123,336,238,574,87,661
公投第１６案,新北市,新莊區,海山里,303,1278,383,310,693,83,776
公投第１６案,新北市,新莊區,海山里,304,1163,352,304,656,82,738
公投第１６案,新北市,新莊區,海山里,305,1228,386,299,685,72,757
公投第１６案,新北市,新莊區,全安里,306,1211,345,304,649,62,711
公投第１６案,新北市,新莊區,全安里,307,1176,318,308,626,75,701
公投第１６案,新北市,新莊區,全安里,308,1536,493,367,860,79,939
公投第１６案,新北市,新莊區,全泰里,309,1486,478,382,860,70,930
公投第１６案,新北市,新莊區,全泰里,310,1513,508,378,886,88,974
公投第１６案,新北市,新莊區,全泰里,311,1395,431,339,770,120,890
公投第１６案,新北市,新莊區,忠孝里,312,1353,408,270,678,92,770
公投第１６案,新北市,新莊區,忠孝里,313,1409,471,330,801,76,877
公投第１６案,新北市,新莊區,忠孝里,314,1478,462,299,761,49,810
公投第１６案,新北市,新莊區,文衡里,315,921,278,215,493,82,575
公投第１６案,新北市,新莊區,文衡里,316,971,336,215,551,60,611
公投第１６案,新北市,新莊區,文聖里,317,1534,492,368,860,102,962
公投第１６案,新北市,新莊區,文聖里,318,1516,478,308,786,52,838
公投第１６案,新北市,新莊區,興漢里,319,697,198,162,360,52,412
公投第１６案,新北市,新莊區,興漢里,320,1235,415,254,669,45,714
公投第１６案,新北市,新莊區,興漢里,321,1138,359,236,595,51,646
公投第１６案,新北市,新莊區,榮和里,322,1063,288,226,514,38,552
公投第１６案,新北市,新莊區,榮和里,323,3399,460,316,776,66,842
公投第１６案,新北市,新莊區,文德里,324,1575,509,347,856,80,936
公投第１６案,新北市,新莊區,文明里,325,1615,543,381,924,78,1002
公投第１６案,新北市,新莊區,化成里,326,1612,424,342,766,85,851
公投第１６案,新北市,新莊區,化成里,327,1514,450,297,747,91,838
公投第１６案,新北市,新莊區,頭前里,328,1382,380,266,646,42,688
公投第１６案,新北市,新莊區,頭前里,329,1475,429,324,753,72,825
公投第１６案,新北市,新莊區,頭前里,330,1462,497,303,800,30,830
公投第１６案,新北市,新莊區,頭前里,331,1426,415,310,725,59,784
公投第１６案,新北市,新莊區,頭前里,332,1421,412,303,715,75,790
公投第１６案,新北市,新莊區,福基里,333,1536,485,304,789,35,824
公投第１６案,新北市,新莊區,福基里,334,1587,490,363,853,68,921
公投第１６案,新北市,新莊區,福基里,335,749,197,186,383,18,401
公投第１６案,新北市,新莊區,福興里,336,1276,424,281,705,63,768
公投第１６案,新北市,新莊區,福興里,337,1303,404,263,667,44,711
公投第１６案,新北市,新莊區,福興里,338,1259,391,301,692,77,769
公投第１６案,新北市,新莊區,福興里,339,1291,442,278,720,59,779
公投第１６案,新北市,新莊區,昌平里,340,1493,505,312,817,28,845
公投第１６案,新北市,新莊區,昌平里,341,1507,467,339,806,71,877
公投第１６案,新北市,新莊區,昌平里,342,1456,471,301,772,35,807
公投第１６案,新北市,新莊區,昌平里,343,1396,444,301,745,36,781
公投第１６案,新北市,新莊區,和平里,344,1351,360,254,614,74,688
公投第１６案,新北市,新莊區,和平里,345,1403,422,271,693,101,794
公投第１６案,新北市,新莊區,和平里,346,1497,445,301,746,88,834
公投第１６案,新北市,新莊區,幸福里,347,1272,402,265,667,107,774
公投第１６案,新北市,新莊區,幸福里,348,1269,355,212,567,60,627
公投第１６案,新北市,新莊區,幸福里,349,1335,389,310,699,92,791
公投第１６案,新北市,新莊區,昌隆里,350,1300,462,275,737,53,790
公投第１６案,新北市,新莊區,昌隆里,351,1286,435,287,722,63,785
公投第１６案,新北市,新莊區,昌隆里,352,1255,437,312,749,73,822
公投第１６案,新北市,新莊區,信義里,353,1558,445,332,777,139,916
公投第１６案,新北市,新莊區,信義里,354,1567,452,324,776,85,861
公投第１６案,新北市,新莊區,信義里,355,1603,497,347,844,102,946
公投第１６案,新北市,新莊區,昌信里,356,1538,456,362,818,47,865
公投第１６案,新北市,新莊區,昌信里,357,1671,544,343,887,66,953
公投第１６案,新北市,新莊區,昌明里,358,1698,474,358,832,53,885
公投第１６案,新北市,新莊區,昌明里,359,1545,495,376,871,67,938
公投第１６案,新北市,新莊區,仁義里,360,1696,518,388,906,135,1041
公投第１６案,新北市,新莊區,仁義里,361,1626,452,321,773,111,884
公投第１６案,新北市,新莊區,仁愛里,362,1170,301,231,532,100,632
公投第１６案,新北市,新莊區,仁愛里,363,1236,358,243,601,119,720
公投第１６案,新北市,新莊區,自信里,364,1071,305,206,511,76,587
公投第１６案,新北市,新莊區,自信里,365,1129,331,251,582,69,651
公投第１６案,新北市,新莊區,自立里,366,1586,485,379,864,59,923
公投第１６案,新北市,新莊區,自立里,367,1597,430,305,735,93,828
公投第１６案,新北市,新莊區,自立里,368,1573,378,311,689,127,816
公投第１６案,新北市,新莊區,自強里,369,1225,344,238,582,59,641
公投第１６案,新北市,新莊區,自強里,370,1217,343,228,571,51,622
公投第１６案,新北市,新莊區,思源里,371,1571,457,331,788,97,885
公投第１６案,新北市,新莊區,思源里,372,1594,449,320,769,91,860
公投第１６案,新北市,新莊區,思源里,373,1583,445,335,780,83,863
公投第１６案,新北市,新莊區,思賢里,374,1245,424,280,704,59,763
公投第１６案,新北市,新莊區,思賢里,375,1203,345,250,595,66,661
公投第１６案,新北市,新莊區,思賢里,376,1265,438,275,713,86,799
公投第１６案,新北市,新莊區,中華里,377,1255,417,258,675,78,753
公投第１６案,新北市,新莊區,中華里,378,1287,398,306,704,54,758
公投第１６案,新北市,新莊區,中美里,379,1167,346,321,667,68,735
公投第１６案,新北市,新莊區,中美里,380,1299,375,270,645,82,727
公投第１６案,新北市,新莊區,中美里,381,1207,331,314,645,56,701
公投第１６案,新北市,新莊區,中美里,382,1415,456,295,751,79,830
公投第１６案,新北市,新莊區,恆安里,383,1342,408,285,693,93,786
公投第１６案,新北市,新莊區,恆安里,384,1341,391,296,687,92,779
公投第１６案,新北市,新莊區,恆安里,385,1247,385,238,623,95,718
公投第１６案,新北市,新莊區,立人里,386,984,399,209,608,40,648
公投第１６案,新北市,新莊區,立人里,387,1043,361,210,571,64,635
公投第１６案,新北市,新莊區,立德里,388,1135,429,273,702,52,754
公投第１６案,新北市,新莊區,立德里,389,1185,358,277,635,55,690
公投第１６案,新北市,新莊區,中和里,390,1346,405,315,720,54,774
公投第１６案,新北市,新莊區,中和里,391,1372,418,317,735,85,820
公投第１６案,新北市,新莊區,中和里,392,1350,419,317,736,98,834
公投第１６案,新北市,新莊區,中泰里,393,1307,434,213,647,77,724
公投第１６案,新北市,新莊區,中泰里,394,1353,397,273,670,107,777
公投第１６案,新北市,新莊區,中泰里,395,1287,406,280,686,76,762
公投第１６案,新北市,新莊區,中宏里,396,1567,388,277,665,46,711
公投第１６案,新北市,新莊區,中宏里,397,1709,556,358,914,108,1022
公投第１６案,新北市,新莊區,中全里,398,1616,458,277,735,65,800
公投第１６案,新北市,新莊區,中全里,399,1628,418,329,747,80,827
公投第１６案,新北市,新莊區,立志里,400,1148,346,278,624,83,707
公投第１６案,新北市,新莊區,立志里,401,1201,340,285,625,14,639
公投第１６案,新北市,新莊區,立志里,402,1135,364,304,668,55,723
公投第１６案,新北市,新莊區,立廷里,403,1495,476,354,830,94,924
公投第１６案,新北市,新莊區,立廷里,404,1486,496,347,843,81,924
公投第１６案,新北市,新莊區,立廷里,405,1483,482,364,846,69,915
公投第１６案,新北市,新莊區,立廷里,406,1553,497,306,803,54,857
公投第１６案,新北市,新莊區,立廷里,407,1625,584,367,951,54,1005
公投第１６案,新北市,新莊區,立廷里,408,1671,528,356,884,43,927
公投第１６案,新北市,新莊區,立基里,409,1389,448,343,791,77,868
公投第１６案,新北市,新莊區,立基里,410,1272,395,288,683,64,747
公投第１６案,新北市,新莊區,立基里,411,1409,496,334,830,48,878
公投第１６案,新北市,新莊區,立基里,412,1372,441,324,765,56,821
公投第１６案,新北市,新莊區,中誠里,413,955,288,220,508,63,571
公投第１６案,新北市,新莊區,中誠里,414,952,278,176,454,85,539
公投第１６案,新北市,新莊區,中港里,415,1412,405,327,732,53,785
公投第１６案,新北市,新莊區,中港里,416,1415,417,323,740,84,824
公投第１６案,新北市,新莊區,中港里,417,1421,470,308,778,81,859
公投第１６案,新北市,新莊區,中港里,418,1293,424,316,740,71,811
公投第１６案,新北市,新莊區,中信里,419,1475,434,297,731,32,763
公投第１６案,新北市,新莊區,中信里,420,1429,465,266,731,87,818
公投第１６案,新北市,新莊區,中信里,421,1481,447,330,777,65,842
公投第１６案,新北市,新莊區,中信里,422,1472,516,287,803,89,892
公投第１６案,新北市,新莊區,中信里,423,1474,484,325,809,59,868
公投第１６案,新北市,新莊區,中平里,424,1462,487,324,811,37,848
公投第１６案,新北市,新莊區,中平里,425,1484,506,325,831,55,886
公投第１６案,新北市,新莊區,中平里,426,1461,484,307,791,53,844
公投第１６案,新北市,新莊區,中平里,427,1444,453,337,790,40,830
公投第１６案,新北市,新莊區,中平里,428,1437,483,316,799,46,845
公投第１６案,新北市,新莊區,中原里,429,1641,423,307,730,88,818
公投第１６案,新北市,新莊區,中原里,430,1633,441,332,773,84,857
公投第１６案,新北市,新莊區,中原里,431,1531,487,334,821,41,862
公投第１６案,新北市,新莊區,中原里,432,1517,485,350,835,72,907
公投第１６案,新北市,新莊區,中原里,433,1487,438,312,750,70,820
公投第１６案,新北市,新莊區,中原里,434,1560,504,311,815,69,884
公投第１６案,新北市,新莊區,中隆里,435,1584,466,324,790,101,891
公投第１６案,新北市,新莊區,中隆里,436,1602,481,331,812,55,867
公投第１６案,新北市,新莊區,中隆里,437,818,219,199,418,66,484
公投第１６案,新北市,新莊區,立功里,438,1633,449,292,741,79,820
公投第１６案,新北市,新莊區,立功里,439,1652,434,362,796,90,886
公投第１６案,新北市,新莊區,立泰里,440,1498,449,304,753,75,828
公投第１６案,新北市,新莊區,立泰里,441,1379,351,311,662,55,717
公投第１６案,新北市,新莊區,立泰里,442,1381,439,301,740,73,813
公投第１６案,新北市,新莊區,立言里,443,1535,482,322,804,106,910
公投第１６案,新北市,新莊區,立言里,444,1492,516,330,846,83,929
公投第１６案,新北市,新莊區,立言里,445,1450,503,312,815,96,911
公投第１６案,新北市,新莊區,豐年里,446,1107,353,237,590,70,660
公投第１６案,新北市,新莊區,豐年里,447,1063,336,256,592,66,658
公投第１６案,新北市,新莊區,豐年里,448,1143,305,293,598,75,673
公投第１６案,新北市,新莊區,國泰里,449,1341,374,264,638,118,756
公投第１６案,新北市,新莊區,泰豐里,450,1063,333,232,565,62,627
公投第１６案,新北市,新莊區,泰豐里,451,1096,312,276,588,72,660
公投第１６案,新北市,新莊區,瓊林里,452,1309,402,295,697,53,750
公投第１６案,新北市,新莊區,瓊林里,453,1216,345,300,645,71,716
公投第１６案,新北市,新莊區,瓊林里,454,1278,393,270,663,26,689
公投第１６案,新北市,新莊區,瓊林里,455,1352,477,298,775,99,874
公投第１６案,新北市,新莊區,福營里,456,1298,355,252,607,69,676
公投第１６案,新北市,新莊區,福營里,457,1042,303,233,536,73,609
公投第１６案,新北市,新莊區,營盤里,458,881,249,191,440,29,469
公投第１６案,新北市,新莊區,營盤里,459,1109,369,279,648,64,712
公投第１６案,新北市,新莊區,丹鳳里,460,1291,389,263,652,65,717
公投第１６案,新北市,新莊區,丹鳳里,461,1293,374,267,641,41,682
公投第１６案,新北市,新莊區,丹鳳里,462,1336,424,289,713,77,790
公投第１６案,新北市,新莊區,丹鳳里,463,1384,376,303,679,69,748
公投第１６案,新北市,新莊區,丹鳳里,464,1231,353,221,574,34,608
公投第１６案,新北市,新莊區,丹鳳里,465,940,277,203,480,52,532
公投第１６案,新北市,新莊區,合鳳里,466,1369,366,283,649,118,767
公投第１６案,新北市,新莊區,合鳳里,467,1384,357,320,677,95,772
公投第１６案,新北市,新莊區,合鳳里,468,1272,357,299,656,83,739
公投第１６案,新北市,新莊區,祥鳳里,469,1073,348,240,588,46,634
公投第１６案,新北市,新莊區,祥鳳里,470,1058,294,268,562,41,603
公投第１６案,新北市,新莊區,雙鳳里,471,1528,491,321,812,28,840
公投第１６案,新北市,新莊區,雙鳳里,472,1244,392,237,629,50,679
公投第１６案,新北市,新莊區,雙鳳里,473,1356,400,262,662,67,729
公投第１６案,新北市,新莊區,雙鳳里,474,1164,371,199,570,41,611
公投第１６案,新北市,新莊區,雙鳳里,475,1423,441,307,748,92,840
公投第１６案,新北市,新莊區,雙鳳里,476,1250,414,316,730,45,775
公投第１６案,新北市,新莊區,雙鳳里,477,1252,392,250,642,39,681
公投第１６案,新北市,新莊區,龍福里,478,1022,308,208,516,36,552
公投第１６案,新北市,新莊區,龍福里,479,959,287,222,509,55,564
公投第１６案,新北市,新莊區,龍鳳里,480,1646,520,383,903,58,961
公投第１６案,新北市,新莊區,龍鳳里,481,1551,457,339,796,75,871
公投第１６案,新北市,新莊區,龍鳳里,482,1526,486,342,828,79,907
公投第１６案,新北市,新莊區,龍鳳里,483,1518,480,322,802,52,854
公投第１６案,新北市,新莊區,龍鳳里,484,1547,516,327,843,57,900
公投第１６案,新北市,新莊區,裕民里,485,1505,396,325,721,106,827
公投第１６案,新北市,新莊區,裕民里,486,1527,410,302,712,111,823
公投第１６案,新北市,新莊區,裕民里,487,1482,396,318,714,68,782
公投第１６案,新北市,新莊區,裕民里,488,1586,432,292,724,97,821
公投第１６案,新北市,新莊區,龍安里,489,1065,312,212,524,96,620
公投第１６案,新北市,新莊區,龍安里,490,1040,351,257,608,62,670
公投第１６案,新北市,新莊區,富國里,491,1090,324,221,545,67,612
公投第１６案,新北市,新莊區,富國里,492,1071,328,217,545,78,623
公投第１６案,新北市,新莊區,富民里,493,1704,482,312,794,48,842
公投第１６案,新北市,新莊區,富民里,494,1698,451,335,786,58,844
公投第１６案,新北市,新莊區,後德里,495,1362,451,324,775,77,852
公投第１６案,新北市,新莊區,後德里,496,1350,409,320,729,61,790
公投第１６案,新北市,新莊區,萬安里,497,1689,439,379,818,150,968
公投第１６案,新北市,新莊區,萬安里,498,1612,439,351,790,145,935
公投第１６案,新北市,新莊區,建福里,499,1130,362,257,619,65,684
公投第１６案,新北市,新莊區,建福里,500,1111,348,272,620,75,695
公投第１６案,新北市,新莊區,後港里,501,1539,467,305,772,58,830
公投第１６案,新北市,新莊區,後港里,502,1586,457,374,831,52,883
公投第１６案,新北市,新莊區,後港里,503,1631,514,342,856,85,941
公投第１６案,新北市,新莊區,後港里,504,1540,450,333,783,75,858
公投第１６案,新北市,新莊區,四維里,505,1388,353,287,640,59,699
公投第１６案,新北市,新莊區,四維里,506,1388,364,240,604,110,714
公投第１６案,新北市,新莊區,四維里,507,1387,353,268,621,74,695
公投第１６案,新北市,新莊區,南港里,508,1181,342,235,577,57,634
公投第１６案,新北市,新莊區,南港里,509,1135,318,265,583,76,659
公投第１６案,新北市,新莊區,南港里,510,1173,334,274,608,65,673
公投第１６案,新北市,新莊區,南港里,511,1215,371,284,655,49,704
公投第１６案,新北市,新莊區,建安里,512,1488,469,331,800,62,862
公投第１６案,新北市,新莊區,建安里,513,1444,439,335,774,49,823
公投第１６案,新北市,新莊區,建安里,514,1499,460,323,783,54,837
公投第１６案,新北市,新莊區,建安里,515,1449,430,330,760,43,803
公投第１６案,新北市,新莊區,民全里,516,1640,470,357,827,95,922
公投第１６案,新北市,新莊區,民全里,517,1648,502,300,802,92,894
公投第１６案,新北市,新莊區,八德里,518,1371,372,278,650,72,722
公投第１６案,新北市,新莊區,八德里,519,1400,399,298,697,81,778
公投第１６案,新北市,新莊區,成德里,520,1457,430,299,729,91,820
公投第１６案,新北市,新莊區,成德里,521,1502,424,300,724,102,826
公投第１６案,新北市,新莊區,成德里,522,1412,394,300,694,91,785
公投第１６案,新北市,新莊區,民安里,523,1318,366,281,647,82,729
公投第１６案,新北市,新莊區,民安里,524,1411,453,308,761,70,831
公投第１６案,新北市,新莊區,民安里,525,1262,396,290,686,45,731
公投第１６案,新北市,新莊區,民安里,526,1228,449,246,695,41,736
公投第１６案,新北市,新莊區,民有里,527,1748,569,368,937,90,1027
公投第１６案,新北市,新莊區,民有里,528,1761,529,384,913,109,1022
公投第１６案,新北市,新莊區,民本里,529,1326,379,243,622,81,703
公投第１６案,新北市,新莊區,民本里,530,1344,350,245,595,80,675
公投第１６案,新北市,新莊區,光明里,531,1355,423,280,703,64,767
公投第１６案,新北市,新莊區,光明里,532,1306,391,265,656,103,759
公投第１６案,新北市,新莊區,光明里,533,1349,435,306,741,58,799
公投第１６案,新北市,新莊區,光正里,534,1265,391,270,661,46,707
公投第１６案,新北市,新莊區,光正里,535,1282,425,280,705,71,776
公投第１６案,新北市,新莊區,光正里,536,1237,393,287,680,61,741
公投第１６案,新北市,新莊區,光榮里,537,1301,420,255,675,35,710
公投第１６案,新北市,新莊區,光榮里,538,1262,393,261,654,72,726
公投第１６案,新北市,新莊區,光榮里,539,1270,379,283,662,61,723
公投第１６案,新北市,新莊區,光和里,540,1245,371,281,652,78,730
公投第１６案,新北市,新莊區,光和里,541,1220,315,275,590,93,683
公投第１６案,新北市,新莊區,光華里,542,1245,364,252,616,49,665
公投第１６案,新北市,新莊區,光華里,543,1212,349,231,580,59,639
公投第１６案,新北市,新莊區,光華里,544,1253,350,258,608,77,685
公投第１６案,新北市,新莊區,光華里,545,1272,357,250,607,69,676
公投第１６案,新北市,新莊區,光華里,546,1227,430,257,687,37,724
公投第１６案,新北市,新莊區,西盛里,547,1126,368,258,626,53,679
公投第１６案,新北市,新莊區,西盛里,548,1240,376,286,662,61,723
公投第１６案,新北市,新莊區,西盛里,549,1460,472,306,778,53,831
公投第１６案,新北市,新莊區,西盛里,550,1072,316,229,545,57,602
公投第１６案,新北市,新莊區,西盛里,551,1127,304,224,528,63,591
公投第１６案,新北市,新莊區,西盛里,552,1332,411,302,713,52,765
公投第１６案,新北市,新莊區,西盛里,553,1341,372,285,657,31,688
公投第１６案,新北市,新莊區,西盛里,554,1140,252,205,457,29,486
公投第１６案,新北市,蘆洲區,光華里,555,1600,402,370,772,136,908
公投第１６案,新北市,蘆洲區,光華里,556,1549,482,298,780,81,861
公投第１６案,新北市,蘆洲區,光華里,557,1516,433,340,773,114,887
公投第１６案,新北市,蘆洲區,光明里,558,1404,407,260,667,107,774
公投第１６案,新北市,蘆洲區,光明里,559,1381,363,295,658,94,752
公投第１６案,新北市,蘆洲區,光明里,560,1485,461,315,776,63,839
公投第１６案,新北市,蘆洲區,中路里,561,1779,344,266,610,69,679
公投第１６案,新北市,蘆洲區,中路里,562,1797,478,402,880,78,958
公投第１６案,新北市,蘆洲區,永安里,563,1364,392,304,696,96,792
公投第１６案,新北市,蘆洲區,永安里,564,1635,504,325,829,86,915
公投第１６案,新北市,蘆洲區,永安里,565,1567,382,307,689,62,751
公投第１６案,新北市,蘆洲區,九芎里,566,1524,428,306,734,66,800
公投第１６案,新北市,蘆洲區,九芎里,567,1612,439,325,764,74,838
公投第１６案,新北市,蘆洲區,九芎里,568,1674,451,379,830,54,884
公投第１６案,新北市,蘆洲區,延平里,569,1838,451,367,818,83,901
公投第１６案,新北市,蘆洲區,延平里,570,1814,441,322,763,57,820
公投第１６案,新北市,蘆洲區,中華里,571,1473,412,342,754,66,820
公投第１６案,新北市,蘆洲區,中華里,572,1465,437,299,736,60,796
公投第１６案,新北市,蘆洲區,中原里,573,1652,489,371,860,93,953
公投第１６案,新北市,蘆洲區,中原里,574,1650,451,232,683,119,802
公投第１６案,新北市,蘆洲區,中原里,575,1656,507,341,848,65,913
公投第１６案,新北市,蘆洲區,長安里,576,1571,411,330,741,82,823
公投第１６案,新北市,蘆洲區,長安里,577,1523,404,322,726,89,815
公投第１６案,新北市,蘆洲區,長安里,578,1475,414,331,745,53,798
公投第１６案,新北市,蘆洲區,忠義里,579,1367,372,271,643,78,721
公投第１６案,新北市,蘆洲區,忠義里,580,1514,442,337,779,79,858
公投第１６案,新北市,蘆洲區,正義里,581,1791,589,394,983,70,1053
公投第１６案,新北市,蘆洲區,正義里,582,1714,566,391,957,79,1036
公投第１６案,新北市,蘆洲區,正義里,583,1780,593,364,957,59,1016
公投第１６案,新北市,蘆洲區,正義里,584,1713,552,369,921,54,975
公投第１６案,新北市,蘆洲區,正義里,585,1720,556,393,949,59,1008
公投第１６案,新北市,蘆洲區,正義里,586,1766,532,379,911,57,968
公投第１６案,新北市,蘆洲區,南港里,587,1623,479,313,792,91,883
公投第１６案,新北市,蘆洲區,南港里,588,1740,541,334,875,74,949
公投第１６案,新北市,蘆洲區,南港里,589,1759,525,409,934,84,1018
公投第１６案,新北市,蘆洲區,永樂里,590,1775,517,421,938,94,1032
公投第１６案,新北市,蘆洲區,永樂里,591,1909,589,408,997,91,1088
公投第１６案,新北市,蘆洲區,永樂里,592,1805,527,409,936,116,1052
公投第１６案,新北市,蘆洲區,成功里,593,1642,448,359,807,62,869
公投第１６案,新北市,蘆洲區,成功里,594,1713,506,334,840,82,922
公投第１６案,新北市,蘆洲區,成功里,595,1746,462,342,804,90,894
公投第１６案,新北市,蘆洲區,成功里,596,1596,468,338,806,73,879
公投第１６案,新北市,蘆洲區,永康里,597,1434,415,280,695,65,760
公投第１６案,新北市,蘆洲區,永康里,598,1450,411,320,731,71,802
公投第１６案,新北市,蘆洲區,永康里,599,1543,403,319,722,44,766
公投第１６案,新北市,蘆洲區,永康里,600,1525,436,310,746,67,813
公投第１６案,新北市,蘆洲區,永德里,601,1419,391,282,673,63,736
公投第１６案,新北市,蘆洲區,永德里,602,1298,388,284,672,68,740
公投第１６案,新北市,蘆洲區,永德里,603,1304,373,257,630,79,709
公投第１６案,新北市,蘆洲區,樓厝里,604,1806,514,360,874,91,965
公投第１６案,新北市,蘆洲區,樓厝里,605,1910,523,358,881,112,993
公投第１６案,新北市,蘆洲區,樓厝里,606,1873,448,335,783,84,867
公投第１６案,新北市,蘆洲區,信義里,607,1785,456,332,788,64,852
公投第１６案,新北市,蘆洲區,信義里,608,1760,434,351,785,89,874
公投第１６案,新北市,蘆洲區,玉清里,609,1841,573,369,942,89,1031
公投第１６案,新北市,蘆洲區,玉清里,610,1855,488,356,844,67,911
公投第１６案,新北市,蘆洲區,玉清里,611,1450,343,297,640,90,730
公投第１６案,新北市,蘆洲區,復興里,612,1585,383,367,750,80,830
公投第１６案,新北市,蘆洲區,復興里,613,1541,359,271,630,154,784
公投第１６案,新北市,蘆洲區,福安里,614,1626,447,337,784,84,868
公投第１６案,新北市,蘆洲區,福安里,615,1241,328,293,621,80,701
公投第１６案,新北市,蘆洲區,鷺江里,616,1634,458,346,804,85,889
公投第１６案,新北市,蘆洲區,鷺江里,617,1573,464,305,769,98,867
公投第１６案,新北市,蘆洲區,鷺江里,618,1619,496,364,860,63,923
公投第１６案,新北市,蘆洲區,恆德里,619,1878,536,379,915,112,1027
公投第１６案,新北市,蘆洲區,恆德里,620,1797,502,352,854,110,964
公投第１６案,新北市,蘆洲區,恆德里,621,1816,551,400,951,57,1008
公投第１６案,新北市,蘆洲區,溪墘里,622,1344,385,313,698,107,805
公投第１６案,新北市,蘆洲區,溪墘里,623,1492,431,392,823,96,919
公投第１６案,新北市,蘆洲區,仁復里,624,1959,541,387,928,136,1064
公投第１６案,新北市,蘆洲區,仁德里,625,1611,436,314,750,133,883
公投第１６案,新北市,蘆洲區,仁德里,626,1574,429,387,816,100,916
公投第１６案,新北市,蘆洲區,仁德里,627,1653,503,358,861,88,949
公投第１６案,新北市,蘆洲區,仁義里,628,3085,586,388,974,90,1064
公投第１６案,新北市,蘆洲區,仁義里,629,1812,470,382,852,115,967
公投第１６案,新北市,蘆洲區,得勝里,630,1332,339,307,646,84,730
公投第１６案,新北市,蘆洲區,得勝里,631,1648,416,284,700,102,802
公投第１６案,新北市,蘆洲區,得仁里,632,1355,389,263,652,51,703
公投第１６案,新北市,蘆洲區,得仁里,633,1371,412,300,712,51,763
公投第１６案,新北市,蘆洲區,保和里,634,1111,291,266,557,91,648
公投第１６案,新北市,蘆洲區,保和里,635,1176,312,276,588,114,702
公投第１６案,新北市,蘆洲區,樹德里,636,1602,442,344,786,94,880
公投第１６案,新北市,蘆洲區,樹德里,637,1361,329,296,625,69,694
公投第１６案,新北市,蘆洲區,民和里,638,1530,443,282,725,101,826
公投第１６案,新北市,蘆洲區,民和里,639,925,250,186,436,91,527
公投第１６案,新北市,蘆洲區,水湳里,640,1851,524,389,913,86,999
公投第１６案,新北市,蘆洲區,水湳里,641,1791,508,305,813,62,875
公投第１６案,新北市,蘆洲區,水湳里,642,1853,500,343,843,82,925
公投第１６案,新北市,蘆洲區,水湳里,643,1758,457,333,790,64,854
公投第１６案,新北市,蘆洲區,水湳里,644,1798,522,357,879,89,968
公投第１６案,新北市,蘆洲區,水河里,645,1645,497,337,834,72,906
公投第１６案,新北市,蘆洲區,水河里,646,1612,409,300,709,76,785
公投第１６案,新北市,蘆洲區,水河里,647,1784,425,339,764,109,873
公投第１６案,新北市,蘆洲區,水河里,648,1701,420,295,715,78,793
公投第１６案,新北市,蘆洲區,水河里,649,1581,457,302,759,57,816
公投第１６案,新北市,蘆洲區,仁愛里,650,1534,441,325,766,76,842
公投第１６案,新北市,蘆洲區,仁愛里,651,1620,479,362,841,87,928
公投第１６案,新北市,蘆洲區,仁愛里,652,1494,468,346,814,74,888
公投第１６案,新北市,蘆洲區,忠孝里,653,1183,338,254,592,66,658
公投第１６案,新北市,蘆洲區,忠孝里,654,985,263,243,506,64,570
公投第１６案,新北市,蘆洲區,保佑里,655,1673,459,319,778,89,867
公投第１６案,新北市,蘆洲區,保佑里,656,1688,504,345,849,99,948
公投第１６案,新北市,蘆洲區,保新里,657,1249,356,269,625,65,690
公投第１６案,新北市,蘆洲區,保新里,658,1476,401,291,692,85,777
公投第１６案,新北市,三重區,大有里,659,1509,414,300,714,96,810
公投第１６案,新北市,三重區,大有里,660,1591,492,338,830,89,919
公投第１６案,新北市,三重區,大有里,661,1653,505,365,870,88,958
公投第１６案,新北市,三重區,博愛里,662,1392,418,325,743,102,845
公投第１６案,新北市,三重區,博愛里,663,1451,474,303,777,102,879
公投第１６案,新北市,三重區,博愛里,664,1329,380,284,664,102,766
公投第１６案,新北市,三重區,二重里,665,1459,457,313,770,62,832
公投第１６案,新北市,三重區,頂崁里,666,1024,309,230,539,81,620
公投第１６案,新北市,三重區,頂崁里,667,1066,283,286,569,72,641
公投第１６案,新北市,三重區,谷王里,668,856,277,214,491,75,566
公投第１６案,新北市,三重區,五谷里,669,764,221,170,391,49,440
公投第１６案,新北市,三重區,五谷里,670,821,242,205,447,63,510
公投第１６案,新北市,三重區,中興里,671,1887,456,429,885,85,970
公投第１６案,新北市,三重區,中興里,672,1646,445,359,804,80,884
公投第１６案,新北市,三重區,德厚里,673,358,109,84,193,22,215
公投第１６案,新北市,三重區,成功里,674,1039,313,228,541,83,624
公投第１６案,新北市,三重區,成功里,675,1114,338,279,617,60,677
公投第１６案,新北市,三重區,成功里,676,1588,572,300,872,57,929
公投第１６案,新北市,三重區,成功里,677,1702,484,357,841,70,911
公投第１６案,新北市,三重區,福祉里,678,1288,397,313,710,82,792
公投第１６案,新北市,三重區,福祉里,679,1629,541,373,914,72,986
公投第１６案,新北市,三重區,福祉里,680,1861,537,413,950,100,1050
公投第１６案,新北市,三重區,福德里,681,1727,472,357,829,66,895
公投第１６案,新北市,三重區,福德里,682,1813,516,425,941,71,1012
公投第１６案,新北市,三重區,福民里,683,1595,486,321,807,91,898
公投第１６案,新北市,三重區,福民里,684,1513,446,343,789,90,879
公投第１６案,新北市,三重區,過田里,685,4433,420,331,751,73,824
公投第１６案,新北市,三重區,過田里,686,1283,368,317,685,65,750
公投第１６案,新北市,三重區,過田里,687,1430,464,338,802,72,874
公投第１６案,新北市,三重區,過田里,688,1357,416,355,771,43,814
公投第１６案,新北市,三重區,錦田里,689,963,303,214,517,56,573
公投第１６案,新北市,三重區,錦田里,690,883,270,196,466,61,527
公投第１６案,新北市,三重區,重明里,691,1494,418,320,738,115,853
公投第１６案,新北市,三重區,重明里,692,1616,516,328,844,96,940
公投第１６案,新北市,三重區,光田里,693,1329,391,275,666,97,763
公投第１６案,新北市,三重區,光田里,694,1289,389,335,724,82,806
公投第１６案,新北市,三重區,光田里,695,1380,372,328,700,108,808
公投第１６案,新北市,三重區,光陽里,696,1668,525,363,888,61,949
公投第１６案,新北市,三重區,光陽里,697,1226,406,279,685,91,776
公投第１６案,新北市,三重區,光陽里,698,1421,435,344,779,56,835
公投第１６案,新北市,三重區,光陽里,699,1364,426,309,735,72,807
公投第１６案,新北市,三重區,田心里,700,1232,393,280,673,63,736
公投第１６案,新北市,三重區,田心里,701,1248,366,326,692,77,769
公投第１６案,新北市,三重區,田心里,702,1256,402,266,668,82,750
公投第１６案,新北市,三重區,福田里,703,1506,467,385,852,81,933
公投第１６案,新北市,三重區,福田里,704,1669,530,376,906,88,994
公投第１６案,新北市,三重區,田中里,705,1308,389,266,655,108,763
公投第１６案,新北市,三重區,田中里,706,1263,448,303,751,76,827
公投第１６案,新北市,三重區,田中里,707,1471,377,364,741,97,838
公投第１６案,新北市,三重區,田中里,708,1447,399,350,749,124,873
公投第１６案,新北市,三重區,田安里,709,1693,424,320,744,86,830
公投第１６案,新北市,三重區,田安里,710,2015,579,463,1042,41,1083
公投第１６案,新北市,三重區,田安里,711,1812,493,369,862,100,962
公投第１６案,新北市,三重區,三民里,712,1509,442,313,755,51,806
公投第１６案,新北市,三重區,三民里,713,1439,444,293,737,80,817
公投第１６案,新北市,三重區,光明里,714,1437,429,316,745,68,813
公投第１６案,新北市,三重區,光明里,715,1697,479,432,911,7,918
公投第１６案,新北市,三重區,光明里,716,1793,552,318,870,59,929
公投第１６案,新北市,三重區,光明里,717,1603,501,389,890,73,963
公投第１６案,新北市,三重區,光正里,718,1166,329,260,589,44,633
公投第１６案,新北市,三重區,光正里,719,1126,341,257,598,67,665
公投第１６案,新北市,三重區,同安里,720,1291,333,234,567,84,651
公投第１６案,新北市,三重區,同慶里,721,1597,476,332,808,91,899
公投第１６案,新北市,三重區,菜寮里,722,1081,342,231,573,90,663
公投第１６案,新北市,三重區,菜寮里,723,911,279,212,491,94,585
公投第１６案,新北市,三重區,永春里,724,1719,447,335,782,63,845
公投第１６案,新北市,三重區,中正里,725,1289,354,268,622,105,727
公投第１６案,新北市,三重區,吉利里,726,1318,425,269,694,111,805
公投第１６案,新北市,三重區,大同里,727,1822,478,382,860,87,947
公投第１６案,新北市,三重區,中民里,728,1185,316,237,553,114,667
公投第１６案,新北市,三重區,平和里,729,1369,354,250,604,118,722
公投第１６案,新北市,三重區,大安里,730,1507,428,326,754,102,856
公投第１６案,新北市,三重區,仁德里,731,926,283,189,472,80,552
公投第１６案,新北市,三重區,仁德里,732,950,241,194,435,37,472
公投第１６案,新北市,三重區,忠孝里,733,1678,427,343,770,96,866
公投第１６案,新北市,三重區,仁義里,734,1117,311,236,547,91,638
公投第１６案,新北市,三重區,光榮里,735,1318,346,277,623,80,703
公投第１６案,新北市,三重區,光輝里,736,1388,390,311,701,59,760
公投第１６案,新北市,三重區,福星里,737,1026,293,210,503,95,598
公投第１６案,新北市,三重區,福利里,738,1096,324,289,613,69,682
公投第１６案,新北市,三重區,福利里,739,967,310,207,517,56,573
公投第１６案,新北市,三重區,清和里,740,1871,513,398,911,84,995
公投第１６案,新北市,三重區,清和里,741,1663,494,331,825,110,935
公投第１６案,新北市,三重區,永興里,742,1208,353,260,613,35,648
公投第１６案,新北市,三重區,中山里,743,1398,360,294,654,78,732
公投第１６案,新北市,三重區,中山里,744,1078,321,209,530,49,579
公投第１６案,新北市,三重區,大園里,745,1102,278,228,506,94,600
公投第１６案,新北市,三重區,大園里,746,1393,385,286,671,98,769
公投第１６案,新北市,三重區,國隆里,747,1251,363,293,656,83,739
公投第１６案,新北市,三重區,國隆里,748,1234,418,281,699,87,786
公投第１６案,新北市,三重區,重陽里,749,1661,449,417,866,94,960
公投第１６案,新北市,三重區,重陽里,750,1590,491,315,806,103,909
公投第１６案,新北市,三重區,民生里,751,1182,342,281,623,79,702
公投第１６案,新北市,三重區,民生里,752,1369,380,346,726,92,818
公投第１６案,新北市,三重區,民生里,753,1222,377,308,685,75,760
公投第１６案,新北市,三重區,重新里,754,1304,352,279,631,110,741
公投第１６案,新北市,三重區,正德里,755,1054,306,192,498,68,566
公投第１６案,新北市,三重區,正義里,756,1635,450,365,815,103,918
公投第１６案,新北市,三重區,正安里,757,1779,489,341,830,103,933
公投第１６案,新北市,三重區,自強里,758,1633,508,310,818,118,936
公投第１６案,新北市,三重區,文化里,759,1107,337,237,574,65,639
公投第１６案,新北市,三重區,文化里,760,1021,327,243,570,70,640
公投第１６案,新北市,三重區,中央里,761,1649,396,321,717,138,855
公投第１６案,新北市,三重區,雙園里,762,874,256,203,459,41,500
公投第１６案,新北市,三重區,錦通里,763,1402,380,292,672,156,828
公投第１６案,新北市,三重區,錦安里,764,1713,439,314,753,110,863
公投第１６案,新北市,三重區,長安里,765,973,215,202,417,73,490
公投第１６案,新北市,三重區,長安里,766,1038,39,224,263,73,336
公投第１６案,新北市,三重區,光華里,767,1833,414,323,737,204,941
公投第１６案,新北市,三重區,長生里,768,817,228,185,413,48,461
公投第１６案,新北市,三重區,開元里,769,1387,415,326,741,82,823
公投第１６案,新北市,三重區,大德里,770,784,233,182,415,47,462
公投第１６案,新北市,三重區,長元里,771,1096,294,226,520,52,572
公投第１６案,新北市,三重區,長元里,772,1163,326,260,586,110,696
公投第１６案,新北市,三重區,長江里,773,1868,576,328,904,76,980
公投第１６案,新北市,三重區,長泰里,774,1117,294,220,514,99,613
公投第１６案,新北市,三重區,長泰里,775,934,239,189,428,62,490
公投第１６案,新北市,三重區,長福里,776,1412,353,289,642,100,742
公投第１６案,新北市,三重區,介壽里,777,1062,357,251,608,67,675
公投第１６案,新北市,三重區,萬壽里,778,891,250,164,414,95,509
公投第１６案,新北市,三重區,萬壽里,779,936,315,235,550,94,644
公投第１６案,新北市,三重區,錦江里,780,1085,261,248,509,84,593
公投第１６案,新北市,三重區,錦江里,781,1065,261,197,458,34,492
公投第１６案,新北市,三重區,龍濱里,782,1398,411,298,709,88,797
公投第１６案,新北市,三重區,龍濱里,783,1550,460,338,798,72,870
公投第１６案,新北市,三重區,龍門里,784,1674,449,349,798,113,911
公投第１６案,新北市,三重區,秀江里,785,1215,361,248,609,99,708
公投第１６案,新北市,三重區,奕壽里,786,1606,453,344,797,91,888
公投第１６案,新北市,三重區,三安里,787,1182,354,255,609,65,674
公投第１６案,新北市,三重區,三安里,788,1238,343,285,628,101,729
公投第１６案,新北市,三重區,福安里,789,1342,395,305,700,97,797
公投第１６案,新北市,三重區,福安里,790,1408,418,319,737,82,819
公投第１６案,新北市,三重區,信安里,791,1770,423,446,869,126,995
公投第１６案,新北市,三重區,安慶里,792,940,247,237,484,69,553
公投第１６案,新北市,三重區,安慶里,793,975,255,218,473,44,517
公投第１６案,新北市,三重區,幸福里,794,1507,401,323,724,79,803
公投第１６案,新北市,三重區,幸福里,795,1419,384,324,708,105,813
公投第１６案,新北市,三重區,幸福里,796,1257,365,262,627,85,712
公投第１６案,新北市,三重區,六合里,797,1619,485,341,826,96,922
公投第１６案,新北市,三重區,六合里,798,1745,487,377,864,19,883
公投第１６案,新北市,三重區,六福里,799,1519,425,328,753,106,859
公投第１６案,新北市,三重區,六福里,800,1682,473,331,804,85,889
公投第１６案,新北市,三重區,六福里,801,1697,510,380,890,102,992
公投第１６案,新北市,三重區,順德里,802,1073,301,196,497,87,584
公投第１６案,新北市,三重區,順德里,803,924,256,189,445,67,512
公投第１６案,新北市,三重區,承德里,804,1613,391,312,703,68,771
公投第１６案,新北市,三重區,瑞德里,805,1034,276,193,469,83,552
公投第１６案,新北市,三重區,瑞德里,806,1118,314,248,562,83,645
公投第１６案,新北市,三重區,崇德里,807,1269,342,286,628,89,717
公投第１６案,新北市,三重區,崇德里,808,990,270,196,466,90,556
公投第１６案,新北市,三重區,崇德里,809,1336,385,282,667,91,758
公投第１６案,新北市,三重區,厚德里,810,1601,498,313,811,93,904
公投第１６案,新北市,三重區,厚德里,811,1581,482,389,871,82,953
公投第１６案,新北市,三重區,維德里,812,1345,408,292,700,82,782
公投第１６案,新北市,三重區,維德里,813,1226,364,332,696,77,773
公投第１６案,新北市,三重區,尚德里,814,1650,471,279,750,113,863
公投第１６案,新北市,三重區,尚德里,815,1140,332,241,573,85,658
公投第１６案,新北市,三重區,培德里,816,1639,472,302,774,62,836
公投第１６案,新北市,三重區,培德里,817,1699,602,274,876,77,953
公投第１６案,新北市,三重區,立德里,818,1501,564,333,897,97,994
公投第１６案,新北市,三重區,立德里,819,1538,430,345,775,94,869
公投第１６案,新北市,三重區,永德里,820,1540,439,308,747,95,842
公投第１６案,新北市,三重區,永德里,821,1276,360,265,625,92,717
公投第１６案,新北市,三重區,永德里,822,1539,410,319,729,89,818
公投第１６案,新北市,三重區,永煇里,823,1170,316,315,631,72,703
公投第１６案,新北市,三重區,永煇里,824,1120,315,258,573,61,634
公投第１６案,新北市,三重區,永發里,825,1789,428,370,798,112,910
公投第１６案,新北市,三重區,永發里,826,1520,405,297,702,109,811
公投第１６案,新北市,三重區,永發里,827,1821,505,392,897,117,1014
公投第１６案,新北市,三重區,永盛里,828,1407,399,300,699,91,790
公投第１６案,新北市,三重區,永盛里,829,1491,412,343,755,78,833
公投第１６案,新北市,三重區,永吉里,830,1381,428,310,738,90,828
公投第１６案,新北市,三重區,永吉里,831,1222,341,279,620,88,708
公投第１６案,新北市,三重區,永安里,832,1938,551,391,942,67,1009
公投第１６案,新北市,三重區,永安里,833,1639,479,366,845,49,894
公投第１６案,新北市,三重區,永豐里,834,1614,460,327,787,118,905
公投第１６案,新北市,三重區,永豐里,835,1709,518,328,846,89,935
公投第１６案,新北市,三重區,永豐里,836,1753,483,324,807,101,908
公投第１６案,新北市,三重區,永福里,837,1398,420,306,726,91,817
公投第１６案,新北市,三重區,永福里,838,1706,469,364,833,88,921
公投第１６案,新北市,三重區,永福里,839,1614,474,353,827,96,923
公投第１６案,新北市,三重區,永清里,840,1591,441,349,790,102,892
公投第１６案,新北市,三重區,永清里,841,1627,443,354,797,78,875
公投第１６案,新北市,三重區,永清里,842,1505,452,312,764,108,872
公投第１６案,新北市,三重區,永順里,843,1331,391,295,686,70,756
公投第１６案,新北市,三重區,永順里,844,1678,448,316,764,78,842
公投第１６案,新北市,三重區,永順里,845,1498,445,340,785,63,848
公投第１６案,新北市,三重區,溪美里,846,1800,520,420,940,113,1053
公投第１６案,新北市,三重區,溪美里,847,1703,469,305,774,69,843
公投第１６案,新北市,三重區,溪美里,848,1975,536,380,916,68,984
公投第１６案,新北市,三重區,溪美里,849,1894,521,391,912,77,989
公投第１６案,新北市,三重區,福隆里,850,1405,432,312,744,79,823
公投第１６案,新北市,三重區,福隆里,851,1293,386,306,692,51,743
公投第１６案,新北市,三重區,福隆里,852,1259,367,267,634,80,714
公投第１６案,新北市,三重區,五常里,853,1144,363,245,608,100,708
公投第１６案,新北市,三重區,五常里,854,1254,385,294,679,87,766
公投第１６案,新北市,三重區,五常里,855,1313,375,280,655,88,743
公投第１６案,新北市,三重區,五福里,856,1594,423,354,777,96,873
公投第１６案,新北市,三重區,五福里,857,1775,489,398,887,90,977
公投第１６案,新北市,三重區,仁忠里,858,1516,395,322,717,133,850
公投第１６案,新北市,三重區,仁忠里,859,1315,408,290,698,126,824
公投第１６案,新北市,三重區,慈福里,860,843,238,195,433,87,520
公投第１６案,新北市,三重區,慈福里,861,1160,291,234,525,87,612
公投第１６案,新北市,三重區,慈生里,862,1052,302,237,539,81,620
公投第１６案,新北市,三重區,慈生里,863,1054,331,255,586,76,662
公投第１６案,新北市,三重區,慈惠里,864,997,273,228,501,89,590
公投第１６案,新北市,三重區,慈惠里,865,936,239,203,442,59,501
公投第１６案,新北市,三重區,慈愛里,866,1658,414,341,755,126,881
公投第１６案,新北市,三重區,慈愛里,867,1496,394,313,707,94,801
公投第１６案,新北市,三重區,慈化里,868,1064,308,268,576,79,655
公投第１６案,新北市,三重區,慈化里,869,1152,377,257,634,70,704
公投第１６案,新北市,三重區,慈祐里,870,1532,415,328,743,59,802
公投第１６案,新北市,三重區,慈祐里,871,1338,339,241,580,60,640
公投第１６案,新北市,三重區,慈祐里,872,1303,346,230,576,81,657
公投第１６案,新北市,三重區,富華里,873,1369,457,250,707,110,817
公投第１６案,新北市,三重區,富華里,874,1491,415,315,730,102,832
公投第１６案,新北市,三重區,富貴里,875,1821,447,361,808,140,948
公投第１６案,新北市,三重區,富貴里,876,1906,532,357,889,76,965
公投第１６案,新北市,三重區,富貴里,877,1842,552,411,963,86,1049
公投第１６案,新北市,三重區,富福里,878,878,240,165,405,69,474
公投第１６案,新北市,三重區,富福里,879,963,296,236,532,77,609
公投第１６案,新北市,三重區,五華里,880,1381,353,259,612,52,664
公投第１６案,新北市,三重區,五華里,881,1681,415,307,722,117,839
公投第１６案,新北市,三重區,五華里,882,1548,414,335,749,51,800
公投第１６案,新北市,三重區,碧華里,883,1542,459,350,809,85,894
公投第１６案,新北市,三重區,碧華里,884,1557,452,319,771,95,866
公投第１６案,新北市,三重區,碧華里,885,1661,519,306,825,76,901
公投第１６案,新北市,三重區,碧華里,886,2024,603,431,1034,47,1081
公投第１６案,新北市,三重區,福樂里,887,1588,383,314,697,98,795
公投第１６案,新北市,三重區,福樂里,888,1706,486,319,805,137,942
公投第１６案,新北市,三重區,仁華里,889,1341,392,309,701,82,783
公投第１６案,新北市,三重區,仁華里,890,1025,295,191,486,60,546
公投第１６案,新北市,三重區,仁華里,891,1339,403,279,682,86,768
公投第１６案,新北市,三重區,五順里,892,1725,467,343,810,152,962
公投第１６案,新北市,三重區,五順里,893,1826,516,361,877,119,996
公投第１６案,新北市,板橋區,留侯里,894,1388,373,299,672,98,770
公投第１６案,新北市,板橋區,流芳里,895,1294,405,288,693,66,759
公投第１６案,新北市,板橋區,赤松里,896,667,200,166,366,37,403
公投第１６案,新北市,板橋區,黃石里,897,898,235,183,418,57,475
公投第１６案,新北市,板橋區,挹秀里,898,829,283,186,469,37,506
公投第１６案,新北市,板橋區,挹秀里,899,739,249,165,414,48,462
公投第１６案,新北市,板橋區,湳興里,900,1035,341,220,561,70,631
公投第１６案,新北市,板橋區,湳興里,901,1713,380,322,702,74,776
公投第１６案,新北市,板橋區,湳興里,902,658,186,120,306,27,333
公投第１６案,新北市,板橋區,湳興里,903,1312,372,259,631,107,738
公投第１６案,新北市,板橋區,新興里,904,1492,385,305,690,73,763
公投第１６案,新北市,板橋區,新興里,905,1393,338,293,631,86,717
公投第１６案,新北市,板橋區,社後里,906,4742,478,335,813,67,880
公投第１６案,新北市,板橋區,社後里,907,1439,415,299,714,48,762
公投第１６案,新北市,板橋區,社後里,908,1187,380,261,641,79,720
公投第１６案,新北市,板橋區,社後里,909,1122,326,236,562,51,613
公投第１６案,新北市,板橋區,香社里,910,1363,447,293,740,44,784
公投第１６案,新北市,板橋區,香社里,911,1093,299,282,581,68,649
公投第１６案,新北市,板橋區,香社里,912,1331,409,309,718,53,771
公投第１６案,新北市,板橋區,香雅里,913,1026,312,260,572,67,639
公投第１６案,新北市,板橋區,香雅里,914,1244,361,232,593,136,729
公投第１６案,新北市,板橋區,中正里,915,1268,332,263,595,95,690
公投第１６案,新北市,板橋區,中正里,916,1313,344,251,595,61,656
公投第１６案,新北市,板橋區,中正里,917,1196,420,254,674,58,732
公投第１６案,新北市,板橋區,自強里,918,1137,442,283,725,50,775
公投第１６案,新北市,板橋區,自強里,919,1269,445,307,752,53,805
公投第１６案,新北市,板橋區,自強里,920,1117,387,253,640,40,680
公投第１６案,新北市,板橋區,自強里,921,1042,353,255,608,56,664
公投第１６案,新北市,板橋區,自立里,922,1257,350,322,672,90,762
公投第１６案,新北市,板橋區,自立里,923,1216,369,263,632,91,723
公投第１６案,新北市,板橋區,光華里,924,1126,340,250,590,72,662
公投第１６案,新北市,板橋區,光華里,925,1290,477,298,775,67,842
公投第１６案,新北市,板橋區,光榮里,926,1215,342,252,594,28,622
公投第１６案,新北市,板橋區,光榮里,927,1099,343,206,549,34,583
公投第１６案,新北市,板橋區,國光里,928,1329,547,245,792,54,846
公投第１６案,新北市,板橋區,國光里,929,996,391,176,567,41,608
公投第１６案,新北市,板橋區,國光里,930,1047,346,223,569,54,623
公投第１６案,新北市,板橋區,港尾里,931,1272,404,276,680,86,766
公投第１６案,新北市,板橋區,港尾里,932,1252,417,273,690,63,753
公投第１６案,新北市,板橋區,新生里,933,1238,349,298,647,84,731
公投第１６案,新北市,板橋區,新生里,934,1389,451,337,788,86,874
公投第１６案,新北市,板橋區,新生里,935,1194,401,268,669,82,751
公投第１６案,新北市,板橋區,金華里,936,1093,309,205,514,68,582
公投第１６案,新北市,板橋區,金華里,937,1148,338,231,569,90,659
公投第１６案,新北市,板橋區,金華里,938,1268,409,280,689,62,751
公投第１６案,新北市,板橋區,港德里,939,1230,342,285,627,91,718
公投第１６案,新北市,板橋區,港德里,940,1012,295,217,512,70,582
公投第１６案,新北市,板橋區,港德里,941,811,231,192,423,64,487
公投第１６案,新北市,板橋區,港德里,942,1197,367,288,655,102,757
公投第１６案,新北市,板橋區,民權里,943,1142,346,226,572,49,621
公投第１６案,新北市,板橋區,民權里,944,1222,381,255,636,63,699
公投第１６案,新北市,板橋區,民安里,945,796,278,170,448,56,504
公投第１６案,新北市,板橋區,民安里,946,997,333,223,556,90,646
公投第１６案,新北市,板橋區,建國里,947,1011,260,273,533,43,576
公投第１６案,新北市,板橋區,建國里,948,1157,327,251,578,85,663
公投第１６案,新北市,板橋區,建國里,949,1040,316,243,559,76,635
公投第１６案,新北市,板橋區,漢生里,950,1173,397,266,663,50,713
公投第１６案,新北市,板橋區,漢生里,951,1193,375,252,627,34,661
公投第１６案,新北市,板橋區,漢生里,952,1255,429,268,697,46,743
公投第１６案,新北市,板橋區,公舘里,953,1306,421,285,706,54,760
公投第１６案,新北市,板橋區,公舘里,954,1050,324,236,560,31,591
公投第１６案,新北市,板橋區,公舘里,955,942,264,234,498,48,546
公投第１６案,新北市,板橋區,新民里,956,1133,390,257,647,71,718
公投第１６案,新北市,板橋區,新民里,957,1251,389,279,668,65,733
公投第１６案,新北市,板橋區,新民里,958,1293,417,290,707,60,767
公投第１６案,新北市,板橋區,幸福里,959,1208,322,251,573,78,651
公投第１６案,新北市,板橋區,幸福里,960,1223,342,279,621,78,699
公投第１６案,新北市,板橋區,幸福里,961,1061,281,246,527,78,605
公投第１６案,新北市,板橋區,文德里,962,1515,465,328,793,72,865
公投第１６案,新北市,板橋區,文德里,963,1225,385,289,674,80,754
公投第１６案,新北市,板橋區,忠誠里,964,1120,426,253,679,36,715
公投第１６案,新北市,板橋區,忠誠里,965,1091,371,250,621,69,690
公投第１６案,新北市,板橋區,忠誠里,966,1385,530,266,796,54,850
公投第１６案,新北市,板橋區,陽明里,967,1283,405,301,706,84,790
公投第１６案,新北市,板橋區,陽明里,968,1204,343,275,618,108,726
公投第１６案,新北市,板橋區,百壽里,969,1191,402,282,684,73,757
公投第１６案,新北市,板橋區,百壽里,970,1078,334,264,598,89,687
公投第１６案,新北市,板橋區,介壽里,971,1351,421,294,715,83,798
公投第１６案,新北市,板橋區,介壽里,972,1322,406,283,689,87,776
公投第１６案,新北市,板橋區,新埔里,973,868,279,183,462,66,528
公投第１６案,新北市,板橋區,新埔里,974,1029,338,265,603,89,692
公投第１６案,新北市,板橋區,華江里,975,1602,517,364,881,59,940
公投第１６案,新北市,板橋區,華江里,976,1362,308,430,738,16,754
公投第１６案,新北市,板橋區,華江里,977,1698,512,359,871,96,967
公投第１６案,新北市,板橋區,華江里,978,1495,494,306,800,50,850
公投第１６案,新北市,板橋區,江翠里,979,1522,406,346,752,93,845
公投第１６案,新北市,板橋區,江翠里,980,1279,388,299,687,69,756
公投第１６案,新北市,板橋區,江翠里,981,1559,384,274,658,76,734
公投第１６案,新北市,板橋區,純翠里,982,1537,420,290,710,117,827
公投第１６案,新北市,板橋區,純翠里,983,1531,406,295,701,94,795
公投第１６案,新北市,板橋區,純翠里,984,1720,515,352,867,39,906
公投第１６案,新北市,板橋區,溪頭里,985,1165,341,220,561,54,615
公投第１６案,新北市,板橋區,溪頭里,986,1857,589,410,999,49,1048
公投第１６案,新北市,板橋區,溪頭里,987,1078,319,230,549,79,628
公投第１６案,新北市,板橋區,溪頭里,988,1177,322,266,588,30,618
公投第１６案,新北市,板橋區,聯翠里,989,1798,544,400,944,66,1010
公投第１６案,新北市,板橋區,聯翠里,990,1455,417,349,766,115,881
公投第１６案,新北市,板橋區,文化里,991,1245,370,299,669,96,765
公投第１６案,新北市,板橋區,文化里,992,1704,457,277,734,203,937
公投第１６案,新北市,板橋區,宏翠里,993,1600,528,202,730,44,774
公投第１６案,新北市,板橋區,宏翠里,994,1409,368,296,664,44,708
公投第１６案,新北市,板橋區,宏翠里,995,1286,354,312,666,75,741
公投第１６案,新北市,板橋區,仁翠里,996,1359,296,274,570,102,672
公投第１６案,新北市,板橋區,仁翠里,997,1188,332,237,569,55,624
公投第１６案,新北市,板橋區,新翠里,998,1627,441,346,787,62,849
公投第１６案,新北市,板橋區,新翠里,999,1633,429,299,728,53,781
公投第１６案,新北市,板橋區,新翠里,1000,1814,619,374,993,86,1079
公投第１６案,新北市,板橋區,新翠里,1001,1810,553,381,934,33,967
公投第１６案,新北市,板橋區,朝陽里,1002,1133,346,214,560,100,660
公投第１６案,新北市,板橋區,朝陽里,1003,841,245,186,431,45,476
公投第１６案,新北市,板橋區,朝陽里,1004,1050,321,255,576,79,655
公投第１６案,新北市,板橋區,吉翠里,1005,1130,286,257,543,98,641
公投第１６案,新北市,板橋區,吉翠里,1006,1056,328,247,575,83,658
公投第１６案,新北市,板橋區,吉翠里,1007,1129,301,231,532,47,579
公投第１６案,新北市,板橋區,德翠里,1008,1713,510,354,864,109,973
公投第１６案,新北市,板橋區,德翠里,1009,1622,500,343,843,110,953
公投第１６案,新北市,板橋區,德翠里,1010,1427,470,343,813,88,901
公投第１６案,新北市,板橋區,德翠里,1011,1471,514,351,865,40,905
公投第１６案,新北市,板橋區,新海里,1012,1076,299,225,524,36,560
公投第１６案,新北市,板橋區,新海里,1013,979,270,183,453,27,480
公投第１６案,新北市,板橋區,新海里,1014,1079,378,272,650,37,687
公投第１６案,新北市,板橋區,滿翠里,1015,828,248,165,413,58,471
公投第１６案,新北市,板橋區,滿翠里,1016,820,225,205,430,81,511
公投第１６案,新北市,板橋區,滿翠里,1017,989,291,226,517,49,566
公投第１６案,新北市,板橋區,明翠里,1018,1023,271,248,519,80,599
公投第１６案,新北市,板橋區,明翠里,1019,1044,271,245,516,48,564
公投第１６案,新北市,板橋區,明翠里,1020,968,290,203,493,85,578
公投第１６案,新北市,板橋區,明翠里,1021,1222,377,290,667,46,713
公投第１６案,新北市,板橋區,松翠里,1022,1385,389,309,698,62,760
公投第１６案,新北市,板橋區,松翠里,1023,1585,422,341,763,98,861
公投第１６案,新北市,板橋區,柏翠里,1024,1840,519,388,907,103,1010
公投第１６案,新北市,板橋區,柏翠里,1025,1806,524,477,1001,116,1117
公投第１６案,新北市,板橋區,龍翠里,1026,1506,429,322,751,110,861
公投第１６案,新北市,板橋區,龍翠里,1027,1476,387,329,716,110,826
公投第１６案,新北市,板橋區,龍翠里,1028,1500,454,339,793,85,878
公投第１６案,新北市,板橋區,松柏里,1029,1096,309,258,567,124,691
公投第１６案,新北市,板橋區,松柏里,1030,963,287,239,526,78,604
公投第１６案,新北市,板橋區,華翠里,1031,1601,183,607,790,65,855
公投第１６案,新北市,板橋區,華翠里,1032,1507,506,329,835,95,930
公投第１６案,新北市,板橋區,莒光里,1033,1315,406,322,728,88,816
公投第１６案,新北市,板橋區,莒光里,1034,1178,347,253,600,39,639
公投第１６案,新北市,板橋區,忠翠里,1035,1822,562,417,979,112,1091
公投第１６案,新北市,板橋區,忠翠里,1036,1605,525,375,900,95,995
公投第１６案,新北市,板橋區,忠翠里,1037,1549,528,348,876,22,898
公投第１６案,新北市,板橋區,忠翠里,1038,1948,653,447,1100,57,1157
公投第１６案,新北市,板橋區,忠翠里,1039,1935,608,386,994,45,1039
公投第１６案,新北市,板橋區,嵐翠里,1040,1097,291,233,524,57,581
公投第１６案,新北市,板橋區,嵐翠里,1041,1095,282,254,536,62,598
公投第１６案,新北市,板橋區,文聖里,1042,1678,493,307,800,120,920
公投第１６案,新北市,板橋區,文聖里,1043,1750,483,358,841,120,961
公投第１６案,新北市,板橋區,文翠里,1044,1187,310,269,579,88,667
公投第１６案,新北市,板橋區,文翠里,1045,1154,372,254,626,44,670
公投第１６案,新北市,板橋區,文翠里,1046,1262,395,274,669,39,708
公投第１６案,新北市,板橋區,青翠里,1047,1271,339,277,616,106,722
公投第１６案,新北市,板橋區,青翠里,1048,1410,384,298,682,123,805
公投第１６案,新北市,板橋區,懷翠里,1049,1745,457,333,790,120,910
公投第１６案,新北市,板橋區,懷翠里,1050,1867,514,387,901,156,1057
公投第１６案,新北市,板橋區,懷翠里,1051,1753,526,416,942,107,1049
公投第１６案,新北市,板橋區,福翠里,1052,1204,384,267,651,71,722
公投第１６案,新北市,板橋區,港嘴里,1053,1614,467,336,803,91,894
公投第１６案,新北市,板橋區,港嘴里,1054,1237,391,289,680,63,743
公投第１６案,新北市,板橋區,港嘴里,1055,1361,378,336,714,91,805
公投第１６案,新北市,板橋區,港嘴里,1056,1243,343,304,647,46,693
公投第１６案,新北市,板橋區,振興里,1057,1515,407,315,722,42,764
公投第１６案,新北市,板橋區,振興里,1058,1515,501,318,819,88,907
公投第１６案,新北市,板橋區,振興里,1059,949,294,221,515,72,587
公投第１６案,新北市,板橋區,振義里,1060,1629,463,340,803,98,901
公投第１６案,新北市,板橋區,振義里,1061,1238,360,295,655,66,721
公投第１６案,新北市,板橋區,振義里,1062,901,201,147,348,36,384
公投第１６案,新北市,板橋區,光復里,1063,1475,434,330,764,101,865
公投第１６案,新北市,板橋區,光復里,1064,1481,420,323,743,90,833
公投第１６案,新北市,板橋區,埔墘里,1065,1800,453,343,796,128,924
公投第１６案,新北市,板橋區,埔墘里,1066,1630,489,335,824,80,904
公投第１６案,新北市,板橋區,埔墘里,1067,1298,437,271,708,67,775
公投第１６案,新北市,板橋區,埔墘里,1068,874,273,197,470,53,523
公投第１６案,新北市,板橋區,富貴里,1069,992,281,225,506,21,527
公投第１６案,新北市,板橋區,富貴里,1070,1034,374,247,621,26,647
公投第１６案,新北市,板橋區,長壽里,1071,1451,428,349,777,89,866
公投第１６案,新北市,板橋區,長壽里,1072,1130,354,279,633,57,690
公投第１６案,新北市,板橋區,福壽里,1073,1440,481,301,782,67,849
公投第１６案,新北市,板橋區,福壽里,1074,1531,427,371,798,110,908
公投第１６案,新北市,板橋區,居仁里,1075,1349,439,341,780,83,863
公投第１６案,新北市,板橋區,居仁里,1076,1593,423,326,749,70,819
公投第１６案,新北市,板橋區,海山里,1077,1174,356,246,602,48,650
公投第１６案,新北市,板橋區,海山里,1078,1228,342,299,641,61,702
公投第１６案,新北市,板橋區,海山里,1079,1187,365,263,628,49,677
公投第１６案,新北市,板橋區,海山里,1080,870,272,204,476,60,536
公投第１６案,新北市,板橋區,海山里,1081,2033,711,425,1136,78,1214
公投第１６案,新北市,板橋區,九如里,1082,1418,403,301,704,67,771
公投第１６案,新北市,板橋區,九如里,1083,1075,301,253,554,68,622
公投第１６案,新北市,板橋區,正泰里,1084,1515,458,300,758,46,804
公投第１６案,新北市,板橋區,正泰里,1085,1182,392,280,672,60,732
公投第１６案,新北市,板橋區,玉光里,1086,1893,573,386,959,96,1055
公投第１６案,新北市,板橋區,玉光里,1087,1302,369,272,641,79,720
公投第１６案,新北市,板橋區,玉光里,1088,1366,380,263,643,78,721
公投第１６案,新北市,板橋區,光仁里,1089,1318,358,329,687,104,791
公投第１６案,新北市,板橋區,光仁里,1090,1200,320,285,605,60,665
公投第１６案,新北市,板橋區,埤墘里,1091,2028,595,464,1059,79,1138
公投第１６案,新北市,板橋區,埤墘里,1092,1746,512,383,895,129,1024
公投第１６案,新北市,板橋區,莊敬里,1093,1954,579,352,931,42,973
公投第１６案,新北市,板橋區,莊敬里,1094,1474,442,308,750,75,825
公投第１６案,新北市,板橋區,永安里,1095,1418,390,317,707,79,786
公投第１６案,新北市,板橋區,永安里,1096,1563,468,408,876,88,964
公投第１６案,新北市,板橋區,雙玉里,1097,1780,485,383,868,115,983
公投第１６案,新北市,板橋區,雙玉里,1098,1707,502,361,863,61,924
公投第１６案,新北市,板橋區,廣新里,1099,906,203,110,313,14,327
公投第１６案,新北市,板橋區,廣新里,1100,1030,296,224,520,73,593
公投第１６案,新北市,板橋區,廣新里,1101,1115,316,275,591,65,656
公投第１６案,新北市,板橋區,深丘里,1102,1836,593,340,933,46,979
公投第１６案,新北市,板橋區,深丘里,1103,1881,553,374,927,100,1027
公投第１６案,新北市,板橋區,深丘里,1104,1688,485,384,869,58,927
公投第１６案,新北市,板橋區,深丘里,1105,1760,563,416,979,59,1038
公投第１６案,新北市,板橋區,香丘里,1106,1044,325,262,587,67,654
公投第１６案,新北市,板橋區,香丘里,1107,1043,329,241,570,55,625
公投第１６案,新北市,板橋區,香丘里,1108,1099,365,242,607,80,687
公投第１６案,新北市,板橋區,西安里,1109,1260,358,91,449,77,526
公投第１６案,新北市,板橋區,西安里,1110,1131,347,248,595,67,662
公投第１６案,新北市,板橋區,東丘里,1111,1225,348,303,651,70,721
公投第１６案,新北市,板橋區,東丘里,1112,1455,570,272,842,66,908
公投第１６案,新北市,板橋區,東丘里,1113,1267,332,293,625,95,720
公投第１６案,新北市,板橋區,民生里,1114,972,257,253,510,70,580
公投第１６案,新北市,板橋區,民生里,1115,994,301,241,542,52,594
公投第１６案,新北市,板橋區,長安里,1116,1111,330,277,607,36,643
公投第１６案,新北市,板橋區,長安里,1117,1177,288,400,688,94,782
公投第１６案,新北市,板橋區,長安里,1118,1544,476,300,776,82,858
公投第１６案,新北市,板橋區,東安里,1119,1021,305,196,501,87,588
公投第１６案,新北市,板橋區,東安里,1120,1040,291,220,511,81,592
公投第１６案,新北市,板橋區,福丘里,1121,1504,445,323,768,56,824
公投第１６案,新北市,板橋區,福丘里,1122,1373,425,275,700,44,744
公投第１６案,新北市,板橋區,福丘里,1123,1210,399,277,676,32,708
公投第１６案,新北市,板橋區,福祿里,1124,1809,618,259,877,86,963
公投第１６案,新北市,板橋區,福祿里,1125,1551,483,326,809,107,916
公投第１６案,新北市,板橋區,民族里,1126,1408,468,301,769,55,824
公投第１６案,新北市,板橋區,民族里,1127,1285,420,280,700,52,752
公投第１６案,新北市,板橋區,民族里,1128,1102,352,282,634,53,687
公投第１６案,新北市,板橋區,國泰里,1129,1399,407,262,669,49,718
公投第１６案,新北市,板橋區,國泰里,1130,1692,536,322,858,96,954
公投第１６案,新北市,板橋區,後埔里,1131,1625,533,362,895,64,959
公投第１６案,新北市,板橋區,後埔里,1132,1712,533,367,900,94,994
公投第１６案,新北市,板橋區,福德里,1133,1246,394,258,652,55,707
公投第１６案,新北市,板橋區,福德里,1134,1471,461,314,775,43,818
公投第１６案,新北市,板橋區,福德里,1135,1761,554,364,918,79,997
公投第１６案,新北市,板橋區,景星里,1136,1499,464,319,783,75,858
公投第１６案,新北市,板橋區,景星里,1137,1528,444,244,688,76,764
公投第１６案,新北市,板橋區,福星里,1138,1536,503,316,819,78,897
公投第１６案,新北市,板橋區,福星里,1139,1550,472,344,816,79,895
公投第１６案,新北市,板橋區,鄉雲里,1140,2050,621,439,1060,112,1172
公投第１６案,新北市,板橋區,鄉雲里,1141,1300,418,291,709,66,775
公投第１６案,新北市,板橋區,廣德里,1142,1537,493,327,820,61,881
公投第１６案,新北市,板橋區,廣德里,1143,1341,317,313,630,46,676
公投第１６案,新北市,板橋區,廣德里,1144,1606,486,332,818,85,903
公投第１６案,新北市,板橋區,廣德里,1145,1433,419,276,695,48,743
公投第１６案,新北市,板橋區,大豐里,1146,1685,475,316,791,61,852
公投第１６案,新北市,板橋區,大豐里,1147,1248,407,298,705,65,770
公投第１６案,新北市,板橋區,大豐里,1148,1172,369,185,554,53,607
公投第１６案,新北市,板橋區,重慶里,1149,1640,414,289,703,67,770
公投第１６案,新北市,板橋區,重慶里,1150,1428,476,252,728,52,780
公投第１６案,新北市,板橋區,重慶里,1151,1527,406,385,791,87,878
公投第１６案,新北市,板橋區,重慶里,1152,1350,431,304,735,54,789
公投第１６案,新北市,板橋區,重慶里,1153,1582,501,305,806,90,896
公投第１６案,新北市,板橋區,仁愛里,1154,919,329,212,541,60,601
公投第１６案,新北市,板橋區,仁愛里,1155,930,277,206,483,30,513
公投第１６案,新北市,板橋區,仁愛里,1156,974,326,236,562,43,605
公投第１６案,新北市,板橋區,和平里,1157,1732,582,360,942,61,1003
公投第１６案,新北市,板橋區,和平里,1158,1438,410,322,732,78,810
公投第１６案,新北市,板橋區,廣福里,1159,1777,513,331,844,126,970
公投第１６案,新北市,板橋區,廣福里,1160,1764,466,334,800,77,877
公投第１６案,新北市,板橋區,五權里,1161,1289,364,294,658,42,700
公投第１６案,新北市,板橋區,五權里,1162,1182,331,248,579,97,676
公投第１６案,新北市,板橋區,五權里,1163,1174,376,252,628,81,709
公投第１６案,新北市,板橋區,華興里,1164,1870,538,387,925,86,1011
公投第１６案,新北市,板橋區,華興里,1165,1842,599,396,995,83,1078
公投第１６案,新北市,板橋區,華貴里,1166,1094,338,227,565,73,638
公投第１６案,新北市,板橋區,華貴里,1167,1228,358,240,598,77,675
公投第１６案,新北市,板橋區,華福里,1168,998,328,250,578,62,640
公投第１６案,新北市,板橋區,華福里,1169,862,284,234,518,52,570
公投第１６案,新北市,板橋區,華德里,1170,1622,439,357,796,64,860
公投第１６案,新北市,板橋區,華德里,1171,1205,330,309,639,78,717
公投第１６案,新北市,板橋區,華德里,1172,1787,482,363,845,61,906
公投第１６案,新北市,板橋區,華德里,1173,1610,556,326,882,41,923
公投第１６案,新北市,板橋區,華東里,1174,2216,749,483,1232,60,1292
公投第１６案,新北市,板橋區,華東里,1175,2294,704,491,1195,73,1268
公投第１６案,新北市,板橋區,華東里,1176,2090,593,401,994,114,1108
公投第１６案,新北市,板橋區,信義里,1177,1356,386,250,636,43,679
公投第１６案,新北市,板橋區,信義里,1178,1067,325,246,571,53,624
公投第１６案,新北市,板橋區,信義里,1179,1319,269,312,581,82,663
公投第１６案,新北市,板橋區,浮洲里,1180,1316,345,265,610,73,683
公投第１６案,新北市,板橋區,浮洲里,1181,1195,331,234,565,81,646
公投第１６案,新北市,板橋區,浮洲里,1182,857,244,218,462,45,507
公投第１６案,新北市,板橋區,華中里,1183,1417,401,284,685,92,777
公投第１６案,新北市,板橋區,華中里,1184,1560,428,376,804,106,910
公投第１６案,新北市,板橋區,華中里,1185,1747,505,360,865,120,985
公投第１６案,新北市,板橋區,僑中里,1186,1176,434,243,677,73,750
公投第１６案,新北市,板橋區,僑中里,1187,1101,324,278,602,45,647
公投第１６案,新北市,板橋區,僑中里,1188,1458,454,337,791,43,834
公投第１６案,新北市,板橋區,大觀里,1189,1630,441,302,743,58,801
公投第１６案,新北市,板橋區,大觀里,1190,1611,417,298,715,142,857
公投第１６案,新北市,板橋區,歡園里,1191,1139,330,234,564,40,604
公投第１６案,新北市,板橋區,中山里,1192,1120,341,210,551,59,610
公投第１６案,新北市,板橋區,中山里,1193,1022,300,214,514,113,627
公投第１６案,新北市,板橋區,中山里,1194,1049,305,230,535,106,641
公投第１６案,新北市,板橋區,中山里,1195,1007,325,213,538,43,581
公投第１６案,新北市,板橋區,中山里,1196,1393,450,287,737,44,781
公投第１６案,新北市,板橋區,復興里,1197,474,80,74,154,46,200
公投第１６案,新北市,板橋區,復興里,1198,500,156,104,260,39,299
公投第１６案,新北市,板橋區,大安里,1199,1177,346,246,592,68,660
公投第１６案,新北市,板橋區,大安里,1200,1186,312,286,598,50,648
公投第１６案,新北市,板橋區,大安里,1201,1139,358,240,598,92,690
公投第１６案,新北市,板橋區,福安里,1202,1750,501,367,868,98,966
公投第１６案,新北市,板橋區,福安里,1203,3451,640,458,1098,65,1163
公投第１６案,新北市,板橋區,聚安里,1204,1620,435,316,751,110,861
公投第１６案,新北市,板橋區,聚安里,1205,903,247,157,404,33,437
公投第１６案,新北市,板橋區,聚安里,1206,1232,373,287,660,57,717
公投第１６案,新北市,板橋區,聚安里,1207,975,238,197,435,36,471
公投第１６案,新北市,板橋區,龍安里,1208,1224,333,265,598,52,650
公投第１６案,新北市,板橋區,龍安里,1209,1291,353,311,664,25,689
公投第１６案,新北市,板橋區,崑崙里,1210,1828,493,347,840,57,897
公投第１６案,新北市,板橋區,崑崙里,1211,1725,469,329,798,70,868
公投第１６案,新北市,板橋區,崑崙里,1212,1085,286,197,483,38,521
公投第１６案,新北市,板橋區,崑崙里,1213,2357,659,455,1114,59,1173
公投第１６案,新北市,板橋區,崑崙里,1214,1560,444,337,781,49,830
公投第１６案,新北市,板橋區,成和里,1215,2201,565,356,921,44,965
公投第１６案,新北市,板橋區,成和里,1216,1626,469,320,789,70,859
公投第１６案,新北市,板橋區,成和里,1217,1786,446,319,765,60,825
公投第１６案,新北市,板橋區,溪洲里,1218,1763,486,548,1034,61,1095
公投第１６案,新北市,板橋區,溪洲里,1219,1744,469,354,823,29,852
公投第１６案,新北市,板橋區,溪洲里,1220,1645,454,317,771,84,855
公投第１６案,新北市,板橋區,溪福里,1221,1861,516,315,831,63,894
公投第１６案,新北市,板橋區,溪福里,1222,1596,423,307,730,47,777
公投第１６案,新北市,板橋區,溪福里,1223,1871,549,370,919,94,1013
公投第１６案,新北市,板橋區,溪福里,1224,1938,590,373,963,102,1065
公投第１６案,新北市,板橋區,溪福里,1225,1827,536,401,937,82,1019
公投第１６案,新北市,板橋區,溪福里,1226,1359,385,262,647,69,716
公投第１６案,新北市,板橋區,溪福里,1227,1613,530,283,813,73,886
公投第１６案,新北市,板橋區,溪北里,1228,1566,473,327,800,84,884
公投第１６案,新北市,板橋區,溪北里,1229,1552,513,364,877,73,950
公投第１６案,新北市,板橋區,堂春里,1230,1885,509,388,897,53,950
公投第１６案,新北市,板橋區,堂春里,1231,1893,488,378,866,128,994
公投第１６案,新北市,中和區,中原里,1232,1630,463,311,774,75,849
公投第１６案,新北市,中和區,中原里,1233,1775,518,399,917,76,993
公投第１６案,新北市,中和區,中原里,1234,1844,533,333,866,59,925
公投第１６案,新北市,中和區,連和里,1235,1019,374,235,609,38,647
公投第１６案,新北市,中和區,連和里,1236,1138,402,238,640,58,698
公投第１６案,新北市,中和區,連城里,1237,1878,563,303,866,58,924
公投第１６案,新北市,中和區,連城里,1238,1980,701,349,1050,76,1126
公投第１６案,新北市,中和區,連城里,1239,1844,555,372,927,104,1031
公投第１６案,新北市,中和區,力行里,1240,2085,669,410,1079,61,1140
公投第１６案,新北市,中和區,力行里,1241,1498,468,284,752,81,833
公投第１６案,新北市,中和區,力行里,1242,1761,555,353,908,51,959
公投第１６案,新北市,中和區,正行里,1243,1254,361,267,628,51,679
公投第１６案,新北市,中和區,正行里,1244,1343,433,295,728,57,785
公投第１６案,新北市,中和區,德行里,1245,1789,576,338,914,61,975
公投第１６案,新北市,中和區,德行里,1246,2000,644,396,1040,53,1093
公投第１６案,新北市,中和區,德行里,1247,1953,547,368,915,58,973
公投第１６案,新北市,中和區,枋寮里,1248,1712,528,344,872,78,950
公投第１６案,新北市,中和區,枋寮里,1249,1582,536,290,826,75,901
公投第１６案,新北市,中和區,漳和里,1250,1742,552,326,878,79,957
公投第１６案,新北市,中和區,漳和里,1251,1493,515,325,840,76,916
公投第１６案,新北市,中和區,廟美里,1252,1352,377,276,653,64,717
公投第１６案,新北市,中和區,廟美里,1253,1244,431,254,685,56,741
公投第１６案,新北市,中和區,廟美里,1254,1394,446,297,743,74,817
公投第１６案,新北市,中和區,福真里,1255,1917,504,304,808,40,848
公投第１６案,新北市,中和區,福真里,1256,1830,492,361,853,102,955
公投第１６案,新北市,中和區,福善里,1257,1124,339,248,587,79,666
公投第１６案,新北市,中和區,福善里,1258,1412,362,285,647,53,700
公投第１６案,新北市,中和區,福善里,1259,1356,394,285,679,64,743
公投第１６案,新北市,中和區,福美里,1260,1425,447,173,620,56,676
公投第１６案,新北市,中和區,福美里,1261,1259,386,285,671,87,758
公投第１６案,新北市,中和區,福美里,1262,1256,351,288,639,94,733
公投第１６案,新北市,中和區,福祥里,1263,1423,447,280,727,69,796
公投第１６案,新北市,中和區,福祥里,1264,1221,372,269,641,68,709
公投第１６案,新北市,中和區,福祥里,1265,1858,513,332,845,89,934
公投第１６案,新北市,中和區,瓦磘里,1266,1804,518,341,859,68,927
公投第１６案,新北市,中和區,瓦磘里,1267,1669,545,358,903,49,952
公投第１６案,新北市,中和區,瓦磘里,1268,1485,467,312,779,57,836
公投第１６案,新北市,中和區,福和里,1269,1005,313,230,543,68,611
公投第１６案,新北市,中和區,福和里,1270,1175,392,284,676,74,750
公投第１６案,新北市,中和區,福和里,1271,1171,370,252,622,71,693
公投第１６案,新北市,中和區,佳和里,1272,1746,486,326,812,58,870
公投第１６案,新北市,中和區,佳和里,1273,1555,426,281,707,58,765
公投第１６案,新北市,中和區,佳和里,1274,1112,327,231,558,80,638
公投第１６案,新北市,中和區,新南里,1275,1780,609,367,976,75,1051
公投第１６案,新北市,中和區,新南里,1276,1918,609,373,982,68,1050
公投第１６案,新北市,中和區,新南里,1277,1689,468,261,729,38,767
公投第１６案,新北市,中和區,新南里,1278,1781,629,348,977,51,1028
公投第１６案,新北市,中和區,南山里,1279,1419,433,303,736,65,801
公投第１６案,新北市,中和區,南山里,1280,1344,404,264,668,57,725
公投第１６案,新北市,中和區,南山里,1281,1804,673,380,1053,70,1123
公投第１６案,新北市,中和區,平河里,1282,1788,496,383,879,80,959
公投第１６案,新北市,中和區,平河里,1283,1793,554,384,938,65,1003
公投第１６案,新北市,中和區,平河里,1284,1352,439,251,690,91,781
公投第１６案,新北市,中和區,平河里,1285,1813,629,311,940,85,1025
公投第１６案,新北市,中和區,平河里,1286,1288,481,279,760,54,814
公投第１６案,新北市,中和區,信和里,1287,1186,357,259,616,51,667
公投第１６案,新北市,中和區,信和里,1288,1237,326,263,589,12,601
公投第１６案,新北市,中和區,信和里,1289,1406,444,268,712,60,772
公投第１６案,新北市,中和區,仁和里,1290,1442,440,274,714,94,808
公投第１６案,新北市,中和區,仁和里,1291,1040,317,271,588,60,648
公投第１６案,新北市,中和區,仁和里,1292,1292,403,292,695,90,785
公投第１６案,新北市,中和區,中正里,1293,1811,558,347,905,78,983
公投第１６案,新北市,中和區,中正里,1294,1789,563,339,902,123,1025
公投第１６案,新北市,中和區,建和里,1295,859,324,188,512,53,565
公投第１６案,新北市,中和區,建和里,1296,972,372,203,575,50,625
公投第１６案,新北市,中和區,建和里,1297,1346,409,296,705,67,772
公投第１６案,新北市,中和區,中山里,1298,1034,321,228,549,49,598
公投第１６案,新北市,中和區,中山里,1299,1387,453,282,735,65,800
公投第１６案,新北市,中和區,碧河里,1300,2067,661,393,1054,116,1170
公投第１６案,新北市,中和區,碧河里,1301,1670,430,311,741,65,806
公投第１６案,新北市,中和區,正南里,1302,1166,357,233,590,74,664
公投第１６案,新北市,中和區,正南里,1303,963,325,201,526,47,573
公投第１６案,新北市,中和區,正南里,1304,1070,292,221,513,50,563
公投第１６案,新北市,中和區,頂南里,1305,1319,362,263,625,71,696
公投第１６案,新北市,中和區,頂南里,1306,1438,510,290,800,82,882
公投第１６案,新北市,中和區,華新里,1307,1808,590,282,872,48,920
公投第１６案,新北市,中和區,華新里,1308,1191,385,207,592,31,623
公投第１６案,新北市,中和區,華新里,1309,1632,494,335,829,78,907
公投第１６案,新北市,中和區,華新里,1310,1765,504,330,834,57,891
公投第１６案,新北市,中和區,東南里,1311,1168,450,216,666,38,704
公投第１６案,新北市,中和區,東南里,1312,1176,400,220,620,29,649
公投第１６案,新北市,中和區,東南里,1313,1565,612,307,919,65,984
公投第１６案,新北市,中和區,華南里,1314,1578,445,308,753,59,812
公投第１６案,新北市,中和區,華南里,1315,2029,613,421,1034,45,1079
公投第１６案,新北市,中和區,華南里,1316,905,271,206,477,45,522
公投第１６案,新北市,中和區,忠孝里,1317,839,231,162,393,50,443
公投第１６案,新北市,中和區,忠孝里,1318,762,244,157,401,36,437
公投第１６案,新北市,中和區,忠孝里,1319,1420,327,282,609,86,695
公投第１６案,新北市,中和區,忠孝里,1320,1272,392,238,630,66,696
公投第１６案,新北市,中和區,崇南里,1321,1976,635,334,969,80,1049
公投第１６案,新北市,中和區,崇南里,1322,1779,628,290,918,54,972
公投第１６案,新北市,中和區,興南里,1323,1454,376,259,635,73,708
公投第１６案,新北市,中和區,興南里,1324,1374,414,244,658,56,714
公投第１６案,新北市,中和區,景南里,1325,1369,401,239,640,54,694
公投第１６案,新北市,中和區,景南里,1326,1501,451,312,763,70,833
公投第１６案,新北市,中和區,景本里,1327,920,317,208,525,75,600
公投第１６案,新北市,中和區,景本里,1328,1050,366,214,580,68,648
公投第１６案,新北市,中和區,橫路里,1329,321,99,74,173,25,198
公投第１６案,新北市,中和區,內南里,1330,1474,435,276,711,83,794
公投第１６案,新北市,中和區,內南里,1331,1461,460,275,735,103,838
公投第１６案,新北市,中和區,內南里,1332,1621,508,290,798,61,859
公投第１６案,新北市,中和區,壽南里,1333,1327,369,333,702,83,785
公投第１６案,新北市,中和區,壽南里,1334,775,238,167,405,46,451
公投第１６案,新北市,中和區,福南里,1335,1916,534,372,906,54,960
公投第１６案,新北市,中和區,福南里,1336,1901,535,353,888,94,982
公投第１６案,新北市,中和區,外南里,1337,4411,413,294,707,58,765
公投第１６案,新北市,中和區,外南里,1338,1212,366,246,612,63,675
公投第１６案,新北市,中和區,外南里,1339,1126,368,232,600,53,653
公投第１６案,新北市,中和區,中興里,1340,1507,461,235,696,44,740
公投第１６案,新北市,中和區,中興里,1341,1519,485,305,790,26,816
公投第１６案,新北市,中和區,中興里,1342,1467,476,305,781,62,843
公投第１６案,新北市,中和區,中興里,1343,1453,471,313,784,98,882
公投第１６案,新北市,中和區,吉興里,1344,1364,496,274,770,54,824
公投第１６案,新北市,中和區,吉興里,1345,1302,410,264,674,57,731
公投第１６案,新北市,中和區,復興里,1346,1627,439,259,698,47,745
公投第１６案,新北市,中和區,復興里,1347,1503,421,306,727,48,775
公投第１６案,新北市,中和區,復興里,1348,1392,409,282,691,36,727
公投第１６案,新北市,中和區,和興里,1349,1067,353,242,595,44,639
公投第１６案,新北市,中和區,和興里,1350,1623,478,318,796,65,861
公投第１６案,新北市,中和區,和興里,1351,1208,428,245,673,37,710
公投第１６案,新北市,中和區,景平里,1352,1991,492,322,814,75,889
公投第１６案,新北市,中和區,景平里,1353,1932,557,268,825,77,902
公投第１６案,新北市,中和區,景平里,1354,947,376,215,591,35,626
公投第１６案,新北市,中和區,景新里,1355,1660,519,344,863,96,959
公投第１６案,新北市,中和區,景新里,1356,1574,446,275,721,65,786
公投第１６案,新北市,中和區,景福里,1357,2136,620,388,1008,72,1080
公投第１６案,新北市,中和區,景福里,1358,1462,440,257,697,84,781
公投第１６案,新北市,中和區,景福里,1359,1548,425,288,713,101,814
公投第１６案,新北市,中和區,景安里,1360,692,260,160,420,37,457
公投第１６案,新北市,中和區,景安里,1361,1221,478,221,699,72,771
公投第１６案,新北市,中和區,景安里,1362,1331,429,291,720,71,791
公投第１６案,新北市,中和區,景安里,1363,984,310,238,548,60,608
公投第１６案,新北市,中和區,景文里,1364,1871,567,324,891,54,945
公投第１６案,新北市,中和區,景文里,1365,1279,375,238,613,71,684
公投第１６案,新北市,中和區,錦和里,1366,1629,522,343,865,60,925
公投第１６案,新北市,中和區,錦和里,1367,1482,464,328,792,50,842
公投第１６案,新北市,中和區,錦和里,1368,1715,544,390,934,68,1002
公投第１６案,新北市,中和區,錦昌里,1369,1952,647,362,1009,77,1086
公投第１６案,新北市,中和區,灰磘里,1370,686,195,154,349,50,399
公投第１６案,新北市,中和區,積穗里,1371,1577,396,313,709,52,761
公投第１６案,新北市,中和區,積穗里,1372,1158,367,262,629,52,681
公投第１６案,新北市,中和區,積穗里,1373,1195,348,365,713,35,748
公投第１６案,新北市,中和區,積穗里,1374,1054,370,253,623,52,675
公投第１６案,新北市,中和區,積穗里,1375,612,211,152,363,30,393
公投第１６案,新北市,中和區,積穗里,1376,1668,559,333,892,53,945
公投第１６案,新北市,中和區,民享里,1377,1071,363,245,608,74,682
公投第１６案,新北市,中和區,民享里,1378,1169,441,275,716,83,799
公投第１６案,新北市,中和區,員山里,1379,1370,402,283,685,54,739
公投第１６案,新北市,中和區,員山里,1380,1574,514,343,857,99,956
公投第１６案,新北市,中和區,員山里,1381,2614,663,440,1103,53,1156
公投第１６案,新北市,中和區,嘉穗里,1382,1477,498,314,812,60,872
公投第１６案,新北市,中和區,嘉穗里,1383,1041,294,244,538,74,612
公投第１６案,新北市,中和區,文元里,1384,1538,439,275,714,76,790
公投第１６案,新北市,中和區,文元里,1385,1599,462,317,779,78,857
公投第１６案,新北市,中和區,文元里,1386,1586,499,329,828,110,938
公投第１６案,新北市,中和區,嘉新里,1387,1726,517,431,948,98,1046
公投第１６案,新北市,中和區,嘉新里,1388,1854,583,442,1025,108,1133
公投第１６案,新北市,中和區,民安里,1389,1472,478,336,814,83,897
公投第１６案,新北市,中和區,民安里,1390,1430,484,307,791,79,870
公投第１６案,新北市,中和區,民安里,1391,1488,508,313,821,69,890
公投第１６案,新北市,中和區,安穗里,1392,1251,392,238,630,53,683
公投第１６案,新北市,中和區,安穗里,1393,1487,483,313,796,67,863
公投第１６案,新北市,中和區,安穗里,1394,1328,393,256,649,96,745
公投第１６案,新北市,中和區,瑞穗里,1395,1128,378,261,639,61,700
公投第１６案,新北市,中和區,瑞穗里,1396,1008,376,239,615,44,659
公投第１６案,新北市,中和區,明穗里,1397,1786,561,413,974,48,1022
公投第１６案,新北市,中和區,明穗里,1398,2219,682,441,1123,68,1191
公投第１６案,新北市,中和區,清穗里,1399,1322,354,267,621,53,674
公投第１６案,新北市,中和區,清穗里,1400,1495,438,295,733,43,776
公投第１６案,新北市,中和區,自強里,1401,1414,396,293,689,76,765
公投第１６案,新北市,中和區,自強里,1402,1681,489,393,882,88,970
公投第１６案,新北市,中和區,自強里,1403,1361,421,264,685,71,756
公投第１６案,新北市,中和區,德穗里,1404,1442,439,291,730,75,805
公投第１６案,新北市,中和區,德穗里,1405,1383,400,269,669,39,708
公投第１６案,新北市,中和區,德穗里,1406,1264,429,259,688,40,728
公投第１６案,新北市,中和區,民生里,1407,1810,585,376,961,127,1088
公投第１６案,新北市,中和區,民生里,1408,1951,532,338,870,91,961
公投第１６案,新北市,中和區,國光里,1409,1582,468,260,728,60,788
公投第１６案,新北市,中和區,國光里,1410,1945,631,417,1048,104,1152
公投第１６案,新北市,中和區,壽德里,1411,1390,459,290,749,58,807
公投第１６案,新北市,中和區,壽德里,1412,1161,371,261,632,29,661
公投第１６案,新北市,中和區,壽德里,1413,1399,506,213,719,58,777
公投第１６案,新北市,中和區,明德里,1414,1070,305,244,549,33,582
公投第１６案,新北市,中和區,明德里,1415,1169,330,269,599,28,627
公投第１６案,新北市,中和區,明德里,1416,1214,436,255,691,76,767
公投第１６案,新北市,中和區,錦中里,1417,1398,452,306,758,69,827
公投第１６案,新北市,中和區,錦中里,1418,1049,308,248,556,52,608
公投第１６案,新北市,中和區,錦中里,1419,1324,439,316,755,61,816
公投第１６案,新北市,中和區,錦盛里,1420,1765,467,292,759,60,819
公投第１６案,新北市,中和區,錦盛里,1421,1709,424,355,779,101,880
公投第１６案,新北市,中和區,民有里,1422,1186,357,252,609,87,696
公投第１６案,新北市,中和區,民有里,1423,1318,439,255,694,80,774
公投第１６案,新北市,中和區,員富里,1424,1430,488,289,777,79,856
公投第１６案,新北市,中和區,員富里,1425,1637,401,250,651,77,728
公投第１６案,新北市,中和區,嘉慶里,1426,1283,373,261,634,76,710
公投第１６案,新北市,中和區,嘉慶里,1427,1310,356,322,678,69,747
公投第１６案,新北市,中和區,嘉慶里,1428,1301,421,281,702,65,767
公投第１６案,新北市,中和區,冠穗里,1429,1681,493,368,861,99,960
公投第１６案,新北市,中和區,冠穗里,1430,1384,427,296,723,68,791
公投第１６案,新北市,中和區,國華里,1431,1187,339,265,604,80,684
公投第１６案,新北市,中和區,國華里,1432,1779,445,315,760,3,763
公投第１６案,新北市,中和區,宜安里,1433,1712,560,343,903,68,971
公投第１６案,新北市,中和區,安樂里,1434,1462,448,281,729,71,800
公投第１６案,新北市,中和區,安樂里,1435,1824,592,326,918,51,969
公投第１６案,新北市,中和區,安和里,1436,1389,524,173,697,80,777
公投第１６案,新北市,中和區,安和里,1437,1434,489,293,782,65,847
公投第１６案,新北市,中和區,安順里,1438,1953,330,630,960,80,1040
公投第１６案,新北市,中和區,安順里,1439,2002,632,396,1028,98,1126
公投第１６案,新北市,中和區,安平里,1440,1858,602,322,924,54,978
公投第１６案,新北市,中和區,安平里,1441,1801,600,344,944,50,994
公投第１６案,新北市,中和區,安平里,1442,1691,584,314,898,74,972
公投第１６案,新北市,中和區,中安里,1443,1363,478,269,747,64,811
公投第１６案,新北市,中和區,中安里,1444,1220,454,258,712,50,762
公投第１６案,新北市,中和區,中安里,1445,1365,488,323,811,47,858
公投第１６案,新北市,中和區,泰安里,1446,1178,392,230,622,46,668
公投第１６案,新北市,中和區,泰安里,1447,830,251,210,461,43,504
公投第１６案,新北市,中和區,泰安里,1448,1197,321,244,565,75,640
公投第１６案,新北市,中和區,秀山里,1449,1369,451,281,732,68,800
公投第１６案,新北市,中和區,秀山里,1450,1336,448,277,725,73,798
公投第１６案,新北市,中和區,秀山里,1451,1377,486,302,788,70,858
公投第１６案,新北市,中和區,秀成里,1452,1499,493,314,807,78,885
公投第１６案,新北市,中和區,秀成里,1453,1689,592,332,924,54,978
公投第１６案,新北市,中和區,秀義里,1454,1323,403,326,729,66,795
公投第１６案,新北市,中和區,秀義里,1455,1079,369,234,603,69,672
公投第１６案,新北市,中和區,秀福里,1456,1545,482,357,839,72,911
公投第１６案,新北市,中和區,秀福里,1457,1326,398,261,659,73,732
公投第１６案,新北市,中和區,秀福里,1458,1443,500,246,746,39,785
公投第１６案,新北市,中和區,秀景里,1459,1712,591,312,903,47,950
公投第１６案,新北市,中和區,秀景里,1460,1916,641,319,960,84,1044
公投第１６案,新北市,中和區,秀景里,1461,863,287,196,483,58,541
公投第１６案,新北市,中和區,秀景里,1462,1203,441,284,725,12,737
公投第１６案,新北市,中和區,秀明里,1463,1483,505,264,769,34,803
公投第１６案,新北市,中和區,秀明里,1464,1575,507,273,780,62,842
公投第１６案,新北市,中和區,秀明里,1465,1432,413,250,663,63,726
公投第１６案,新北市,中和區,秀峰里,1466,1441,433,294,727,79,806
公投第１６案,新北市,中和區,秀峰里,1467,1269,425,249,674,72,746
公投第１６案,新北市,中和區,秀峰里,1468,1363,515,249,764,44,808
公投第１６案,新北市,中和區,秀士里,1469,1089,376,210,586,43,629
公投第１６案,新北市,中和區,秀士里,1470,1171,311,260,571,36,607
公投第１６案,新北市,中和區,秀水里,1471,1150,379,220,599,46,645
公投第１６案,新北市,中和區,秀水里,1472,1154,439,224,663,35,698
公投第１６案,新北市,中和區,秀水里,1473,1067,387,231,618,47,665
公投第１６案,新北市,中和區,秀仁里,1474,1526,491,271,762,65,827
公投第１６案,新北市,中和區,秀仁里,1475,1447,508,283,791,56,847
公投第１６案,新北市,永和區,光復里,1476,1554,497,333,830,87,917
公投第１６案,新北市,永和區,網溪里,1477,1065,366,210,576,27,603
公投第１６案,新北市,永和區,復興里,1478,854,302,188,490,55,545
公投第１６案,新北市,永和區,復興里,1479,1253,465,220,685,75,760
公投第１６案,新北市,永和區,竹林里,1480,1733,571,336,907,64,971
公投第１６案,新北市,永和區,竹林里,1481,1581,534,291,825,69,894
公投第１６案,新北市,永和區,桂林里,1482,1735,567,306,873,89,962
公投第１６案,新北市,永和區,桂林里,1483,1563,503,313,816,44,860
公投第１６案,新北市,永和區,上林里,1484,1650,579,334,913,73,986
公投第１６案,新北市,永和區,上林里,1485,1454,507,266,773,56,829
公投第１６案,新北市,永和區,福林里,1486,1568,465,295,760,68,828
公投第１６案,新北市,永和區,福林里,1487,1444,469,266,735,65,800
公投第１６案,新北市,永和區,勵行里,1488,1140,316,258,574,51,625
公投第１６案,新北市,永和區,中興里,1489,1188,252,409,661,67,728
公投第１６案,新北市,永和區,中興里,1490,1516,449,323,772,83,855
公投第１６案,新北市,永和區,永興里,1491,1397,447,258,705,75,780
公投第１６案,新北市,永和區,永興里,1492,1438,470,292,762,54,816
公投第１６案,新北市,永和區,正興里,1493,1084,364,241,605,48,653
公投第１６案,新北市,永和區,正興里,1494,941,312,196,508,43,551
公投第１６案,新北市,永和區,豫溪里,1495,1598,542,269,811,61,872
公投第１６案,新北市,永和區,豫溪里,1496,2842,485,305,790,37,827
公投第１６案,新北市,永和區,光明里,1497,1261,430,298,728,62,790
公投第１６案,新北市,永和區,光明里,1498,1449,532,343,875,51,926
公投第１６案,新北市,永和區,福和里,1499,1511,521,315,836,56,892
公投第１６案,新北市,永和區,福和里,1500,1470,546,322,868,52,920
公投第１６案,新北市,永和區,福和里,1501,1580,629,221,850,58,908
公投第１６案,新北市,永和區,得和里,1502,1438,510,325,835,68,903
公投第１６案,新北市,永和區,得和里,1503,1305,482,295,777,39,816
公投第１６案,新北市,永和區,得和里,1504,1046,376,239,615,29,644
公投第１６案,新北市,永和區,永貞里,1505,1566,509,355,864,24,888
公投第１６案,新北市,永和區,永貞里,1506,1468,466,343,809,60,869
公投第１６案,新北市,永和區,永福里,1507,1305,494,312,806,55,861
公投第１６案,新北市,永和區,永福里,1508,1181,385,275,660,51,711
公投第１６案,新北市,永和區,河濱里,1509,1720,557,305,862,72,934
公投第１６案,新北市,永和區,河濱里,1510,1103,359,284,643,39,682
公投第１６案,新北市,永和區,秀和里,1511,1649,509,313,822,148,970
公投第１６案,新北市,永和區,秀和里,1512,1206,395,310,705,49,754
公投第１６案,新北市,永和區,秀和里,1513,1506,551,314,865,47,912
公投第１６案,新北市,永和區,永元里,1514,1488,511,274,785,72,857
公投第１６案,新北市,永和區,永元里,1515,1288,449,261,710,87,797
公投第１６案,新北市,永和區,永元里,1516,1413,455,236,691,53,744
公投第１６案,新北市,永和區,民權里,1517,1329,468,245,713,60,773
公投第１６案,新北市,永和區,民權里,1518,1436,556,292,848,52,900
公投第１６案,新北市,永和區,民權里,1519,1112,339,269,608,59,667
公投第１６案,新北市,永和區,民族里,1520,1100,418,274,692,53,745
公投第１６案,新北市,永和區,民族里,1521,1545,559,331,890,63,953
公投第１６案,新北市,永和區,民族里,1522,1436,516,267,783,29,812
公投第１６案,新北市,永和區,秀朗里,1523,1731,630,371,1001,75,1076
公投第１６案,新北市,永和區,秀朗里,1524,1762,593,406,999,82,1081
公投第１６案,新北市,永和區,秀成里,1525,1320,369,313,682,63,745
公投第１６案,新北市,永和區,秀成里,1526,1297,379,224,603,28,631
公投第１６案,新北市,永和區,秀林里,1527,1798,550,348,898,88,986
公投第１６案,新北市,永和區,秀林里,1528,1491,508,320,828,78,906
公投第１６案,新北市,永和區,秀得里,1529,1223,430,240,670,32,702
公投第１６案,新北市,永和區,秀得里,1530,1108,373,224,597,72,669
公投第１６案,新北市,永和區,秀元里,1531,1408,456,335,791,70,861
公投第１６案,新北市,永和區,秀元里,1532,1265,419,283,702,66,768
公投第１６案,新北市,永和區,民生里,1533,1115,346,223,569,37,606
公投第１６案,新北市,永和區,民生里,1534,1133,376,280,656,71,727
公投第１６案,新北市,永和區,民生里,1535,1217,423,239,662,66,728
公投第１６案,新北市,永和區,民本里,1536,1713,543,340,883,80,963
公投第１６案,新北市,永和區,民本里,1537,1721,553,311,864,72,936
公投第１６案,新北市,永和區,民富里,1538,1327,406,267,673,77,750
公投第１６案,新北市,永和區,民富里,1539,1257,451,285,736,45,781
公投第１６案,新北市,永和區,民樂里,1540,1348,477,320,797,54,851
公投第１６案,新北市,永和區,民樂里,1541,1461,665,310,975,47,1022
公投第１６案,新北市,永和區,民樂里,1542,1368,448,296,744,72,816
公投第１６案,新北市,永和區,民治里,1543,1234,267,246,513,104,617
公投第１６案,新北市,永和區,民治里,1544,1303,443,262,705,63,768
公投第１６案,新北市,永和區,智光里,1545,1516,510,270,780,44,824
公投第１６案,新北市,永和區,智光里,1546,1422,492,299,791,78,869
公投第１６案,新北市,永和區,潭安里,1547,991,361,221,582,38,620
公投第１６案,新北市,永和區,潭安里,1548,1016,372,226,598,51,649
公投第１６案,新北市,永和區,潭安里,1549,1146,410,222,632,62,694
公投第１６案,新北市,永和區,潭安里,1550,1043,344,242,586,42,628
公投第１６案,新北市,永和區,潭墘里,1551,1210,442,262,704,23,727
公投第１６案,新北市,永和區,潭墘里,1552,1630,553,333,886,45,931
公投第１６案,新北市,永和區,潭墘里,1553,1092,396,226,622,37,659
公投第１６案,新北市,永和區,店街里,1554,1872,617,414,1031,75,1106
公投第１６案,新北市,永和區,店街里,1555,1781,618,345,963,45,1008
公投第１６案,新北市,永和區,大新里,1556,1049,355,239,594,54,648
公投第１６案,新北市,永和區,大新里,1557,1285,471,286,757,49,806
公投第１６案,新北市,永和區,永安里,1558,1209,426,267,693,54,747
公投第１６案,新北市,永和區,永安里,1559,1132,374,298,672,39,711
公投第１６案,新北市,永和區,永安里,1560,1287,453,314,767,54,821
公投第１６案,新北市,永和區,永樂里,1561,1068,350,262,612,60,672
公投第１６案,新北市,永和區,永樂里,1562,1098,390,263,653,59,712
公投第１６案,新北市,永和區,水源里,1563,1222,443,260,703,60,763
公投第１６案,新北市,永和區,水源里,1564,1157,388,240,628,80,708
公投第１６案,新北市,永和區,水源里,1565,1168,402,290,692,73,765
公投第１６案,新北市,永和區,協和里,1566,1283,393,283,676,75,751
公投第１６案,新北市,永和區,協和里,1567,1372,454,303,757,47,804
公投第１６案,新北市,永和區,雙和里,1568,1876,658,387,1045,77,1122
公投第１６案,新北市,永和區,雙和里,1569,1576,546,367,913,89,1002
公投第１６案,新北市,永和區,安和里,1570,1661,539,386,925,71,996
公投第１６案,新北市,永和區,安和里,1571,1808,600,373,973,45,1018
公投第１６案,新北市,永和區,前溪里,1572,1898,621,372,993,73,1066
公投第１６案,新北市,永和區,和平里,1573,1508,550,313,863,64,927
公投第１６案,新北市,永和區,和平里,1574,1341,448,293,741,77,818
公投第１６案,新北市,永和區,和平里,1575,1422,453,308,761,70,831
公投第１６案,新北市,永和區,保平里,1576,1177,406,239,645,46,691
公投第１６案,新北市,永和區,保平里,1577,1557,489,338,827,94,921
公投第１６案,新北市,永和區,保平里,1578,1491,449,321,770,60,830
公投第１６案,新北市,永和區,中溪里,1579,1586,516,318,834,69,903
公投第１６案,新北市,永和區,中溪里,1580,1313,424,259,683,33,716
公投第１６案,新北市,永和區,中溪里,1581,1636,488,371,859,77,936
公投第１６案,新北市,永和區,保安里,1582,1598,494,352,846,79,925
公投第１６案,新北市,永和區,保安里,1583,1609,593,324,917,59,976
公投第１６案,新北市,永和區,保安里,1584,1375,495,308,803,51,854
公投第１６案,新北市,永和區,保安里,1585,1648,624,354,978,60,1038
公投第１６案,新北市,永和區,保順里,1586,1077,332,255,587,59,646
公投第１６案,新北市,永和區,保順里,1587,1157,394,258,652,56,708
公投第１６案,新北市,永和區,保順里,1588,1339,506,308,814,40,854
公投第１６案,新北市,永和區,保順里,1589,1306,479,285,764,35,799
公投第１６案,新北市,永和區,保順里,1590,1236,476,273,749,37,786
公投第１６案,新北市,永和區,保順里,1591,1133,428,243,671,35,706
公投第１６案,新北市,永和區,保順里,1592,1425,533,296,829,36,865
公投第１６案,新北市,永和區,下溪里,1593,1938,612,399,1011,100,1111
公投第１６案,新北市,永和區,下溪里,1594,1607,553,352,905,58,963
公投第１６案,新北市,永和區,大同里,1595,853,298,180,478,48,526
公投第１６案,新北市,永和區,新生里,1596,768,216,153,369,58,427
公投第１６案,新北市,永和區,永成里,1597,893,232,156,388,40,428
公投第１６案,新北市,永和區,忠義里,1598,743,236,167,403,33,436
公投第１６案,新北市,永和區,仁愛里,1599,1155,390,278,668,51,719
公投第１６案,新北市,永和區,仁愛里,1600,1263,439,280,719,66,785
公投第１６案,新北市,永和區,文化里,1601,1189,441,251,692,41,733
公投第１６案,新北市,永和區,文化里,1602,1346,410,288,698,47,745
公投第１６案,新北市,永和區,信義里,1603,1368,458,256,714,61,775
公投第１６案,新北市,永和區,信義里,1604,1043,354,221,575,43,618
公投第１６案,新北市,永和區,後溪里,1605,1709,557,406,963,68,1031
公投第１６案,新北市,永和區,上溪里,1606,879,273,174,447,35,482
公投第１６案,新北市,永和區,上溪里,1607,904,262,237,499,43,542
公投第１６案,新北市,永和區,頂溪里,1608,1221,440,269,709,63,772
公投第１６案,新北市,永和區,頂溪里,1609,1018,235,250,485,48,533
公投第１６案,新北市,永和區,河堤里,1610,1551,522,292,814,60,874
公投第１６案,新北市,永和區,河堤里,1611,1428,478,310,788,67,855
公投第１６案,新北市,永和區,新廍里,1612,1044,365,221,586,61,647
公投第１６案,新北市,永和區,新廍里,1613,967,351,196,547,61,608
公投第１６案,新北市,樹林區,三興里,1614,1408,372,280,652,91,743
公投第１６案,新北市,樹林區,三興里,1615,1310,348,285,633,46,679
公投第１６案,新北市,樹林區,三興里,1616,1534,386,286,672,90,762
公投第１６案,新北市,樹林區,三福里,1617,1211,334,263,597,75,672
公投第１６案,新北市,樹林區,三福里,1618,1125,345,252,597,60,657
公投第１６案,新北市,樹林區,三福里,1619,1134,379,251,630,55,685
公投第１６案,新北市,樹林區,三多里,1620,1897,432,345,777,117,894
公投第１６案,新北市,樹林區,三多里,1621,1716,476,349,825,87,912
公投第１６案,新北市,樹林區,三龍里,1622,736,209,192,401,56,457
公投第１６案,新北市,樹林區,三龍里,1623,1137,364,281,645,48,693
公投第１６案,新北市,樹林區,獇寮里,1624,1542,420,317,737,63,800
公投第１６案,新北市,樹林區,獇寮里,1625,1470,383,317,700,108,808
公投第１６案,新北市,樹林區,獇寮里,1626,1456,390,265,655,39,694
公投第１６案,新北市,樹林區,光興里,1627,1124,327,270,597,32,629
公投第１６案,新北市,樹林區,光興里,1628,1235,339,267,606,54,660
公投第１６案,新北市,樹林區,光興里,1629,1212,347,276,623,48,671
公投第１６案,新北市,樹林區,金寮里,1630,1223,315,242,557,48,605
公投第１６案,新北市,樹林區,金寮里,1631,1335,368,275,643,82,725
公投第１６案,新北市,樹林區,金寮里,1632,1206,339,271,610,54,664
公投第１６案,新北市,樹林區,潭底里,1633,1927,366,260,626,85,711
公投第１６案,新北市,樹林區,潭底里,1634,914,253,210,463,60,523
公投第１６案,新北市,樹林區,潭底里,1635,1456,456,311,767,73,840
公投第１６案,新北市,樹林區,文林里,1636,1409,409,268,677,67,744
公投第１６案,新北市,樹林區,文林里,1637,1500,478,334,812,87,899
公投第１６案,新北市,樹林區,文林里,1638,1545,470,318,788,79,867
公投第１６案,新北市,樹林區,保安里,1639,1483,415,312,727,49,776
公投第１６案,新北市,樹林區,保安里,1640,1524,440,323,763,51,814
公投第１６案,新北市,樹林區,保安里,1641,1431,479,279,758,42,800
公投第１６案,新北市,樹林區,保安里,1642,1181,336,233,569,87,656
公投第１６案,新北市,樹林區,圳安里,1643,1116,332,237,569,83,652
公投第１６案,新北市,樹林區,圳安里,1644,1077,262,253,515,50,565
公投第１６案,新北市,樹林區,圳安里,1645,1103,288,220,508,29,537
公投第１６案,新北市,樹林區,圳福里,1646,1385,402,294,696,76,772
公投第１６案,新北市,樹林區,圳福里,1647,1266,349,263,612,59,671
公投第１６案,新北市,樹林區,圳福里,1648,1195,346,253,599,52,651
公投第１６案,新北市,樹林區,圳民里,1649,1254,345,255,600,78,678
公投第１６案,新北市,樹林區,圳民里,1650,1263,385,269,654,73,727
公投第１６案,新北市,樹林區,圳生里,1651,1473,469,338,807,94,901
公投第１６案,新北市,樹林區,樹德里,1652,870,274,191,465,35,500
公投第１６案,新北市,樹林區,樹德里,1653,1338,396,338,734,87,821
公投第１６案,新北市,樹林區,樹德里,1654,1010,300,188,488,51,539
公投第１６案,新北市,樹林區,樹福里,1655,1658,493,356,849,114,963
公投第１６案,新北市,樹林區,樹福里,1656,1538,486,404,890,78,968
公投第１６案,新北市,樹林區,樹西里,1657,1405,480,298,778,111,889
公投第１６案,新北市,樹林區,樹西里,1658,1587,494,321,815,73,888
公投第１６案,新北市,樹林區,樹西里,1659,1566,462,339,801,79,880
公投第１６案,新北市,樹林區,樹興里,1660,997,274,209,483,32,515
公投第１６案,新北市,樹林區,樹興里,1661,1187,349,258,607,68,675
公投第１６案,新北市,樹林區,樹興里,1662,1061,279,234,513,66,579
公投第１６案,新北市,樹林區,樹人里,1663,1701,564,323,887,66,953
公投第１６案,新北市,樹林區,樹人里,1664,1278,391,266,657,69,726
公投第１６案,新北市,樹林區,育英里,1665,1433,470,315,785,80,865
公投第１６案,新北市,樹林區,育英里,1666,1306,392,315,707,95,802
公投第１６案,新北市,樹林區,樹南里,1667,1268,363,326,689,84,773
公投第１６案,新北市,樹林區,樹南里,1668,1281,418,279,697,43,740
公投第１６案,新北市,樹林區,樹南里,1669,1200,380,285,665,55,720
公投第１６案,新北市,樹林區,坡內里,1670,1491,369,315,684,56,740
公投第１６案,新北市,樹林區,樹東里,1671,1066,306,223,529,32,561
公投第１６案,新北市,樹林區,樹北里,1672,877,276,200,476,81,557
公投第１６案,新北市,樹林區,彭福里,1673,1616,442,354,796,87,883
公投第１６案,新北市,樹林區,彭福里,1674,1589,408,251,659,89,748
公投第１６案,新北市,樹林區,彭福里,1675,1367,434,289,723,75,798
公投第１６案,新北市,樹林區,和平里,1676,1144,347,264,611,77,688
公投第１６案,新北市,樹林區,和平里,1677,1059,285,226,511,49,560
公投第１６案,新北市,樹林區,和平里,1678,1224,330,265,595,82,677
公投第１６案,新北市,樹林區,彭興里,1679,1141,301,219,520,59,579
公投第１６案,新北市,樹林區,彭興里,1680,1396,349,208,557,36,593
公投第１６案,新北市,樹林區,彭興里,1681,1157,325,246,571,66,637
公投第１６案,新北市,樹林區,彭興里,1682,1498,373,301,674,101,775
公投第１６案,新北市,樹林區,彭厝里,1683,1514,390,340,730,104,834
公投第１６案,新北市,樹林區,彭厝里,1684,1546,419,294,713,67,780
公投第１６案,新北市,樹林區,彭厝里,1685,1392,385,312,697,81,778
公投第１６案,新北市,樹林區,大同里,1686,1566,490,313,803,73,876
公投第１６案,新北市,樹林區,大同里,1687,1566,456,326,782,64,846
公投第１６案,新北市,樹林區,中華里,1688,1517,437,311,748,77,825
公投第１６案,新北市,樹林區,中華里,1689,1481,481,280,761,61,822
公投第１６案,新北市,樹林區,太順里,1690,1261,376,252,628,49,677
公投第１６案,新北市,樹林區,太順里,1691,1163,247,325,572,38,610
公投第１６案,新北市,樹林區,東昇里,1692,1661,511,383,894,98,992
公投第１６案,新北市,樹林區,東昇里,1693,1585,486,347,833,67,900
公投第１６案,新北市,樹林區,東昇里,1694,1018,334,223,557,59,616
公投第１６案,新北市,樹林區,東陽里,1695,1247,371,243,614,80,694
公投第１６案,新北市,樹林區,東陽里,1696,1390,401,259,660,93,753
公投第１６案,新北市,樹林區,東陽里,1697,1293,384,301,685,57,742
公投第１６案,新北市,樹林區,東陽里,1698,1301,347,301,648,41,689
公投第１６案,新北市,樹林區,東山里,1699,1606,427,336,763,81,844
公投第１６案,新北市,樹林區,東山里,1700,1277,329,290,619,90,709
公投第１６案,新北市,樹林區,山佳里,1701,1219,344,269,613,70,683
公投第１６案,新北市,樹林區,山佳里,1702,1454,376,304,680,59,739
公投第１６案,新北市,樹林區,山佳里,1703,1314,375,268,643,58,701
公投第１６案,新北市,樹林區,山佳里,1704,1008,346,260,606,33,639
公投第１６案,新北市,樹林區,中山里,1705,1574,439,302,741,104,845
公投第１６案,新北市,樹林區,中山里,1706,1364,419,298,717,56,773
公投第１６案,新北市,樹林區,中山里,1707,1677,434,332,766,88,854
公投第１６案,新北市,樹林區,樂山里,1708,1683,399,276,675,53,728
公投第１６案,新北市,樹林區,柑園里,1709,1452,449,314,763,71,834
公投第１６案,新北市,樹林區,柑園里,1710,1592,555,328,883,38,921
公投第１６案,新北市,樹林區,柑園里,1711,1619,518,362,880,55,935
公投第１６案,新北市,樹林區,柑園里,1712,1642,616,348,964,45,1009
公投第１６案,新北市,樹林區,柑園里,1713,1357,428,300,728,37,765
公投第１６案,新北市,樹林區,西園里,1714,1638,456,370,826,116,942
公投第１６案,新北市,樹林區,南園里,1715,1592,458,347,805,66,871
公投第１６案,新北市,樹林區,南園里,1716,1521,483,346,829,67,896
公投第１６案,新北市,樹林區,南園里,1717,1707,578,364,942,69,1011
公投第１６案,新北市,樹林區,南園里,1718,1741,533,377,910,105,1015
公投第１６案,新北市,樹林區,南園里,1719,1655,483,348,831,88,919
公投第１６案,新北市,樹林區,南園里,1720,1775,479,307,786,125,911
公投第１６案,新北市,樹林區,南園里,1721,1781,583,329,912,74,986
公投第１６案,新北市,樹林區,東園里,1722,1565,366,277,643,78,721
公投第１６案,新北市,樹林區,北園里,1723,936,258,203,461,44,505
公投第１６案,新北市,樹林區,北園里,1724,1030,296,230,526,34,560
公投第１６案,新北市,鶯歌區,建德里,1725,515,161,106,267,26,293
公投第１６案,新北市,鶯歌區,東鶯里,1726,965,305,217,522,59,581
公投第１６案,新北市,鶯歌區,北鶯里,1727,1931,538,442,980,83,1063
公投第１６案,新北市,鶯歌區,北鶯里,1728,1797,492,314,806,82,888
公投第１６案,新北市,鶯歌區,西鶯里,1729,1057,326,217,543,54,597
公投第１６案,新北市,鶯歌區,西鶯里,1730,962,273,186,459,27,486
公投第１６案,新北市,鶯歌區,中鶯里,1731,934,309,219,528,54,582
公投第１６案,新北市,鶯歌區,南鶯里,1732,1742,544,433,977,84,1061
公投第１６案,新北市,鶯歌區,南鶯里,1733,1634,470,316,786,73,859
公投第１６案,新北市,鶯歌區,南鶯里,1734,1676,458,281,739,82,821
公投第１６案,新北市,鶯歌區,建國里,1735,2052,553,438,991,136,1127
公投第１６案,新北市,鶯歌區,建國里,1736,1977,481,372,853,60,913
公投第１６案,新北市,鶯歌區,建國里,1737,1957,582,402,984,47,1031
公投第１６案,新北市,鶯歌區,二甲里,1738,850,195,153,348,40,388
公投第１６案,新北市,鶯歌區,二橋里,1739,1782,504,342,846,70,916
公投第１６案,新北市,鶯歌區,二橋里,1740,1496,432,297,729,65,794
公投第１６案,新北市,鶯歌區,二橋里,1741,2071,560,378,938,63,1001
公投第１６案,新北市,鶯歌區,二橋里,1742,1753,391,300,691,98,789
公投第１６案,新北市,鶯歌區,尖山里,1743,1737,483,320,803,67,870
公投第１６案,新北市,鶯歌區,尖山里,1744,1669,491,262,753,86,839
公投第１６案,新北市,鶯歌區,尖山里,1745,1842,460,317,777,52,829
公投第１６案,新北市,鶯歌區,尖山里,1746,1454,386,280,666,70,736
公投第１６案,新北市,鶯歌區,南靖里,1747,942,263,185,448,56,504
公投第１６案,新北市,鶯歌區,南靖里,1748,1317,333,276,609,95,704
公投第１６案,新北市,鶯歌區,南靖里,1749,949,228,170,398,34,432
公投第１６案,新北市,鶯歌區,同慶里,1750,1440,493,283,776,65,841
公投第１６案,新北市,鶯歌區,永昌里,1751,1809,525,354,879,113,992
公投第１６案,新北市,鶯歌區,永昌里,1752,1758,552,352,904,82,986
公投第１６案,新北市,鶯歌區,永昌里,1753,1589,458,337,795,72,867
公投第１６案,新北市,鶯歌區,永昌里,1754,1067,318,249,567,65,632
公投第１６案,新北市,鶯歌區,永昌里,1755,1092,340,247,587,55,642
公投第１６案,新北市,鶯歌區,永吉里,1756,1730,526,364,890,65,955
公投第１６案,新北市,鶯歌區,永吉里,1757,1281,379,259,638,76,714
公投第１６案,新北市,鶯歌區,永吉里,1758,1238,407,294,701,66,767
公投第１６案,新北市,鶯歌區,鳳祥里,1759,1568,464,327,791,78,869
公投第１６案,新北市,鶯歌區,鳳祥里,1760,1271,373,239,612,73,685
公投第１６案,新北市,鶯歌區,鳳祥里,1761,1183,288,185,473,33,506
公投第１６案,新北市,鶯歌區,鳳鳴里,1762,1026,278,169,447,39,486
公投第１６案,新北市,鶯歌區,鳳鳴里,1763,1721,431,365,796,54,850
公投第１６案,新北市,鶯歌區,鳳鳴里,1764,1317,348,289,637,52,689
公投第１６案,新北市,鶯歌區,鳳福里,1765,1046,304,251,555,72,627
公投第１６案,新北市,鶯歌區,鳳福里,1766,1144,335,279,614,75,689
公投第１６案,新北市,鶯歌區,鳳福里,1767,1336,324,265,589,90,679
公投第１６案,新北市,鶯歌區,大湖里,1768,1479,335,246,581,108,689
公投第１６案,新北市,鶯歌區,大湖里,1769,1736,463,341,804,95,899
公投第１６案,新北市,鶯歌區,大湖里,1770,1389,424,309,733,70,803
公投第１６案,新北市,鶯歌區,中湖里,1771,1956,537,391,928,106,1034
公投第１６案,新北市,鶯歌區,中湖里,1772,1371,373,291,664,79,743
公投第１６案,新北市,鶯歌區,中湖里,1773,1810,405,279,684,47,731
公投第１６案,新北市,鶯歌區,東湖里,1774,227,49,43,92,6,98
公投第１６案,新北市,土城區,祖田里,1775,1505,427,303,730,78,808
公投第１６案,新北市,土城區,頂新里,1776,1242,394,306,700,50,750
公投第１６案,新北市,土城區,頂新里,1777,1206,421,250,671,45,716
公投第１６案,新北市,土城區,頂福里,1778,1474,429,287,716,87,803
公投第１６案,新北市,土城區,頂福里,1779,1489,390,284,674,80,754
公投第１６案,新北市,土城區,頂福里,1780,1675,447,339,786,73,859
公投第１６案,新北市,土城區,頂埔里,1781,1499,462,295,757,69,826
公投第１６案,新北市,土城區,頂埔里,1782,1495,403,298,701,71,772
公投第１６案,新北市,土城區,頂埔里,1783,1411,386,272,658,102,760
公投第１６案,新北市,土城區,沛陂里,1784,1378,382,250,632,72,704
公投第１６案,新北市,土城區,沛陂里,1785,1256,340,272,612,56,668
公投第１６案,新北市,土城區,沛陂里,1786,1379,411,316,727,65,792
公投第１６案,新北市,土城區,永寧里,1787,1424,399,254,653,86,739
公投第１６案,新北市,土城區,永寧里,1788,1455,404,283,687,99,786
公投第１６案,新北市,土城區,永寧里,1789,1419,381,291,672,65,737
公投第１６案,新北市,土城區,永寧里,1790,1357,462,295,757,46,803
公投第１６案,新北市,土城區,永寧里,1791,1501,452,300,752,47,799
公投第１６案,新北市,土城區,大安里,1792,1206,341,254,595,98,693
公投第１６案,新北市,土城區,大安里,1793,1255,374,314,688,41,729
公投第１６案,新北市,土城區,大安里,1794,1869,527,341,868,102,970
公投第１６案,新北市,土城區,員仁里,1795,1292,336,312,648,51,699
公投第１６案,新北市,土城區,員仁里,1796,1324,355,263,618,39,657
公投第１６案,新北市,土城區,員仁里,1797,1155,289,245,534,79,613
公投第１６案,新北市,土城區,員仁里,1798,1183,331,254,585,70,655
公投第１６案,新北市,土城區,埤塘里,1799,2518,271,211,482,64,546
公投第１６案,新北市,土城區,埤塘里,1800,1218,347,223,570,68,638
公投第１６案,新北市,土城區,埤塘里,1801,1133,323,241,564,84,648
公投第１６案,新北市,土城區,土城里,1802,894,251,201,452,45,497
公投第１６案,新北市,土城區,土城里,1803,931,311,174,485,65,550
公投第１６案,新北市,土城區,長風里,1804,1820,743,321,1064,90,1154
公投第１６案,新北市,土城區,員信里,1805,1320,421,228,649,45,694
公投第１６案,新北市,土城區,員信里,1806,1241,443,157,600,51,651
公投第１６案,新北市,土城區,員信里,1807,1414,417,292,709,65,774
公投第１６案,新北市,土城區,員林里,1808,1378,394,297,691,95,786
公投第１６案,新北市,土城區,員林里,1809,1421,411,328,739,90,829
公投第１６案,新北市,土城區,員林里,1810,1340,398,258,656,67,723
公投第１６案,新北市,土城區,員林里,1811,1144,333,284,617,61,678
公投第１６案,新北市,土城區,員福里,1812,1268,375,273,648,77,725
公投第１６案,新北市,土城區,員福里,1813,1196,351,247,598,94,692
公投第１６案,新北市,土城區,員福里,1814,1308,421,278,699,82,781
公投第１６案,新北市,土城區,員福里,1815,1175,335,251,586,87,673
公投第１６案,新北市,土城區,日和里,1816,1230,364,258,622,82,704
公投第１６案,新北市,土城區,日和里,1817,1342,393,289,682,88,770
公投第１６案,新北市,土城區,日和里,1818,1268,407,287,694,47,741
公投第１６案,新北市,土城區,日和里,1819,1227,389,298,687,86,773
公投第１６案,新北市,土城區,日新里,1820,1356,440,237,677,102,779
公投第１６案,新北市,土城區,日新里,1821,1496,465,288,753,85,838
公投第１６案,新北市,土城區,日新里,1822,1309,370,270,640,104,744
公投第１６案,新北市,土城區,裕生里,1823,1175,362,264,626,68,694
公投第１６案,新北市,土城區,裕生里,1824,1237,354,255,609,83,692
公投第１６案,新北市,土城區,裕生里,1825,1256,381,252,633,86,719
公投第１６案,新北市,土城區,裕生里,1826,1228,383,251,634,31,665
公投第１６案,新北市,土城區,貨饒里,1827,1182,343,240,583,85,668
公投第１６案,新北市,土城區,貨饒里,1828,1558,445,334,779,67,846
公投第１６案,新北市,土城區,貨饒里,1829,1160,345,253,598,66,664
公投第１６案,新北市,土城區,瑞興里,1830,1357,404,293,697,67,764
公投第１６案,新北市,土城區,瑞興里,1831,1464,417,286,703,101,804
公投第１６案,新北市,土城區,復興里,1832,1335,358,271,629,64,693
公投第１６案,新北市,土城區,復興里,1833,1346,368,291,659,91,750
公投第１６案,新北市,土城區,復興里,1834,1435,492,344,836,68,904
公投第１６案,新北市,土城區,廣福里,1835,1639,489,317,806,97,903
公投第１６案,新北市,土城區,廣福里,1836,1728,580,319,899,83,982
公投第１６案,新北市,土城區,廣福里,1837,1665,440,272,712,45,757
公投第１６案,新北市,土城區,學成里,1838,1333,432,294,726,82,808
公投第１６案,新北市,土城區,學成里,1839,1567,515,344,859,53,912
公投第１６案,新北市,土城區,埤林里,1840,1576,431,332,763,102,865
公投第１６案,新北市,土城區,埤林里,1841,1458,455,300,755,81,836
公投第１６案,新北市,土城區,埤林里,1842,1517,433,304,737,133,870
公投第１６案,新北市,土城區,埤林里,1843,1489,505,300,805,61,866
公投第１６案,新北市,土城區,埤林里,1844,1463,489,322,811,38,849
公投第１６案,新北市,土城區,廣興里,1845,1584,467,343,810,56,866
公投第１６案,新北市,土城區,廣興里,1846,1464,465,253,718,82,800
公投第１６案,新北市,土城區,樂利里,1847,1598,495,327,822,80,902
公投第１６案,新北市,土城區,樂利里,1848,1500,399,293,692,108,800
公投第１６案,新北市,土城區,樂利里,1849,1542,471,306,777,67,844
公投第１６案,新北市,土城區,學府里,1850,1619,544,337,881,73,954
公投第１６案,新北市,土城區,學府里,1851,1521,415,284,699,57,756
公投第１６案,新北市,土城區,明德里,1852,1691,505,358,863,54,917
公投第１６案,新北市,土城區,明德里,1853,1657,494,324,818,68,886
公投第１６案,新北市,土城區,明德里,1854,1772,578,396,974,55,1029
公投第１６案,新北市,土城區,學士里,1855,1423,467,287,754,31,785
公投第１６案,新北市,土城區,學士里,1856,1321,420,337,757,57,814
公投第１６案,新北市,土城區,學士里,1857,1429,472,326,798,76,874
公投第１６案,新北市,土城區,柑林里,1858,1445,436,255,691,83,774
公投第１６案,新北市,土城區,柑林里,1859,1520,517,296,813,70,883
公投第１６案,新北市,土城區,中正里,1860,1484,411,234,645,37,682
公投第１６案,新北市,土城區,中正里,1861,1362,404,282,686,40,726
公投第１６案,新北市,土城區,青雲里,1862,1262,366,262,628,57,685
公投第１６案,新北市,土城區,青雲里,1863,1343,390,317,707,70,777
公投第１６案,新北市,土城區,清和里,1864,1337,340,252,592,63,655
公投第１６案,新北市,土城區,清和里,1865,1325,305,216,521,66,587
公投第１６案,新北市,土城區,清和里,1866,1390,356,288,644,66,710
公投第１６案,新北市,土城區,清和里,1867,1534,452,302,754,79,833
公投第１６案,新北市,土城區,清化里,1868,1484,420,265,685,103,788
公投第１６案,新北市,土城區,清溪里,1869,1532,411,265,676,117,793
公投第１６案,新北市,土城區,清溪里,1870,1507,481,282,763,82,845
公投第１６案,新北市,土城區,清溪里,1871,1550,493,311,804,69,873
公投第１６案,新北市,土城區,清溪里,1872,1567,459,323,782,70,852
公投第１６案,新北市,土城區,青山里,1873,1367,402,300,702,76,778
公投第１６案,新北市,土城區,青山里,1874,1293,358,267,625,68,693
公投第１６案,新北市,土城區,清水里,1875,1402,415,291,706,83,789
公投第１６案,新北市,土城區,清水里,1876,1379,421,275,696,67,763
公投第１６案,新北市,土城區,清水里,1877,1471,445,266,711,60,771
公投第１６案,新北市,土城區,清水里,1878,1410,427,268,695,62,757
公投第１６案,新北市,土城區,清水里,1879,1542,458,314,772,59,831
公投第１６案,新北市,土城區,永豐里,1880,1238,343,267,610,73,683
公投第１６案,新北市,土城區,永豐里,1881,1301,333,232,565,115,680
公投第１６案,新北市,土城區,永豐里,1882,1311,505,298,803,41,844
公投第１６案,新北市,土城區,永富里,1883,1511,414,253,667,68,735
公投第１６案,新北市,土城區,永富里,1884,1531,419,320,739,75,814
公投第１６案,新北市,土城區,永富里,1885,1638,478,297,775,78,853
公投第１６案,新北市,土城區,廷寮里,1886,1335,441,288,729,63,792
公投第１６案,新北市,土城區,廷寮里,1887,1459,463,277,740,64,804
公投第１６案,新北市,土城區,廷寮里,1888,1489,442,301,743,59,802
公投第１６案,新北市,土城區,金城里,1889,1774,560,351,911,60,971
公投第１６案,新北市,土城區,金城里,1890,1792,546,374,920,60,980
公投第１６案,新北市,土城區,金城里,1891,1798,562,348,910,77,987
公投第１６案,新北市,土城區,峯廷里,1892,1312,355,262,617,85,702
公投第１６案,新北市,土城區,峯廷里,1893,1301,383,219,602,76,678
公投第１６案,新北市,土城區,峯廷里,1894,1254,336,261,597,68,665
公投第１６案,新北市,土城區,峯廷里,1895,1215,338,258,596,47,643
公投第１６案,新北市,土城區,峯廷里,1896,1448,443,279,722,62,784
公投第１６案,新北市,土城區,延吉里,1897,1321,369,263,632,83,715
公投第１６案,新北市,土城區,延吉里,1898,1150,292,225,517,80,597
公投第１６案,新北市,土城區,延吉里,1899,1425,337,285,622,78,700
公投第１６案,新北市,土城區,延壽里,1900,1366,379,355,734,80,814
公投第１６案,新北市,土城區,延壽里,1901,1292,382,293,675,60,735
公投第１６案,新北市,土城區,延壽里,1902,1317,367,276,643,77,720
公投第１６案,新北市,土城區,延祿里,1903,1324,404,274,678,75,753
公投第１６案,新北市,土城區,延祿里,1904,1189,328,238,566,73,639
公投第１６案,新北市,土城區,延祿里,1905,1223,351,317,668,43,711
公投第１６案,新北市,土城區,平和里,1906,1550,440,309,749,80,829
公投第１６案,新北市,土城區,平和里,1907,1606,458,349,807,104,911
公投第１６案,新北市,土城區,平和里,1908,1509,433,329,762,66,828
公投第１６案,新北市,土城區,平和里,1909,1529,469,273,742,82,824
公投第１６案,新北市,土城區,安和里,1910,1458,427,239,666,106,772
公投第１６案,新北市,土城區,安和里,1911,1468,403,305,708,132,840
公投第１６案,新北市,土城區,安和里,1912,1495,433,305,738,67,805
公投第１６案,新北市,土城區,延和里,1913,1303,363,281,644,96,740
公投第１６案,新北市,土城區,延和里,1914,1365,397,298,695,74,769
公投第１６案,新北市,土城區,延和里,1915,1476,452,284,736,85,821
公投第１６案,新北市,土城區,延和里,1916,1519,520,270,790,51,841
公投第１６案,新北市,三峽區,三峽里,1917,274,93,66,159,29,188
公投第１６案,新北市,三峽區,秀川里,1918,583,159,118,277,45,322
公投第１６案,新北市,三峽區,八張里,1919,1765,414,327,741,32,773
公投第１６案,新北市,三峽區,八張里,1920,1714,484,345,829,79,908
公投第１６案,新北市,三峽區,中埔里,1921,1355,358,297,655,42,697
公投第１６案,新北市,三峽區,中埔里,1922,1329,399,283,682,67,749
公投第１６案,新北市,三峽區,弘道里,1923,1059,277,203,480,75,555
公投第１６案,新北市,三峽區,永舘里,1924,1364,372,328,700,82,782
公投第１６案,新北市,三峽區,永舘里,1925,1098,317,259,576,70,646
公投第１６案,新北市,三峽區,永舘里,1926,1296,386,267,653,58,711
公投第１６案,新北市,三峽區,永舘里,1927,1240,306,267,573,101,674
公投第１６案,新北市,三峽區,永舘里,1928,1531,448,309,757,54,811
公投第１６案,新北市,三峽區,鳶山里,1929,1444,431,234,665,41,706
公投第１６案,新北市,三峽區,鳶山里,1930,1347,358,285,643,89,732
公投第１６案,新北市,三峽區,鳶山里,1931,1455,413,297,710,73,783
公投第１６案,新北市,三峽區,鳶山里,1932,1556,408,265,673,42,715
公投第１６案,新北市,三峽區,鳶山里,1933,1390,305,262,567,38,605
公投第１６案,新北市,三峽區,鳶山里,1934,1532,431,315,746,71,817
公投第１６案,新北市,三峽區,龍埔里,1935,1377,327,259,586,84,670
公投第１６案,新北市,三峽區,龍埔里,1936,1731,595,232,827,70,897
公投第１６案,新北市,三峽區,龍埔里,1937,1705,487,314,801,50,851
公投第１６案,新北市,三峽區,龍埔里,1938,1590,509,314,823,49,872
公投第１６案,新北市,三峽區,龍埔里,1939,1650,514,364,878,46,924
公投第１６案,新北市,三峽區,龍恩里,1940,1441,422,329,751,38,789
公投第１６案,新北市,三峽區,龍恩里,1941,1404,485,306,791,24,815
公投第１６案,新北市,三峽區,龍恩里,1942,1295,455,274,729,43,772
公投第１６案,新北市,三峽區,龍恩里,1943,1348,368,248,616,42,658
公投第１６案,新北市,三峽區,龍學里,1944,1579,487,344,831,34,865
公投第１６案,新北市,三峽區,龍學里,1945,1435,433,302,735,31,766
公投第１６案,新北市,三峽區,龍學里,1946,1659,607,321,928,41,969
公投第１６案,新北市,三峽區,龍學里,1947,1512,526,333,859,57,916
公投第１６案,新北市,三峽區,龍學里,1948,1463,523,296,819,53,872
公投第１６案,新北市,三峽區,龍學里,1949,1465,494,320,814,34,848
公投第１６案,新北市,三峽區,龍學里,1950,1463,502,303,805,31,836
公投第１６案,新北市,三峽區,龍學里,1951,1443,485,297,782,45,827
公投第１６案,新北市,三峽區,礁溪里,1952,1634,462,295,757,67,824
公投第１６案,新北市,三峽區,礁溪里,1953,1716,462,371,833,88,921
公投第１６案,新北市,三峽區,礁溪里,1954,1675,471,327,798,70,868
公投第１６案,新北市,三峽區,安溪里,1955,1649,392,273,665,62,727
公投第１６案,新北市,三峽區,安溪里,1956,1489,399,305,704,82,786
公投第１６案,新北市,三峽區,安溪里,1957,1771,487,310,797,72,869
公投第１６案,新北市,三峽區,安溪里,1958,1726,521,331,852,67,919
公投第１６案,新北市,三峽區,介壽里,1959,1363,365,302,667,67,734
公投第１６案,新北市,三峽區,介壽里,1960,1624,466,309,775,74,849
公投第１６案,新北市,三峽區,介壽里,1961,1352,285,409,694,55,749
公投第１６案,新北市,三峽區,介壽里,1962,1608,335,260,595,22,617
公投第１６案,新北市,三峽區,中正里,1963,1458,429,275,704,74,778
公投第１６案,新北市,三峽區,中正里,1964,1641,411,325,736,52,788
公投第１６案,新北市,三峽區,中正里,1965,1530,398,289,687,120,807
公投第１６案,新北市,三峽區,大埔里,1966,1389,316,244,560,72,632
公投第１６案,新北市,三峽區,大埔里,1967,1315,342,240,582,88,670
公投第１６案,新北市,三峽區,大埔里,1968,934,338,179,517,52,569
公投第１６案,新北市,三峽區,嘉添里,1969,1270,320,232,552,54,606
公投第１６案,新北市,三峽區,嘉添里,1970,929,236,178,414,47,461
公投第１６案,新北市,三峽區,添福里,1971,1035,260,211,471,39,510
公投第１６案,新北市,三峽區,金圳里,1972,502,97,100,197,26,223
公投第１６案,新北市,三峽區,五寮里,1973,836,188,153,341,67,408
公投第１６案,新北市,三峽區,插角里,1974,669,160,97,257,70,327
公投第１６案,新北市,三峽區,有木里,1975,733,207,145,352,78,430
公投第１６案,新北市,三峽區,二鬮里,1976,1560,533,335,868,70,938
公投第１６案,新北市,三峽區,二鬮里,1977,1638,461,317,778,64,842
公投第１６案,新北市,三峽區,溪南里,1978,1394,351,259,610,65,675
公投第１６案,新北市,三峽區,溪北里,1979,771,226,176,402,44,446
公投第１６案,新北市,三峽區,溪北里,1980,1367,363,275,638,39,677
公投第１６案,新北市,三峽區,溪東里,1981,1241,316,249,565,80,645
公投第１６案,新北市,三峽區,溪東里,1982,1520,387,273,660,62,722
公投第１６案,新北市,三峽區,成福里,1983,873,294,202,496,58,554
公投第１６案,新北市,三峽區,竹崙里,1984,768,131,120,251,123,374
公投第１６案,新北市,三峽區,竹崙里,1985,1097,266,205,471,42,513
公投第１６案,新北市,三峽區,安坑里,1986,1322,291,195,486,90,576
公投第１６案,新北市,新店區,新店里,1987,1603,508,331,839,52,891
公投第１６案,新北市,新店區,張南里,1988,1921,561,441,1002,68,1070
公投第１６案,新北市,新店區,國校里,1989,1082,336,226,562,25,587
公投第１６案,新北市,新店區,國校里,1990,1235,391,273,664,53,717
公投第１６案,新北市,新店區,文中里,1991,1568,540,344,884,39,923
公投第１６案,新北市,新店區,廣明里,1992,771,230,167,397,57,454
公投第１６案,新北市,新店區,文明里,1993,1256,365,296,661,41,702
公投第１６案,新北市,新店區,文明里,1994,1008,330,214,544,58,602
公投第１６案,新北市,新店區,中興里,1995,1515,527,303,830,61,891
公投第１６案,新北市,新店區,中興里,1996,1637,646,307,953,69,1022
公投第１６案,新北市,新店區,中興里,1997,1549,485,351,836,65,901
公投第１６案,新北市,新店區,新生里,1998,2011,785,403,1188,69,1257
公投第１６案,新北市,新店區,新生里,1999,1554,521,302,823,83,906
公投第１６案,新北市,新店區,新生里,2000,1770,456,435,891,99,990
公投第１６案,新北市,新店區,新德里,2001,1316,455,276,731,56,787
公投第１６案,新北市,新店區,新德里,2002,1126,380,196,576,68,644
公投第１６案,新北市,新店區,張北里,2003,1460,428,303,731,65,796
公投第１６案,新北市,新店區,張北里,2004,1584,562,303,865,78,943
公投第１６案,新北市,新店區,張北里,2005,1449,475,293,768,66,834
公投第１６案,新北市,新店區,張北里,2006,1520,576,321,897,60,957
公投第１６案,新北市,新店區,張北里,2007,1821,704,324,1028,45,1073
公投第１６案,新北市,新店區,五峯里,2008,1956,676,384,1060,46,1106
公投第１６案,新北市,新店區,五峯里,2009,1665,572,346,918,62,980
公投第１６案,新北市,新店區,五峯里,2010,1588,590,317,907,58,965
公投第１６案,新北市,新店區,五峯里,2011,1519,518,304,822,31,853
公投第１６案,新北市,新店區,長春里,2012,1185,430,274,704,44,748
公投第１６案,新北市,新店區,長春里,2013,1095,424,248,672,27,699
公投第１６案,新北市,新店區,新安里,2014,1106,409,231,640,52,692
公投第１６案,新北市,新店區,新安里,2015,2700,216,166,382,27,409
公投第１６案,新北市,新店區,新安里,2016,995,348,216,564,33,597
公投第１６案,新北市,新店區,新安里,2017,1168,381,242,623,48,671
公投第１６案,新北市,新店區,忠誠里,2018,1123,428,263,691,69,760
公投第１６案,新北市,新店區,忠誠里,2019,1085,412,243,655,53,708
公投第１６案,新北市,新店區,中正里,2020,1412,524,292,816,63,879
公投第１６案,新北市,新店區,中正里,2021,1659,588,318,906,64,970
公投第１６案,新北市,新店區,中正里,2022,1198,467,255,722,48,770
公投第１６案,新北市,新店區,中正里,2023,1376,451,252,703,42,745
公投第１６案,新北市,新店區,中華里,2024,1300,426,246,672,45,717
公投第１６案,新北市,新店區,中華里,2025,1238,451,229,680,46,726
公投第１６案,新北市,新店區,中華里,2026,1388,461,242,703,36,739
公投第１６案,新北市,新店區,仁愛里,2027,933,217,324,541,52,593
公投第１６案,新北市,新店區,仁愛里,2028,908,337,198,535,49,584
公投第１６案,新北市,新店區,建國里,2029,1582,496,340,836,75,911
公投第１６案,新北市,新店區,建國里,2030,1247,452,258,710,68,778
公投第１６案,新北市,新店區,百忍里,2031,971,332,214,546,57,603
公投第１６案,新北市,新店區,百忍里,2032,1145,426,216,642,66,708
公投第１６案,新北市,新店區,百忍里,2033,1392,493,280,773,65,838
公投第１６案,新北市,新店區,百和里,2034,1452,527,325,852,64,916
公投第１６案,新北市,新店區,百和里,2035,1440,506,275,781,56,837
公投第１６案,新北市,新店區,福德里,2036,1786,586,347,933,91,1024
公投第１６案,新北市,新店區,福德里,2037,1825,704,282,986,78,1064
公投第１６案,新北市,新店區,百福里,2038,1477,519,332,851,40,891
公投第１６案,新北市,新店區,百福里,2039,1750,617,352,969,63,1032
公投第１６案,新北市,新店區,福民里,2040,1792,643,319,962,64,1026
公投第１６案,新北市,新店區,福民里,2041,1979,722,333,1055,67,1122
公投第１６案,新北市,新店區,中山里,2042,826,303,167,470,31,501
公投第１６案,新北市,新店區,中山里,2043,1924,738,354,1092,58,1150
公投第１６案,新北市,新店區,中山里,2044,1383,561,263,824,33,857
公投第１６案,新北市,新店區,和平里,2045,830,230,150,380,45,425
公投第１６案,新北市,新店區,中央里,2046,1759,675,347,1022,47,1069
公投第１６案,新北市,新店區,中央里,2047,1957,723,387,1110,71,1181
公投第１６案,新北市,新店區,中央里,2048,1481,559,305,864,38,902
公投第１６案,新北市,新店區,國豐里,2049,1552,529,301,830,85,915
公投第１６案,新北市,新店區,國豐里,2050,1467,503,264,767,79,846
公投第１６案,新北市,新店區,明德里,2051,1371,485,262,747,55,802
公投第１６案,新北市,新店區,明德里,2052,991,325,229,554,44,598
公投第１６案,新北市,新店區,明德里,2053,1231,428,246,674,72,746
公投第１６案,新北市,新店區,大豐里,2054,1701,539,374,913,85,998
公投第１６案,新北市,新店區,大豐里,2055,1707,549,367,916,58,974
公投第１６案,新北市,新店區,大同里,2056,1773,531,464,995,50,1045
公投第１６案,新北市,新店區,大同里,2057,1866,598,365,963,47,1010
公投第１６案,新北市,新店區,江陵里,2058,1735,633,343,976,58,1034
公投第１６案,新北市,新店區,江陵里,2059,1632,625,366,991,57,1048
公投第１６案,新北市,新店區,江陵里,2060,1591,570,317,887,65,952
公投第１６案,新北市,新店區,復興里,2061,1495,435,304,739,79,818
公投第１６案,新北市,新店區,復興里,2062,1511,572,158,730,33,763
公投第１６案,新北市,新店區,寶興里,2063,1260,377,288,665,70,735
公投第１６案,新北市,新店區,寶興里,2064,1948,738,370,1108,51,1159
公投第１６案,新北市,新店區,寶興里,2065,1582,588,339,927,52,979
公投第１６案,新北市,新店區,寶福里,2066,1315,411,292,703,62,765
公投第１６案,新北市,新店區,寶福里,2067,1562,475,320,795,60,855
公投第１６案,新北市,新店區,寶福里,2068,1982,786,342,1128,47,1175
公投第１６案,新北市,新店區,寶福里,2069,1518,524,310,834,65,899
公投第１６案,新北市,新店區,寶安里,2070,1735,570,350,920,53,973
公投第１６案,新北市,新店區,寶安里,2071,1716,618,290,908,57,965
公投第１６案,新北市,新店區,寶安里,2072,1580,549,306,855,76,931
公投第１６案,新北市,新店區,信義里,2073,1358,498,304,802,45,847
公投第１６案,新北市,新店區,信義里,2074,1610,526,365,891,112,1003
公投第１６案,新北市,新店區,信義里,2075,1383,447,273,720,52,772
公投第１６案,新北市,新店區,信義里,2076,1596,531,337,868,42,910
公投第１６案,新北市,新店區,忠孝里,2077,1360,437,247,684,46,730
公投第１６案,新北市,新店區,忠孝里,2078,1160,391,175,566,30,596
公投第１６案,新北市,新店區,大鵬里,2079,1236,534,234,768,46,814
公投第１６案,新北市,新店區,大鵬里,2080,1234,518,240,758,41,799
公投第１６案,新北市,新店區,太平里,2081,1579,481,350,831,91,922
公投第１６案,新北市,新店區,太平里,2082,1241,415,236,651,60,711
公投第１６案,新北市,新店區,美城里,2083,1275,401,284,685,28,713
公投第１６案,新北市,新店區,美城里,2084,1214,341,240,581,65,646
公投第１６案,新北市,新店區,頂城里,2085,1578,406,290,696,97,793
公投第１６案,新北市,新店區,下城里,2086,1442,470,276,746,50,796
公投第１６案,新北市,新店區,下城里,2087,1475,430,266,696,84,780
公投第１６案,新北市,新店區,柴埕里,2088,1580,649,317,966,60,1026
公投第１６案,新北市,新店區,柴埕里,2089,1585,442,352,794,43,837
公投第１６案,新北市,新店區,柴埕里,2090,1586,485,372,857,78,935
公投第１６案,新北市,新店區,柴埕里,2091,1931,622,379,1001,73,1074
公投第１６案,新北市,新店區,柴埕里,2092,1239,430,216,646,40,686
公投第１６案,新北市,新店區,安和里,2093,1892,599,372,971,73,1044
公投第１６案,新北市,新店區,安和里,2094,1529,442,293,735,62,797
公投第１６案,新北市,新店區,安和里,2095,1358,469,261,730,61,791
公投第１６案,新北市,新店區,安和里,2096,1905,560,366,926,50,976
公投第１６案,新北市,新店區,永安里,2097,1885,532,346,878,123,1001
公投第１６案,新北市,新店區,永安里,2098,1345,393,276,669,66,735
公投第１６案,新北市,新店區,永安里,2099,1387,408,317,725,68,793
公投第１６案,新北市,新店區,新和里,2100,1960,626,378,1004,77,1081
公投第１６案,新北市,新店區,新和里,2101,1837,588,356,944,88,1032
公投第１６案,新北市,新店區,永平里,2102,1662,565,308,873,73,946
公投第１６案,新北市,新店區,永平里,2103,1617,586,335,921,73,994
公投第１６案,新北市,新店區,永平里,2104,1704,587,336,923,52,975
公投第１６案,新北市,新店區,公崙里,2105,1835,559,341,900,87,987
公投第１６案,新北市,新店區,公崙里,2106,2009,610,375,985,101,1086
公投第１６案,新北市,新店區,公崙里,2107,1450,451,289,740,72,812
公投第１６案,新北市,新店區,公崙里,2108,1726,551,357,908,53,961
公投第１６案,新北市,新店區,公崙里,2109,1797,553,342,895,84,979
公投第１６案,新北市,新店區,公崙里,2110,1739,592,318,910,51,961
公投第１６案,新北市,新店區,安昌里,2111,1523,522,281,803,49,852
公投第１６案,新北市,新店區,安昌里,2112,1642,546,299,845,41,886
公投第１６案,新北市,新店區,安昌里,2113,1644,558,302,860,38,898
公投第１６案,新北市,新店區,德安里,2114,1662,475,320,795,42,837
公投第１６案,新北市,新店區,德安里,2115,2067,636,463,1099,84,1183
公投第１６案,新北市,新店區,德安里,2116,1870,468,315,783,70,853
公投第１６案,新北市,新店區,達觀里,2117,1982,647,370,1017,61,1078
公投第１６案,新北市,新店區,達觀里,2118,1546,572,256,828,53,881
公投第１６案,新北市,新店區,明城里,2119,1712,623,357,980,54,1034
公投第１６案,新北市,新店區,明城里,2120,1423,544,293,837,46,883
公投第１６案,新北市,新店區,小城里,2121,1666,611,324,935,79,1014
公投第１６案,新北市,新店區,小城里,2122,1769,645,377,1022,75,1097
公投第１６案,新北市,新店區,雙城里,2123,1079,279,204,483,59,542
公投第１６案,新北市,新店區,雙城里,2124,1140,332,243,575,24,599
公投第１６案,新北市,新店區,雙城里,2125,1825,701,230,931,68,999
公投第１６案,新北市,新店區,雙城里,2126,1178,384,283,667,46,713
公投第１６案,新北市,新店區,香坡里,2127,1463,469,274,743,54,797
公投第１６案,新北市,新店區,香坡里,2128,1152,377,232,609,45,654
公投第１６案,新北市,新店區,香坡里,2129,2008,551,351,902,42,944
公投第１６案,新北市,新店區,香坡里,2130,2120,589,328,917,55,972
公投第１６案,新北市,新店區,香坡里,2131,1153,411,251,662,23,685
公投第１６案,新北市,新店區,香坡里,2132,1573,513,272,785,40,825
公投第１６案,新北市,新店區,日興里,2133,1992,500,358,858,105,963
公投第１６案,新北市,新店區,日興里,2134,1668,426,337,763,60,823
公投第１６案,新北市,新店區,日興里,2135,1617,422,296,718,76,794
公投第１６案,新北市,新店區,玫瑰里,2136,2013,586,399,985,95,1080
公投第１６案,新北市,新店區,玫瑰里,2137,1791,616,373,989,50,1039
公投第１６案,新北市,新店區,玫瑰里,2138,1624,523,334,857,67,924
公投第１６案,新北市,新店區,吉祥里,2139,1178,432,239,671,45,716
公投第１６案,新北市,新店區,吉祥里,2140,1277,464,245,709,42,751
公投第１６案,新北市,新店區,吉祥里,2141,1879,645,345,990,73,1063
公投第１６案,新北市,新店區,塗潭里,2142,939,222,136,358,33,391
公投第１６案,新北市,新店區,華城里,2143,960,304,205,509,44,553
公投第１６案,新北市,新店區,華城里,2144,1434,510,324,834,42,876
公投第１６案,新北市,新店區,青潭里,2145,1838,499,383,882,77,959
公投第１６案,新北市,新店區,青潭里,2146,1453,469,281,750,62,812
公投第１６案,新北市,新店區,青潭里,2147,1549,432,321,753,79,832
公投第１６案,新北市,新店區,美潭里,2148,1860,612,401,1013,66,1079
公投第１６案,新北市,新店區,美潭里,2149,1743,526,317,843,52,895
公投第１６案,新北市,新店區,美潭里,2150,1122,441,254,695,40,735
公投第１６案,新北市,新店區,員潭里,2151,1468,478,284,762,52,814
公投第１６案,新北市,新店區,員潭里,2152,1763,545,362,907,65,972
公投第１６案,新北市,新店區,員潭里,2153,1344,394,262,656,60,716
公投第１６案,新北市,新店區,雙坑里,2154,753,194,147,341,62,403
公投第１６案,新北市,新店區,粗坑里,2155,602,169,122,291,16,307
公投第１６案,新北市,新店區,粗坑里,2156,2237,611,473,1084,85,1169
公投第１６案,新北市,新店區,屈尺里,2157,1096,304,248,552,42,594
公投第１６案,新北市,新店區,屈尺里,2158,1143,286,196,482,54,536
公投第１６案,新北市,新店區,龜山里,2159,1569,420,308,728,97,825
公投第１６案,新北市,新店區,廣興里,2160,1284,453,253,706,94,800
公投第１６案,新北市,新店區,直潭里,2161,439,64,54,118,15,133
公投第１６案,新北市,新店區,直潭里,2162,750,206,185,391,45,436
公投第１６案,新北市,深坑區,萬順里,2163,1142,321,219,540,49,589
公投第１６案,新北市,深坑區,萬順里,2164,1139,347,256,603,67,670
公投第１６案,新北市,深坑區,萬福里,2165,1065,262,234,496,77,573
公投第１６案,新北市,深坑區,萬福里,2166,1400,408,242,650,66,716
公投第１６案,新北市,深坑區,土庫里,2167,1330,374,246,620,57,677
公投第１６案,新北市,深坑區,土庫里,2168,1380,365,272,637,41,678
公投第１６案,新北市,深坑區,深坑里,2169,1496,390,246,636,35,671
公投第１６案,新北市,深坑區,深坑里,2170,1508,487,300,787,78,865
公投第１６案,新北市,深坑區,埔新里,2171,1624,468,371,839,87,926
公投第１６案,新北市,深坑區,埔新里,2172,2165,674,431,1105,73,1178
公投第１６案,新北市,深坑區,埔新里,2173,1790,564,376,940,105,1045
公投第１６案,新北市,深坑區,昇高里,2174,782,204,151,355,33,388
公投第１６案,新北市,深坑區,昇高里,2175,1164,409,236,645,30,675
公投第１６案,新北市,深坑區,賴仲里,2176,1344,427,308,735,67,802
公投第１６案,新北市,深坑區,賴仲里,2177,739,238,188,426,28,454
公投第１６案,新北市,深坑區,阿柔里,2178,556,178,123,301,38,339
公投第１６案,新北市,石碇區,石碇里,2179,391,109,93,202,39,241
公投第１６案,新北市,石碇區,潭邊里,2180,789,220,130,350,51,401
公投第１６案,新北市,石碇區,烏塗里,2181,662,134,113,247,29,276
公投第１６案,新北市,石碇區,彭山里,2182,310,81,63,144,17,161
公投第１６案,新北市,石碇區,豐田里,2183,280,83,50,133,16,149
公投第１６案,新北市,石碇區,豐田里,2184,93,19,14,33,5,38
公投第１６案,新北市,石碇區,隆盛里,2185,683,152,107,259,46,305
公投第１６案,新北市,石碇區,豐林里,2186,323,110,79,189,14,203
公投第１６案,新北市,石碇區,中民里,2187,726,135,116,251,12,263
公投第１６案,新北市,石碇區,永定里,2188,591,146,125,271,44,315
公投第１６案,新北市,石碇區,光明里,2189,282,71,83,154,36,190
公投第１６案,新北市,石碇區,永安里,2190,788,184,115,299,21,320
公投第１６案,新北市,石碇區,格頭里,2191,943,236,241,477,77,554
公投第１６案,新北市,坪林區,坪林里,2192,1248,373,215,588,58,646
公投第１６案,新北市,坪林區,水德里,2193,612,138,110,248,44,292
公投第１６案,新北市,坪林區,大林里,2194,1141,316,232,548,106,654
公投第１６案,新北市,坪林區,石𥕢里,2195,417,90,67,157,7,164
公投第１６案,新北市,坪林區,粗窟里,2196,595,162,119,281,51,332
公投第１６案,新北市,坪林區,粗窟里,2197,248,77,51,128,24,152
公投第１６案,新北市,坪林區,上德里,2198,338,92,51,143,22,165
公投第１６案,新北市,坪林區,上德里,2199,478,107,71,178,25,203
公投第１６案,新北市,坪林區,漁光里,2200,390,80,56,136,17,153
公投第１６案,新北市,坪林區,漁光里,2201,424,100,58,158,36,194
公投第１６案,新北市,烏來區,忠治里,2202,1568,531,314,845,87,932
公投第１６案,新北市,烏來區,烏來里,2203,1198,340,217,557,31,588
公投第１６案,新北市,烏來區,烏來里,2204,1169,309,206,515,45,560
公投第１６案,新北市,烏來區,孝義里,2205,228,77,38,115,4,119
公投第１６案,新北市,烏來區,信賢里,2206,486,135,88,223,47,270
公投第１６案,新北市,烏來區,福山里,2207,615,148,95,243,30,273
公投第１６案,新北市,平溪區,薯榔里,2208,384,88,68,156,31,187
公投第１６案,新北市,平溪區,菁桐里,2209,232,59,34,93,2,95
公投第１６案,新北市,平溪區,白石里,2210,249,74,53,127,13,140
公投第１６案,新北市,平溪區,石底里,2211,458,128,67,195,57,252
公投第１６案,新北市,平溪區,平溪里,2212,232,49,50,99,28,127
公投第１６案,新北市,平溪區,嶺腳里,2213,635,145,88,233,27,260
公投第１６案,新北市,平溪區,東勢里,2214,427,111,89,200,37,237
公投第１６案,新北市,平溪區,十分里,2215,862,173,129,302,54,356
公投第１６案,新北市,平溪區,望古里,2216,147,41,28,69,4,73
公投第１６案,新北市,平溪區,南山里,2217,365,82,37,119,18,137
公投第１６案,新北市,平溪區,新寮里,2218,153,23,34,57,7,64
公投第１６案,新北市,平溪區,平湖里,2219,177,61,33,94,15,109
公投第１６案,新北市,瑞芳區,龍潭里,2220,725,215,159,374,47,421
公投第１６案,新北市,瑞芳區,龍興里,2221,1074,310,222,532,75,607
公投第１６案,新北市,瑞芳區,龍興里,2222,825,253,156,409,23,432
公投第１６案,新北市,瑞芳區,龍鎮里,2223,1242,357,250,607,30,637
公投第１６案,新北市,瑞芳區,龍安里,2224,598,173,113,286,39,325
公投第１６案,新北市,瑞芳區,龍川里,2225,872,250,164,414,52,466
公投第１６案,新北市,瑞芳區,龍川里,2226,760,187,135,322,48,370
公投第１６案,新北市,瑞芳區,龍山里,2227,1330,349,210,559,65,624
公投第１６案,新北市,瑞芳區,爪峯里,2228,1683,430,283,713,72,785
公投第１６案,新北市,瑞芳區,爪峯里,2229,980,257,192,449,65,514
公投第１６案,新北市,瑞芳區,爪峯里,2230,946,256,187,443,60,503
公投第１６案,新北市,瑞芳區,新峰里,2231,1375,345,211,556,50,606
公投第１６案,新北市,瑞芳區,新峰里,2232,1671,457,297,754,65,819
公投第１６案,新北市,瑞芳區,東和里,2233,978,222,167,389,37,426
公投第１６案,新北市,瑞芳區,東和里,2234,645,155,119,274,40,314
公投第１６案,新北市,瑞芳區,柑坪里,2235,1089,283,203,486,73,559
公投第１６案,新北市,瑞芳區,弓橋里,2236,286,65,43,108,15,123
公投第１６案,新北市,瑞芳區,猴硐里,2237,461,100,86,186,44,230
公投第１６案,新北市,瑞芳區,光復里,2238,274,66,50,116,22,138
公投第１６案,新北市,瑞芳區,碩仁里,2239,155,49,34,83,10,93
公投第１６案,新北市,瑞芳區,吉慶里,2240,817,243,160,403,47,450
公投第１６案,新北市,瑞芳區,吉慶里,2241,884,218,146,364,89,453
公投第１６案,新北市,瑞芳區,吉安里,2242,1333,328,230,558,61,619
公投第１６案,新北市,瑞芳區,吉安里,2243,607,138,82,220,14,234
公投第１６案,新北市,瑞芳區,吉安里,2244,1045,289,200,489,53,542
公投第１６案,新北市,瑞芳區,上天里,2245,673,195,115,310,53,363
公投第１６案,新北市,瑞芳區,上天里,2246,618,134,80,214,15,229
公投第１６案,新北市,瑞芳區,傑魚里,2247,1063,259,195,454,39,493
公投第１６案,新北市,瑞芳區,傑魚里,2248,860,247,164,411,55,466
公投第１６案,新北市,瑞芳區,基山里,2249,432,68,53,121,5,126
公投第１６案,新北市,瑞芳區,永慶里,2250,445,95,65,160,12,172
公投第１６案,新北市,瑞芳區,崇文里,2251,318,68,55,123,11,134
公投第１６案,新北市,瑞芳區,福住里,2252,159,31,34,65,12,77
公投第１６案,新北市,瑞芳區,頌德里,2253,337,78,49,127,18,145
公投第１６案,新北市,瑞芳區,瓜山里,2254,180,58,29,87,11,98
公投第１６案,新北市,瑞芳區,銅山里,2255,187,46,21,67,14,81
公投第１６案,新北市,瑞芳區,新山里,2256,369,105,65,170,22,192
公投第１６案,新北市,瑞芳區,石山里,2257,335,81,77,158,28,186
公投第１６案,新北市,瑞芳區,濓洞里,2258,470,112,69,181,19,200
公投第１６案,新北市,瑞芳區,濓新里,2259,297,64,45,109,7,116
公投第１６案,新北市,瑞芳區,南雅里,2260,267,89,69,158,8,166
公投第１６案,新北市,瑞芳區,鼻頭里,2261,876,130,90,220,11,231
公投第１６案,新北市,瑞芳區,海濱里,2262,1241,244,172,416,32,448
公投第１６案,新北市,瑞芳區,瑞濱里,2263,998,265,189,454,78,532
公投第１６案,新北市,瑞芳區,瑞濱里,2264,948,253,179,432,66,498
公投第１６案,新北市,瑞芳區,深澳里,2265,1308,276,190,466,38,504
公投第１６案,新北市,雙溪區,雙溪里,2266,455,116,70,186,30,216
公投第１６案,新北市,雙溪區,新基里,2267,286,75,54,129,19,148
公投第１６案,新北市,雙溪區,新基里,2268,496,152,94,246,31,277
公投第１６案,新北市,雙溪區,三港里,2269,383,87,61,148,14,162
公投第１６案,新北市,雙溪區,牡丹里,2270,887,207,120,327,50,377
公投第１６案,新北市,雙溪區,牡丹里,2271,652,156,100,256,20,276
公投第１６案,新北市,雙溪區,三貂里,2272,333,100,56,156,15,171
公投第１６案,新北市,雙溪區,平林里,2273,642,168,113,281,37,318
公投第１６案,新北市,雙溪區,平林里,2274,282,72,50,122,13,135
公投第１６案,新北市,雙溪區,上林里,2275,621,148,100,248,21,269
公投第１６案,新北市,雙溪區,外柑里,2276,422,98,61,159,10,169
公投第１６案,新北市,雙溪區,長源里,2277,369,60,43,103,31,134
公投第１６案,新北市,雙溪區,共和里,2278,120,30,25,55,10,65
公投第１６案,新北市,雙溪區,共和里,2279,271,73,41,114,22,136
公投第１６案,新北市,雙溪區,魚行里,2280,362,98,85,183,30,213
公投第１６案,新北市,雙溪區,魚行里,2281,371,98,72,170,25,195
公投第１６案,新北市,雙溪區,泰平里,2282,1047,329,212,541,72,613
公投第１６案,新北市,貢寮區,貢寮里,2283,876,217,183,400,52,452
公投第１６案,新北市,貢寮區,龍崗里,2284,433,117,76,193,27,220
公投第１６案,新北市,貢寮區,吉林里,2285,516,127,73,200,11,211
公投第１６案,新北市,貢寮區,雙玉里,2286,373,70,56,126,27,153
公投第１６案,新北市,貢寮區,雙玉里,2287,313,56,61,117,38,155
公投第１６案,新北市,貢寮區,福連里,2288,485,135,102,237,13,250
公投第１６案,新北市,貢寮區,福連里,2289,415,91,110,201,13,214
公投第１６案,新北市,貢寮區,福隆里,2290,812,168,182,350,17,367
公投第１６案,新北市,貢寮區,福隆里,2291,861,160,211,371,47,418
公投第１６案,新北市,貢寮區,龍門里,2292,676,115,176,291,18,309
公投第１６案,新北市,貢寮區,真理里,2293,1091,183,251,434,31,465
公投第１６案,新北市,貢寮區,真理里,2294,955,174,189,363,47,410
公投第１６案,新北市,貢寮區,仁里里,2295,769,148,174,322,15,337
公投第１６案,新北市,貢寮區,仁里里,2296,962,238,209,447,29,476
公投第１６案,新北市,貢寮區,美豐里,2297,390,105,100,205,9,214
公投第１６案,新北市,貢寮區,美豐里,2298,349,75,83,158,8,166
公投第１６案,新北市,貢寮區,和美里,2299,508,81,84,165,36,201
公投第１６案,新北市,貢寮區,和美里,2300,495,87,64,151,16,167
公投第１６案,新北市,金山區,和平里,2301,481,141,94,235,27,262
公投第１６案,新北市,金山區,大同里,2302,715,192,151,343,36,379
公投第１６案,新北市,金山區,豐漁里,2303,481,114,72,186,28,214
公投第１６案,新北市,金山區,磺港里,2304,1792,441,307,748,81,829
公投第１６案,新北市,金山區,美田里,2305,1781,448,373,821,92,913
公投第１６案,新北市,金山區,美田里,2306,2010,565,435,1000,76,1076
公投第１６案,新北市,金山區,金美里,2307,1572,427,289,716,67,783
公投第１６案,新北市,金山區,金美里,2308,1777,436,375,811,101,912
公投第１６案,新北市,金山區,金美里,2309,1631,427,292,719,55,774
公投第１６案,新北市,金山區,五湖里,2310,828,224,174,398,36,434
公投第１６案,新北市,金山區,五湖里,2311,888,225,188,413,40,453
公投第１６案,新北市,金山區,重和里,2312,1211,311,234,545,64,609
公投第１６案,新北市,金山區,兩湖里,2313,416,109,106,215,25,240
公投第１６案,新北市,金山區,六股里,2314,682,211,135,346,53,399
公投第１６案,新北市,金山區,三界里,2315,644,149,141,290,59,349
公投第１６案,新北市,金山區,清泉里,2316,830,210,151,361,48,409
公投第１６案,新北市,金山區,西湖里,2317,188,44,43,87,12,99
公投第１６案,新北市,金山區,萬壽里,2318,469,116,114,230,29,259
公投第１６案,新北市,金山區,永興里,2319,582,110,72,182,31,213
公投第１６案,新北市,萬里區,萬里里,2320,1286,378,244,622,74,696
公投第１６案,新北市,萬里區,萬里里,2321,1576,455,335,790,68,858
公投第１６案,新北市,萬里區,萬里里,2322,1447,368,257,625,65,690
公投第１６案,新北市,萬里區,北基里,2323,1466,335,251,586,87,673
公投第１６案,新北市,萬里區,北基里,2324,1369,309,211,520,75,595
公投第１６案,新北市,萬里區,龜吼里,2325,1215,250,161,411,64,475
公投第１６案,新北市,萬里區,龜吼里,2326,1317,363,236,599,95,694
公投第１６案,新北市,萬里區,野柳里,2327,1676,342,310,652,76,728
公投第１６案,新北市,萬里區,野柳里,2328,1550,383,273,656,84,740
公投第１６案,新北市,萬里區,大鵬里,2329,945,307,221,528,62,590
公投第１６案,新北市,萬里區,大鵬里,2330,1760,506,377,883,76,959
公投第１６案,新北市,萬里區,磺潭里,2331,570,164,97,261,27,288
公投第１６案,新北市,萬里區,雙興里,2332,952,233,175,408,44,452
公投第１６案,新北市,萬里區,溪底里,2333,674,186,131,317,79,396
公投第１６案,新北市,萬里區,崁脚里,2334,405,97,91,188,23,211
公投第１６案,新北市,萬里區,中幅里,2335,1089,265,208,473,77,550
公投第１６案,新北市,汐止區,仁德里,2336,1595,334,414,748,97,845
公投第１６案,新北市,汐止區,義民里,2337,1262,361,276,637,70,707
公投第１６案,新北市,汐止區,禮門里,2338,917,253,213,466,73,539
公投第１６案,新北市,汐止區,智慧里,2339,1929,618,357,975,93,1068
公投第１６案,新北市,汐止區,智慧里,2340,2227,644,452,1096,84,1180
公投第１６案,新北市,汐止區,大同里,2341,1143,323,266,589,60,649
公投第１６案,新北市,汐止區,大同里,2342,1367,433,283,716,46,762
公投第１６案,新北市,汐止區,信望里,2343,322,89,61,150,25,175
公投第１６案,新北市,汐止區,新昌里,2344,1460,429,335,764,5,769
公投第１６案,新北市,汐止區,新昌里,2345,1719,490,313,803,71,874
公投第１６案,新北市,汐止區,新昌里,2346,1661,465,314,779,69,848
公投第１６案,新北市,汐止區,福安里,2347,1590,521,308,829,70,899
公投第１６案,新北市,汐止區,福安里,2348,1599,464,338,802,71,873
公投第１６案,新北市,汐止區,福安里,2349,1749,566,328,894,76,970
公投第１６案,新北市,汐止區,秀峰里,2350,1809,183,144,327,29,356
公投第１６案,新北市,汐止區,秀峰里,2351,1601,419,281,700,45,745
公投第１６案,新北市,汐止區,秀峰里,2352,1387,410,256,666,74,740
公投第１６案,新北市,汐止區,秀山里,2353,1779,567,396,963,80,1043
公投第１６案,新北市,汐止區,秀山里,2354,2074,694,392,1086,68,1154
公投第１６案,新北市,汐止區,復興里,2355,2072,634,401,1035,78,1113
公投第１６案,新北市,汐止區,復興里,2356,2120,697,456,1153,83,1236
公投第１６案,新北市,汐止區,復興里,2357,1952,590,391,981,69,1050
公投第１６案,新北市,汐止區,自強里,2358,1654,481,306,787,91,878
公投第１６案,新北市,汐止區,自強里,2359,1444,425,253,678,83,761
公投第１６案,新北市,汐止區,自強里,2360,1627,537,383,920,42,962
公投第１６案,新北市,汐止區,文化里,2361,1751,486,338,824,83,907
公投第１６案,新北市,汐止區,文化里,2362,2066,612,402,1014,81,1095
公投第１６案,新北市,汐止區,白雲里,2363,1941,506,305,811,70,881
公投第１６案,新北市,汐止區,白雲里,2364,1906,606,338,944,71,1015
公投第１６案,新北市,汐止區,茄苳里,2365,1363,355,274,629,89,718
公投第１６案,新北市,汐止區,茄苳里,2366,1368,354,292,646,50,696
公投第１６案,新北市,汐止區,茄苳里,2367,1233,302,251,553,62,615
公投第１６案,新北市,汐止區,崇德里,2368,1554,449,286,735,40,775
公投第１６案,新北市,汐止區,崇德里,2369,1700,426,361,787,66,853
公投第１６案,新北市,汐止區,崇德里,2370,1124,348,233,581,49,630
公投第１６案,新北市,汐止區,城中里,2371,1900,597,413,1010,75,1085
公投第１６案,新北市,汐止區,城中里,2372,2050,626,384,1010,87,1097
公投第１６案,新北市,汐止區,橋東里,2373,1244,382,226,608,59,667
公投第１６案,新北市,汐止區,橋東里,2374,1320,356,250,606,55,661
公投第１６案,新北市,汐止區,建成里,2375,1473,445,322,767,65,832
公投第１６案,新北市,汐止區,建成里,2376,1802,584,336,920,76,996
公投第１６案,新北市,汐止區,建成里,2377,1266,412,278,690,51,741
公投第１６案,新北市,汐止區,長安里,2378,1481,364,290,654,84,738
公投第１６案,新北市,汐止區,保安里,2379,1497,412,284,696,77,773
公投第１６案,新北市,汐止區,東山里,2380,556,155,124,279,25,304
公投第１６案,新北市,汐止區,保長里,2381,1913,545,338,883,72,955
公投第１６案,新北市,汐止區,保長里,2382,2027,580,384,964,54,1018
公投第１６案,新北市,汐止區,保新里,2383,1927,546,351,897,49,946
公投第１６案,新北市,汐止區,保新里,2384,696,183,154,337,51,388
公投第１６案,新北市,汐止區,鄉長里,2385,2127,601,354,955,98,1053
公投第１６案,新北市,汐止區,江北里,2386,1642,427,279,706,70,776
公投第１６案,新北市,汐止區,江北里,2387,1912,514,386,900,98,998
公投第１６案,新北市,汐止區,江北里,2388,1893,447,351,798,79,877
公投第１６案,新北市,汐止區,拱北里,2389,1466,372,255,627,87,714
公投第１６案,新北市,汐止區,拱北里,2390,1538,441,262,703,90,793
公投第１６案,新北市,汐止區,拱北里,2391,1550,472,261,733,53,786
公投第１６案,新北市,汐止區,烘內里,2392,1456,404,261,665,76,741
公投第１６案,新北市,汐止區,八連里,2393,947,291,227,518,56,574
公投第１６案,新北市,汐止區,長青里,2394,923,277,211,488,29,517
公投第１６案,新北市,汐止區,北峰里,2395,2043,477,349,826,203,1029
公投第１６案,新北市,汐止區,北峰里,2396,2012,511,366,877,82,959
公投第１６案,新北市,汐止區,金龍里,2397,1471,379,245,624,54,678
公投第１６案,新北市,汐止區,金龍里,2398,1603,431,311,742,76,818
公投第１６案,新北市,汐止區,金龍里,2399,1530,455,294,749,74,823
公投第１６案,新北市,汐止區,樟樹里,2400,1988,491,318,809,46,855
公投第１６案,新北市,汐止區,忠孝里,2401,2198,585,434,1019,70,1089
公投第１６案,新北市,汐止區,忠孝里,2402,1712,473,325,798,71,869
公投第１６案,新北市,汐止區,忠孝里,2403,1806,558,368,926,79,1005
公投第１６案,新北市,汐止區,忠孝里,2404,1576,471,292,763,89,852
公投第１６案,新北市,汐止區,厚德里,2405,1511,442,293,735,50,785
公投第１６案,新北市,汐止區,厚德里,2406,1691,486,267,753,54,807
公投第１６案,新北市,汐止區,厚德里,2407,1636,479,321,800,69,869
公投第１６案,新北市,汐止區,厚德里,2408,1676,505,285,790,75,865
公投第１６案,新北市,汐止區,山光里,2409,1264,370,240,610,46,656
公投第１６案,新北市,汐止區,山光里,2410,1165,360,216,576,29,605
公投第１６案,新北市,汐止區,中興里,2411,1765,487,329,816,77,893
公投第１６案,新北市,汐止區,中興里,2412,1815,473,292,765,41,806
公投第１６案,新北市,汐止區,中興里,2413,1778,469,319,788,95,883
公投第１６案,新北市,汐止區,中興里,2414,1580,489,291,780,92,872
公投第１６案,新北市,汐止區,福德里,2415,1516,421,330,751,56,807
公投第１６案,新北市,汐止區,福德里,2416,1425,383,254,637,62,699
公投第１６案,新北市,汐止區,興福里,2417,1388,423,293,716,51,767
公投第１６案,新北市,汐止區,興福里,2418,1436,382,315,697,83,780
公投第１６案,新北市,汐止區,康福里,2419,1591,479,303,782,58,840
公投第１６案,新北市,汐止區,康福里,2420,1639,474,298,772,42,814
公投第１６案,新北市,汐止區,康福里,2421,1394,386,266,652,35,687
公投第１６案,新北市,汐止區,湖光里,2422,2035,546,382,928,62,990
公投第１６案,新北市,汐止區,湖光里,2423,1895,543,358,901,71,972
公投第１６案,新北市,汐止區,湖光里,2424,1374,471,277,748,36,784
公投第１６案,新北市,汐止區,湖蓮里,2425,1061,327,256,583,36,619
公投第１６案,新北市,汐止區,湖蓮里,2426,1312,515,295,810,25,835
公投第１６案,新北市,汐止區,湖興里,2427,1548,508,286,794,64,858
公投第１６案,新北市,汐止區,湖興里,2428,1350,467,267,734,37,771
公投第１６案,新北市,汐止區,湖興里,2429,1499,427,334,761,50,811
公投第１６案,新北市,汐止區,湖興里,2430,1366,461,265,726,58,784
公投第１６案,新北市,汐止區,北山里,2431,1335,399,294,693,72,765
公投第１６案,新北市,汐止區,北山里,2432,1324,462,286,748,60,808
公投第１６案,新北市,汐止區,北山里,2433,1286,424,281,705,76,781
公投第１６案,新北市,汐止區,北山里,2434,1155,310,252,562,74,636
公投第１６案,新北市,汐止區,忠山里,2435,1682,610,373,983,47,1030
公投第１６案,新北市,汐止區,忠山里,2436,1494,526,325,851,69,920
公投第１６案,新北市,汐止區,環河里,2437,1166,314,316,630,73,703
公投第１６案,新北市,汐止區,橫科里,2438,2184,622,432,1054,141,1195
公投第１６案,新北市,汐止區,橫科里,2439,2031,606,408,1014,96,1110
公投第１６案,新北市,汐止區,福山里,2440,1759,535,351,886,76,962
公投第１６案,新北市,汐止區,福山里,2441,1577,525,316,841,59,900
公投第１６案,新北市,汐止區,宜興里,2442,1364,441,252,693,33,726
公投第１６案,新北市,汐止區,宜興里,2443,1401,471,264,735,62,797
公投第１６案,新北市,汐止區,東勢里,2444,1173,377,270,647,46,693
公投第１６案,新北市,汐止區,東勢里,2445,993,330,218,548,33,581
公投第１６案,新北市,汐止區,東勢里,2446,1587,527,275,802,37,839
公投第１６案,臺中市,大甲區,朝陽里,1,1356,290,439,729,88,817
公投第１６案,臺中市,大甲區,大甲里,2,1059,360,240,600,65,665
公投第１６案,臺中市,大甲區,順天里,3,694,227,174,401,43,444
公投第１６案,臺中市,大甲區,順天里,4,874,276,200,476,45,521
公投第１６案,臺中市,大甲區,孔門里,5,763,211,184,395,34,429
公投第１６案,臺中市,大甲區,平安里,6,856,290,211,501,46,547
公投第１６案,臺中市,大甲區,平安里,7,1249,391,280,671,68,739
公投第１６案,臺中市,大甲區,庄美里,8,922,369,93,462,41,503
公投第１６案,臺中市,大甲區,庄美里,9,1189,378,264,642,60,702
公投第１６案,臺中市,大甲區,新美里,10,1065,390,239,629,51,680
公投第１６案,臺中市,大甲區,新美里,11,1252,425,294,719,85,804
公投第１６案,臺中市,大甲區,新美里,12,1057,318,235,553,60,613
公投第１６案,臺中市,大甲區,岷山里,13,1031,315,242,557,37,594
公投第１６案,臺中市,大甲區,岷山里,14,1060,371,239,610,58,668
公投第１６案,臺中市,大甲區,中山里,15,1311,388,294,682,84,766
公投第１６案,臺中市,大甲區,中山里,16,1424,449,309,758,61,819
公投第１６案,臺中市,大甲區,中山里,17,1670,539,361,900,83,983
公投第１６案,臺中市,大甲區,南陽里,18,812,253,162,415,63,478
公投第１６案,臺中市,大甲區,薰風里,19,863,296,193,489,29,518
公投第１６案,臺中市,大甲區,義和里,20,1598,519,361,880,69,949
公投第１６案,臺中市,大甲區,義和里,21,1588,465,363,828,76,904
公投第１６案,臺中市,大甲區,武陵里,22,1197,392,235,627,65,692
公投第１６案,臺中市,大甲區,文曲里,23,1106,301,230,531,88,619
公投第１６案,臺中市,大甲區,武曲里,24,903,279,221,500,71,571
公投第１６案,臺中市,大甲區,武曲里,25,869,290,200,490,53,543
公投第１６案,臺中市,大甲區,文武里,26,1350,448,277,725,59,784
公投第１６案,臺中市,大甲區,文武里,27,1144,332,246,578,122,700
公投第１６案,臺中市,大甲區,文武里,28,1208,402,250,652,81,733
公投第１６案,臺中市,大甲區,文武里,29,1567,534,319,853,66,919
公投第１６案,臺中市,大甲區,奉化里,30,1246,455,295,750,41,791
公投第１６案,臺中市,大甲區,奉化里,31,767,233,186,419,51,470
公投第１６案,臺中市,大甲區,德化里,32,790,259,179,438,42,480
公投第１６案,臺中市,大甲區,德化里,33,972,318,219,537,52,589
公投第１６案,臺中市,大甲區,江南里,34,1388,397,300,697,59,756
公投第１６案,臺中市,大甲區,頂店里,35,1331,387,275,662,54,716
公投第１６案,臺中市,大甲區,頂店里,36,1167,416,255,671,60,731
公投第１６案,臺中市,大甲區,頂店里,37,1934,679,371,1050,72,1122
公投第１６案,臺中市,大甲區,太白里,38,1263,384,212,596,62,658
公投第１６案,臺中市,大甲區,孟春里,39,1390,411,295,706,88,794
公投第１６案,臺中市,大甲區,孟春里,40,1186,309,203,512,59,571
公投第１６案,臺中市,大甲區,孟春里,41,1397,417,299,716,58,774
公投第１６案,臺中市,大甲區,幸福里,42,1173,295,182,477,29,506
公投第１６案,臺中市,大甲區,幸福里,43,1398,411,272,683,90,773
公投第１６案,臺中市,大甲區,日南里,44,1228,325,237,562,79,641
公投第１６案,臺中市,大甲區,日南里,45,1258,348,271,619,63,682
公投第１６案,臺中市,大甲區,日南里,46,1435,407,314,721,67,788
公投第１６案,臺中市,大甲區,日南里,47,1532,430,331,761,81,842
公投第１６案,臺中市,大甲區,龍泉里,48,652,218,114,332,46,378
公投第１６案,臺中市,大甲區,龍泉里,49,870,214,171,385,46,431
公投第１６案,臺中市,大甲區,西岐里,50,891,235,181,416,45,461
公投第１６案,臺中市,大甲區,西岐里,51,784,257,154,411,43,454
公投第１６案,臺中市,大甲區,銅安里,52,1368,369,261,630,119,749
公投第１６案,臺中市,大甲區,福德里,53,1126,356,148,504,96,600
公投第１６案,臺中市,大甲區,建興里,54,1486,398,222,620,116,736
公投第１６案,臺中市,大安區,南埔里,55,1068,289,196,485,84,569
公投第１６案,臺中市,大安區,南庄里,56,1050,319,209,528,85,613
公投第１６案,臺中市,大安區,中庄里,57,1246,370,290,660,101,761
公投第１６案,臺中市,大安區,中庄里,58,1397,406,293,699,82,781
公投第１６案,臺中市,大安區,東安里,59,1227,381,279,660,97,757
公投第１６案,臺中市,大安區,福興里,60,1170,364,228,592,100,692
公投第１６案,臺中市,大安區,龜壳里,61,914,285,173,458,138,596
公投第１６案,臺中市,大安區,龜壳里,62,667,173,117,290,55,345
公投第１６案,臺中市,大安區,頂安里,63,890,254,150,404,79,483
公投第１６案,臺中市,大安區,永安里,64,1289,368,272,640,95,735
公投第１６案,臺中市,大安區,永安里,65,455,109,94,203,39,242
公投第１６案,臺中市,大安區,福住里,66,1028,321,200,521,62,583
公投第１６案,臺中市,大安區,海墘里,67,1446,438,311,749,117,866
公投第１６案,臺中市,大安區,西安里,68,688,248,159,407,41,448
公投第１６案,臺中市,大安區,西安里,69,1062,338,222,560,89,649
公投第１６案,臺中市,大安區,松雅里,70,923,301,250,551,48,599
公投第１６案,臺中市,外埔區,永豐里,71,1059,310,221,531,71,602
公投第１６案,臺中市,外埔區,六分里,72,1013,327,231,558,33,591
公投第１６案,臺中市,外埔區,六分里,73,1150,386,260,646,71,717
公投第１６案,臺中市,外埔區,大同里,74,1855,681,405,1086,97,1183
公投第１６案,臺中市,外埔區,大同里,75,1327,457,286,743,54,797
公投第１６案,臺中市,外埔區,大同里,76,1453,503,298,801,77,878
公投第１６案,臺中市,外埔區,大東里,77,1653,515,289,804,122,926
公投第１６案,臺中市,外埔區,大東里,78,1615,478,332,810,66,876
公投第１６案,臺中市,外埔區,大東里,79,1470,392,325,717,63,780
公投第１６案,臺中市,外埔區,大東里,80,1559,481,350,831,94,925
公投第１６案,臺中市,外埔區,三崁里,81,1902,551,382,933,136,1069
公投第１６案,臺中市,外埔區,水美里,82,1138,370,285,655,77,732
公投第１６案,臺中市,外埔區,水美里,83,1065,360,230,590,89,679
公投第１６案,臺中市,外埔區,水美里,84,1243,433,277,710,66,776
公投第１６案,臺中市,外埔區,鐵山里,85,962,274,204,478,50,528
公投第１６案,臺中市,外埔區,鐵山里,86,1169,340,244,584,73,657
公投第１６案,臺中市,外埔區,中山里,87,1216,450,255,705,79,784
公投第１６案,臺中市,外埔區,馬鳴里,88,1391,502,200,702,75,777
公投第１６案,臺中市,外埔區,土城里,89,1616,488,304,792,118,910
公投第１６案,臺中市,外埔區,廍子里,90,1203,311,204,515,51,566
公投第１６案,臺中市,清水區,鰲峰里,91,1076,322,224,546,38,584
公投第１６案,臺中市,清水區,靈泉里,92,953,345,211,556,68,624
公投第１６案,臺中市,清水區,清水里,93,914,286,216,502,71,573
公投第１６案,臺中市,清水區,清水里,94,1143,404,255,659,76,735
公投第１６案,臺中市,清水區,文昌里,95,680,247,147,394,36,430
公投第１６案,臺中市,清水區,南寧里,96,904,317,184,501,57,558
公投第１６案,臺中市,清水區,南寧里,97,893,302,212,514,62,576
公投第１６案,臺中市,清水區,西寧里,98,1577,529,313,842,75,917
公投第１６案,臺中市,清水區,北寧里,99,690,230,141,371,35,406
公投第１６案,臺中市,清水區,中興里,100,403,122,99,221,25,246
公投第１６案,臺中市,清水區,西社里,101,1413,449,294,743,103,846
公投第１６案,臺中市,清水區,西社里,102,777,233,169,402,56,458
公投第１６案,臺中市,清水區,南社里,103,1313,477,265,742,53,795
公投第１６案,臺中市,清水區,南社里,104,1439,537,285,822,72,894
公投第１６案,臺中市,清水區,南社里,105,1265,384,261,645,38,683
公投第１６案,臺中市,清水區,南社里,106,1277,490,276,766,43,809
公投第１６案,臺中市,清水區,南社里,107,1276,457,259,716,57,773
公投第１６案,臺中市,清水區,南社里,108,1376,484,332,816,52,868
公投第１６案,臺中市,清水區,南社里,109,1291,516,251,767,42,809
公投第１６案,臺中市,清水區,裕嘉里,110,1510,519,300,819,97,916
公投第１６案,臺中市,清水區,臨江里,111,1524,412,401,813,9,822
公投第１６案,臺中市,清水區,秀水里,112,1474,422,291,713,69,782
公投第１６案,臺中市,清水區,秀水里,113,1507,474,301,775,77,852
公投第１６案,臺中市,清水區,秀水里,114,1321,460,308,768,96,864
公投第１６案,臺中市,清水區,武鹿里,115,1157,300,243,543,61,604
公投第１６案,臺中市,清水區,武鹿里,116,1255,427,264,691,61,752
公投第１６案,臺中市,清水區,武鹿里,117,881,266,188,454,48,502
公投第１６案,臺中市,清水區,海濱里,118,1083,384,214,598,73,671
公投第１６案,臺中市,清水區,海濱里,119,951,346,174,520,50,570
公投第１６案,臺中市,清水區,槺榔里,120,1424,420,280,700,83,783
公投第１６案,臺中市,清水區,槺榔里,121,1233,348,249,597,78,675
公投第１６案,臺中市,清水區,槺榔里,122,1288,310,246,556,75,631
公投第１６案,臺中市,清水區,槺榔里,123,1200,386,268,654,69,723
公投第１６案,臺中市,清水區,中社里,124,1609,626,287,913,54,967
公投第１６案,臺中市,清水區,中社里,125,1136,399,283,682,33,715
公投第１６案,臺中市,清水區,高西里,126,1302,447,196,643,84,727
公投第１６案,臺中市,清水區,高南里,127,1373,520,253,773,101,874
公投第１６案,臺中市,清水區,高東里,128,1257,337,227,564,92,656
公投第１６案,臺中市,清水區,高北里,129,1184,322,205,527,94,621
公投第１６案,臺中市,清水區,高美里,130,1322,429,231,660,89,749
公投第１６案,臺中市,清水區,國姓里,131,1193,325,228,553,75,628
公投第１６案,臺中市,清水區,國姓里,132,927,256,185,441,108,549
公投第１６案,臺中市,清水區,菁埔里,133,1073,341,247,588,80,668
公投第１６案,臺中市,清水區,菁埔里,134,1163,375,252,627,95,722
公投第１６案,臺中市,清水區,頂湳里,135,855,276,161,437,40,477
公投第１６案,臺中市,清水區,頂湳里,136,902,238,173,411,91,502
公投第１６案,臺中市,清水區,田寮里,137,1415,451,278,729,87,816
公投第１６案,臺中市,清水區,田寮里,138,1066,309,207,516,64,580
公投第１６案,臺中市,清水區,橋頭里,139,1391,425,267,692,86,778
公投第１６案,臺中市,清水區,橋頭里,140,1449,440,273,713,51,764
公投第１６案,臺中市,清水區,橋頭里,141,1377,469,299,768,63,831
公投第１６案,臺中市,清水區,橋頭里,142,1423,440,335,775,74,849
公投第１６案,臺中市,清水區,橋頭里,143,1624,534,337,871,71,942
公投第１６案,臺中市,清水區,下湳里,144,1358,393,279,672,95,767
公投第１６案,臺中市,清水區,下湳里,145,1464,455,305,760,92,852
公投第１６案,臺中市,清水區,東山里,146,1211,376,273,649,97,746
公投第１６案,臺中市,清水區,吳厝里,147,1456,429,285,714,61,775
公投第１６案,臺中市,清水區,楊厝里,148,1162,405,217,622,103,725
公投第１６案,臺中市,清水區,海風里,149,1368,545,241,786,88,874
公投第１６案,臺中市,梧棲區,頂寮里,150,1541,451,323,774,97,871
公投第１６案,臺中市,梧棲區,頂寮里,151,1581,463,328,791,90,881
公投第１６案,臺中市,梧棲區,下寮里,152,1083,342,214,556,81,637
公投第１６案,臺中市,梧棲區,下寮里,153,876,273,197,470,59,529
公投第１６案,臺中市,梧棲區,中正里,154,1043,320,215,535,83,618
公投第１６案,臺中市,梧棲區,中正里,155,1502,424,299,723,60,783
公投第１６案,臺中市,梧棲區,中正里,156,1384,432,292,724,74,798
公投第１６案,臺中市,梧棲區,中和里,157,517,166,140,306,44,350
公投第１６案,臺中市,梧棲區,文化里,158,1169,412,258,670,79,749
公投第１６案,臺中市,梧棲區,安仁里,159,863,285,182,467,57,524
公投第１６案,臺中市,梧棲區,草湳里,160,1277,355,219,574,66,640
公投第１６案,臺中市,梧棲區,草湳里,161,1742,503,359,862,76,938
公投第１６案,臺中市,梧棲區,草湳里,162,1342,397,318,715,74,789
公投第１６案,臺中市,梧棲區,草湳里,163,1767,517,387,904,113,1017
公投第１６案,臺中市,梧棲區,南簡里,164,1542,424,277,701,88,789
公投第１６案,臺中市,梧棲區,南簡里,165,1636,539,296,835,62,897
公投第１６案,臺中市,梧棲區,南簡里,166,1796,528,335,863,83,946
公投第１６案,臺中市,梧棲區,福德里,167,1450,474,278,752,47,799
公投第１６案,臺中市,梧棲區,福德里,168,1548,423,278,701,152,853
公投第１６案,臺中市,梧棲區,福德里,169,1366,432,303,735,69,804
公投第１６案,臺中市,梧棲區,大庄里,170,955,352,218,570,48,618
公投第１６案,臺中市,梧棲區,大庄里,171,1305,383,260,643,74,717
公投第１６案,臺中市,梧棲區,大庄里,172,1239,393,268,661,71,732
公投第１６案,臺中市,梧棲區,大庄里,173,1079,338,228,566,101,667
公投第１６案,臺中市,梧棲區,大庄里,174,1220,395,232,627,53,680
公投第１６案,臺中市,梧棲區,大庄里,175,1544,524,322,846,86,932
公投第１６案,臺中市,梧棲區,大村里,176,1460,501,312,813,68,881
公投第１６案,臺中市,梧棲區,大村里,177,1292,422,280,702,84,786
公投第１６案,臺中市,梧棲區,大村里,178,1300,411,259,670,72,742
公投第１６案,臺中市,梧棲區,大村里,179,1555,456,293,749,86,835
公投第１６案,臺中市,梧棲區,興農里,180,1031,309,190,499,72,571
公投第１６案,臺中市,梧棲區,興農里,181,1277,414,268,682,88,770
公投第１６案,臺中市,梧棲區,永寧里,182,1037,301,214,515,59,574
公投第１６案,臺中市,梧棲區,永寧里,183,1187,384,240,624,82,706
公投第１６案,臺中市,梧棲區,永安里,184,1399,441,236,677,82,759
公投第１６案,臺中市,梧棲區,永安里,185,1135,339,233,572,65,637
公投第１６案,臺中市,沙鹿區,居仁里,186,1380,423,243,666,71,737
公投第１６案,臺中市,沙鹿區,洛泉里,187,852,274,186,460,59,519
公投第１６案,臺中市,沙鹿區,洛泉里,188,1176,399,241,640,83,723
公投第１６案,臺中市,沙鹿區,沙鹿里,189,958,353,200,553,92,645
公投第１６案,臺中市,沙鹿區,美仁里,190,488,176,135,311,26,337
公投第１６案,臺中市,沙鹿區,興仁里,191,1177,380,241,621,68,689
公投第１６案,臺中市,沙鹿區,興仁里,192,1285,402,241,643,101,744
公投第１６案,臺中市,沙鹿區,興安里,193,1736,502,324,826,113,939
公投第１６案,臺中市,沙鹿區,興安里,194,1628,488,354,842,150,992
公投第１６案,臺中市,沙鹿區,斗抵里,195,1469,449,306,755,39,794
公投第１６案,臺中市,沙鹿區,斗抵里,196,1423,476,327,803,68,871
公投第１６案,臺中市,沙鹿區,斗抵里,197,1444,433,275,708,152,860
公投第１６案,臺中市,沙鹿區,鹿峰里,198,1469,462,269,731,124,855
公投第１６案,臺中市,沙鹿區,鹿峰里,199,1902,567,443,1010,95,1105
公投第１６案,臺中市,沙鹿區,鹿峰里,200,1675,526,375,901,83,984
公投第１６案,臺中市,沙鹿區,鹿寮里,201,1098,340,225,565,73,638
公投第１６案,臺中市,沙鹿區,鹿寮里,202,1539,524,344,868,81,949
公投第１６案,臺中市,沙鹿區,鹿寮里,203,1329,427,306,733,53,786
公投第１６案,臺中市,沙鹿區,鹿寮里,204,1255,364,278,642,64,706
公投第１６案,臺中市,沙鹿區,鹿寮里,205,1507,478,344,822,68,890
公投第１６案,臺中市,沙鹿區,竹林里,206,1463,446,320,766,102,868
公投第１６案,臺中市,沙鹿區,竹林里,207,1279,371,246,617,94,711
公投第１６案,臺中市,沙鹿區,竹林里,208,1024,301,180,481,54,535
公投第１６案,臺中市,沙鹿區,竹林里,209,1388,411,261,672,83,755
公投第１６案,臺中市,沙鹿區,竹林里,210,1074,358,226,584,68,652
公投第１６案,臺中市,沙鹿區,竹林里,211,1072,364,244,608,48,656
公投第１６案,臺中市,沙鹿區,犁分里,212,1107,361,238,599,92,691
公投第１６案,臺中市,沙鹿區,福興里,213,1947,547,362,909,78,987
公投第１６案,臺中市,沙鹿區,福興里,214,1682,481,324,805,95,900
公投第１６案,臺中市,沙鹿區,北勢里,215,1633,573,324,897,55,952
公投第１６案,臺中市,沙鹿區,北勢里,216,1533,450,286,736,70,806
公投第１６案,臺中市,沙鹿區,北勢里,217,1605,380,314,694,62,756
公投第１６案,臺中市,沙鹿區,晉江里,218,1694,512,302,814,65,879
公投第１６案,臺中市,沙鹿區,六路里,219,1628,499,311,810,65,875
公投第１６案,臺中市,沙鹿區,六路里,220,1665,553,371,924,45,969
公投第１６案,臺中市,沙鹿區,六路里,221,1651,475,359,834,76,910
公投第１６案,臺中市,沙鹿區,南勢里,222,1108,370,232,602,85,687
公投第１６案,臺中市,沙鹿區,南勢里,223,1142,398,247,645,55,700
公投第１６案,臺中市,沙鹿區,南勢里,224,1039,330,221,551,48,599
公投第１６案,臺中市,沙鹿區,埔子里,225,1840,541,387,928,89,1017
公投第１６案,臺中市,沙鹿區,埔子里,226,1872,553,413,966,72,1038
公投第１６案,臺中市,沙鹿區,埔子里,227,1558,433,321,754,86,840
公投第１６案,臺中市,沙鹿區,三鹿里,228,1739,511,315,826,76,902
公投第１６案,臺中市,沙鹿區,三鹿里,229,1672,477,313,790,54,844
公投第１６案,臺中市,沙鹿區,三鹿里,230,1634,511,337,848,62,910
公投第１６案,臺中市,沙鹿區,三鹿里,231,1616,460,301,761,63,824
公投第１６案,臺中市,沙鹿區,公明里,232,1593,493,329,822,83,905
公投第１６案,臺中市,沙鹿區,公明里,233,981,299,198,497,35,532
公投第１６案,臺中市,沙鹿區,公明里,234,1740,594,342,936,93,1029
公投第１６案,臺中市,沙鹿區,清泉里,235,1247,412,255,667,94,761
公投第１６案,臺中市,沙鹿區,清泉里,236,1047,345,222,567,31,598
公投第１６案,臺中市,沙鹿區,西勢里,237,1119,329,232,561,105,666
公投第１６案,臺中市,沙鹿區,西勢里,238,1025,311,198,509,57,566
公投第１６案,臺中市,龍井區,竹坑里,239,1758,595,347,942,115,1057
公投第１６案,臺中市,龍井區,竹坑里,240,1275,410,241,651,75,726
公投第１６案,臺中市,龍井區,龍東里,241,1379,353,262,615,56,671
公投第１６案,臺中市,龍井區,龍東里,242,1403,385,271,656,90,746
公投第１６案,臺中市,龍井區,龍西里,243,974,283,225,508,56,564
公投第１６案,臺中市,龍井區,龍西里,244,901,303,171,474,64,538
公投第１６案,臺中市,龍井區,田中里,245,1779,523,345,868,117,985
公投第１６案,臺中市,龍井區,田中里,246,1609,531,340,871,90,961
公投第１６案,臺中市,龍井區,福田里,247,1038,216,276,492,43,535
公投第１６案,臺中市,龍井區,麗水里,248,1328,463,258,721,83,804
公投第１６案,臺中市,龍井區,麗水里,249,921,330,204,534,36,570
公投第１６案,臺中市,龍井區,龍津里,250,1609,460,288,748,97,845
公投第１６案,臺中市,龍井區,龍津里,251,1227,308,232,540,34,574
公投第１６案,臺中市,龍井區,龍津里,252,1278,378,255,633,92,725
公投第１６案,臺中市,龍井區,龍津里,253,914,205,171,376,39,415
公投第１６案,臺中市,龍井區,三德里,254,1678,448,303,751,47,798
公投第１６案,臺中市,龍井區,三德里,255,1233,323,234,557,64,621
公投第１６案,臺中市,龍井區,忠和里,256,1520,459,305,764,95,859
公投第１６案,臺中市,龍井區,忠和里,257,1905,561,329,890,82,972
公投第１６案,臺中市,龍井區,忠和里,258,1520,469,349,818,83,901
公投第１６案,臺中市,龍井區,山腳里,259,1385,389,291,680,70,750
公投第１６案,臺中市,龍井區,山腳里,260,1212,367,257,624,57,681
公投第１６案,臺中市,龍井區,山腳里,261,1432,504,267,771,42,813
公投第１６案,臺中市,龍井區,山腳里,262,1663,450,347,797,71,868
公投第１６案,臺中市,龍井區,龍泉里,263,1422,438,249,687,65,752
公投第１６案,臺中市,龍井區,龍泉里,264,1616,409,337,746,84,830
公投第１６案,臺中市,龍井區,龍泉里,265,1422,474,293,767,73,840
公投第１６案,臺中市,龍井區,龍泉里,266,1165,367,264,631,56,687
公投第１６案,臺中市,龍井區,龍泉里,267,1624,511,336,847,53,900
公投第１６案,臺中市,龍井區,龍崗里,268,1613,522,288,810,93,903
公投第１６案,臺中市,龍井區,龍崗里,269,943,327,198,525,62,587
公投第１６案,臺中市,龍井區,新庄里,270,1595,437,303,740,111,851
公投第１６案,臺中市,龍井區,新庄里,271,1508,491,297,788,100,888
公投第１６案,臺中市,龍井區,新庄里,272,1479,430,278,708,81,789
公投第１６案,臺中市,龍井區,新庄里,273,1509,471,316,787,88,875
公投第１６案,臺中市,龍井區,南寮里,274,1582,510,334,844,98,942
公投第１６案,臺中市,龍井區,東海里,275,1725,657,230,887,86,973
公投第１６案,臺中市,龍井區,東海里,276,1616,523,326,849,78,927
公投第１６案,臺中市,龍井區,東海里,277,1657,532,377,909,64,973
公投第１６案,臺中市,龍井區,東海里,278,1774,590,358,948,83,1031
公投第１６案,臺中市,龍井區,東海里,279,1701,538,418,956,77,1033
公投第１６案,臺中市,龍井區,新東里,280,1121,335,267,602,58,660
公投第１６案,臺中市,龍井區,新東里,281,987,324,233,557,64,621
公投第１６案,臺中市,龍井區,新東里,282,1206,364,297,661,59,720
公投第１６案,臺中市,龍井區,新東里,283,1378,459,315,774,73,847
公投第１６案,臺中市,大肚區,王田里,284,1415,419,302,721,73,794
公投第１６案,臺中市,大肚區,王田里,285,1392,409,250,659,88,747
公投第１６案,臺中市,大肚區,王田里,286,1520,503,327,830,92,922
公投第１６案,臺中市,大肚區,中和里,287,862,321,191,512,71,583
公投第１６案,臺中市,大肚區,福山里,288,1256,440,257,697,81,778
公投第１６案,臺中市,大肚區,福山里,289,1292,426,233,659,88,747
公投第１６案,臺中市,大肚區,福山里,290,1010,312,225,537,76,613
公投第１６案,臺中市,大肚區,營埔里,291,1485,467,344,811,108,919
公投第１６案,臺中市,大肚區,社腳里,292,1190,415,244,659,100,759
公投第１６案,臺中市,大肚區,社腳里,293,1250,389,257,646,99,745
公投第１６案,臺中市,大肚區,新興里,294,1310,420,279,699,82,781
公投第１６案,臺中市,大肚區,新興里,295,1294,491,166,657,79,736
公投第１６案,臺中市,大肚區,大東里,296,1734,576,404,980,103,1083
公投第１６案,臺中市,大肚區,大東里,297,1316,402,255,657,93,750
公投第１６案,臺中市,大肚區,大肚里,298,854,258,177,435,73,508
公投第１６案,臺中市,大肚區,大肚里,299,1273,463,288,751,62,813
公投第１６案,臺中市,大肚區,永和里,300,851,299,201,500,43,543
公投第１６案,臺中市,大肚區,磺溪里,301,1629,529,306,835,68,903
公投第１６案,臺中市,大肚區,永順里,302,1709,507,325,832,127,959
公投第１６案,臺中市,大肚區,成功里,303,953,267,188,455,54,509
公投第１６案,臺中市,大肚區,山陽里,304,1336,422,332,754,61,815
公投第１６案,臺中市,大肚區,頂街里,305,2113,609,415,1024,119,1143
公投第１６案,臺中市,大肚區,頂街里,306,1730,527,332,859,161,1020
公投第１６案,臺中市,大肚區,頂街里,307,1692,571,329,900,50,950
公投第１６案,臺中市,大肚區,頂街里,308,1747,576,357,933,56,989
公投第１６案,臺中市,大肚區,瑞井里,309,1672,527,307,834,101,935
公投第１６案,臺中市,大肚區,瑞井里,310,1675,467,351,818,68,886
公投第１６案,臺中市,大肚區,瑞井里,311,1673,520,325,845,94,939
公投第１６案,臺中市,大肚區,蔗廍里,312,1636,481,388,869,88,957
公投第１６案,臺中市,大肚區,蔗廍里,313,1753,497,325,822,121,943
公投第１６案,臺中市,大肚區,蔗廍里,314,1343,346,278,624,57,681
公投第１６案,臺中市,大肚區,自強里,315,1822,513,384,897,90,987
公投第１６案,臺中市,大肚區,自強里,316,1670,509,369,878,154,1032
公投第１６案,臺中市,烏日區,烏日里,317,1480,523,303,826,105,931
公投第１６案,臺中市,烏日區,烏日里,318,1841,592,415,1007,114,1121
公投第１６案,臺中市,烏日區,烏日里,319,1751,547,364,911,92,1003
公投第１６案,臺中市,烏日區,烏日里,320,1547,496,368,864,93,957
公投第１６案,臺中市,烏日區,烏日里,321,1836,616,386,1002,63,1065
公投第１６案,臺中市,烏日區,湖日里,322,1239,405,284,689,134,823
公投第１６案,臺中市,烏日區,湖日里,323,1295,378,275,653,94,747
公投第１６案,臺中市,烏日區,三和里,324,1263,370,245,615,99,714
公投第１６案,臺中市,烏日區,三和里,325,1622,475,378,853,53,906
公投第１６案,臺中市,烏日區,三和里,326,1822,559,362,921,109,1030
公投第１６案,臺中市,烏日區,榮泉里,327,1966,593,402,995,97,1092
公投第１６案,臺中市,烏日區,榮泉里,328,1615,520,358,878,68,946
公投第１６案,臺中市,烏日區,榮泉里,329,1232,399,292,691,60,751
公投第１６案,臺中市,烏日區,學田里,330,1347,405,294,699,45,744
公投第１６案,臺中市,烏日區,學田里,331,1165,337,232,569,55,624
公投第１６案,臺中市,烏日區,九德里,332,1664,573,355,928,62,990
公投第１６案,臺中市,烏日區,九德里,333,1230,368,295,663,77,740
公投第１６案,臺中市,烏日區,九德里,334,1574,521,350,871,117,988
公投第１６案,臺中市,烏日區,九德里,335,1452,511,334,845,68,913
公投第１６案,臺中市,烏日區,九德里,336,1879,547,338,885,100,985
公投第１６案,臺中市,烏日區,九德里,337,1601,483,344,827,76,903
公投第１６案,臺中市,烏日區,九德里,338,1546,528,336,864,85,949
公投第１６案,臺中市,烏日區,九德里,339,1866,497,363,860,74,934
公投第１６案,臺中市,烏日區,仁德里,340,1938,622,426,1048,99,1147
公投第１６案,臺中市,烏日區,仁德里,341,1759,560,364,924,109,1033
公投第１６案,臺中市,烏日區,仁德里,342,2061,651,383,1034,110,1144
公投第１６案,臺中市,烏日區,仁德里,343,1691,582,342,924,81,1005
公投第１６案,臺中市,烏日區,前竹里,344,1039,318,279,597,81,678
公投第１６案,臺中市,烏日區,前竹里,345,1221,392,278,670,63,733
公投第１６案,臺中市,烏日區,五光里,346,1650,533,363,896,110,1006
公投第１６案,臺中市,烏日區,光明里,347,937,307,207,514,63,577
公投第１６案,臺中市,烏日區,光明里,348,1220,409,274,683,43,726
公投第１６案,臺中市,烏日區,東園里,349,2139,584,304,888,179,1067
公投第１６案,臺中市,烏日區,溪埧里,350,1371,455,323,778,105,883
公投第１６案,臺中市,烏日區,溪埧里,351,1277,421,260,681,73,754
公投第１６案,臺中市,烏日區,溪埧里,352,1708,519,322,841,108,949
公投第１６案,臺中市,烏日區,螺潭里,353,2048,628,413,1041,115,1156
公投第１６案,臺中市,烏日區,北里里,354,1632,495,345,840,69,909
公投第１６案,臺中市,烏日區,南里里,355,1327,418,304,722,84,806
公投第１６案,臺中市,烏日區,溪尾里,356,854,221,188,409,89,498
公投第１６案,臺中市,后里區,廣福里,357,852,300,172,472,70,542
公投第１６案,臺中市,后里區,廣福里,358,1135,345,218,563,85,648
公投第１６案,臺中市,后里區,仁里里,359,1079,280,220,500,80,580
公投第１６案,臺中市,后里區,義里里,360,1539,547,286,833,82,915
公投第１６案,臺中市,后里區,義里里,361,1591,524,320,844,84,928
公投第１６案,臺中市,后里區,義德里,362,1376,393,254,647,67,714
公投第１６案,臺中市,后里區,義德里,363,1298,426,262,688,37,725
公投第１６案,臺中市,后里區,后里里,364,1428,451,297,748,104,852
公投第１６案,臺中市,后里區,后里里,365,1178,434,274,708,74,782
公投第１６案,臺中市,后里區,后里里,366,1095,374,241,615,40,655
公投第１６案,臺中市,后里區,厚里里,367,963,314,187,501,38,539
公投第１６案,臺中市,后里區,厚里里,368,1163,342,245,587,67,654
公投第１６案,臺中市,后里區,墩東里,369,1018,336,219,555,63,618
公投第１６案,臺中市,后里區,墩東里,370,854,295,198,493,61,554
公投第１６案,臺中市,后里區,墩東里,371,1485,456,280,736,77,813
公投第１６案,臺中市,后里區,墩東里,372,1355,502,276,778,77,855
公投第１６案,臺中市,后里區,墩西里,373,840,246,159,405,60,465
公投第１６案,臺中市,后里區,墩西里,374,1146,352,257,609,73,682
公投第１６案,臺中市,后里區,墩南里,375,1669,525,379,904,122,1026
公投第１６案,臺中市,后里區,墩南里,376,1673,535,375,910,131,1041
公投第１６案,臺中市,后里區,墩北里,377,1493,504,296,800,71,871
公投第１６案,臺中市,后里區,墩北里,378,1052,339,212,551,98,649
公投第１６案,臺中市,后里區,墩北里,379,909,281,163,444,39,483
公投第１６案,臺中市,后里區,中和里,380,1091,346,221,567,97,664
公投第１６案,臺中市,后里區,中和里,381,1342,410,264,674,152,826
公投第１６案,臺中市,后里區,舊社里,382,1138,286,230,516,129,645
公投第１６案,臺中市,后里區,舊社里,383,977,327,197,524,66,590
公投第１６案,臺中市,后里區,聯合里,384,1584,413,268,681,65,746
公投第１６案,臺中市,后里區,太平里,385,915,287,179,466,58,524
公投第１６案,臺中市,后里區,太平里,386,1225,379,261,640,100,740
公投第１６案,臺中市,后里區,眉山里,387,1552,474,299,773,82,855
公投第１６案,臺中市,后里區,眉山里,388,1600,495,319,814,61,875
公投第１６案,臺中市,后里區,月眉里,389,942,285,195,480,56,536
公投第１６案,臺中市,后里區,月眉里,390,943,277,207,484,44,528
公投第１６案,臺中市,后里區,公館里,391,1055,291,202,493,66,559
公投第１６案,臺中市,后里區,公館里,392,1067,331,219,550,80,630
公投第１６案,臺中市,后里區,泰安里,393,1340,354,261,615,96,711
公投第１６案,臺中市,豐原區,豐原里,394,983,297,201,498,65,563
公投第１６案,臺中市,豐原區,豐原里,395,1309,426,313,739,43,782
公投第１６案,臺中市,豐原區,豐榮里,396,1116,338,279,617,72,689
公投第１６案,臺中市,豐原區,頂街里,397,945,304,250,554,56,610
公投第１６案,臺中市,豐原區,中山里,398,850,244,217,461,83,544
公投第１６案,臺中市,豐原區,下街里,399,760,267,179,446,44,490
公投第１６案,臺中市,豐原區,中陽里,400,1617,545,345,890,2,892
公投第１６案,臺中市,豐原區,中陽里,401,1677,515,305,820,71,891
公投第１６案,臺中市,豐原區,中陽里,402,1771,681,390,1071,56,1127
公投第１６案,臺中市,豐原區,大湳里,403,1145,327,298,625,44,669
公投第１６案,臺中市,豐原區,大湳里,404,1362,413,290,703,66,769
公投第１６案,臺中市,豐原區,北湳里,405,1389,484,292,776,65,841
公投第１６案,臺中市,豐原區,北湳里,406,1530,521,331,852,85,937
公投第１６案,臺中市,豐原區,東湳里,407,1471,436,308,744,141,885
公投第１６案,臺中市,豐原區,東湳里,408,1410,438,328,766,102,868
公投第１６案,臺中市,豐原區,東湳里,409,1162,354,249,603,68,671
公投第１６案,臺中市,豐原區,西湳里,410,1656,508,381,889,64,953
公投第１６案,臺中市,豐原區,西湳里,411,1838,586,379,965,79,1044
公投第１６案,臺中市,豐原區,西湳里,412,1666,507,344,851,105,956
公投第１６案,臺中市,豐原區,西湳里,413,1821,605,380,985,108,1093
公投第１６案,臺中市,豐原區,西湳里,414,1821,675,439,1114,96,1210
公投第１６案,臺中市,豐原區,豐西里,415,1647,500,336,836,81,917
公投第１６案,臺中市,豐原區,圳寮里,416,1256,395,341,736,107,843
公投第１６案,臺中市,豐原區,豐圳里,417,1552,551,354,905,94,999
公投第１６案,臺中市,豐原區,豐圳里,418,1793,592,389,981,66,1047
公投第１６案,臺中市,豐原區,富春里,419,759,269,219,488,50,538
公投第１６案,臺中市,豐原區,葫蘆里,420,642,202,178,380,42,422
公投第１６案,臺中市,豐原區,西安里,421,1528,484,380,864,44,908
公投第１６案,臺中市,豐原區,西安里,422,1788,628,425,1053,89,1142
公投第１６案,臺中市,豐原區,西安里,423,1663,566,398,964,110,1074
公投第１６案,臺中市,豐原區,西勢里,424,1260,470,334,804,73,877
公投第１６案,臺中市,豐原區,西勢里,425,902,285,199,484,41,525
公投第１６案,臺中市,豐原區,中興里,426,1357,412,281,693,40,733
公投第１６案,臺中市,豐原區,中興里,427,1592,577,325,902,60,962
公投第１６案,臺中市,豐原區,社皮里,428,1873,626,382,1008,95,1103
公投第１６案,臺中市,豐原區,社皮里,429,1867,601,375,976,100,1076
公投第１６案,臺中市,豐原區,社皮里,430,1823,548,382,930,134,1064
公投第１６案,臺中市,豐原區,社皮里,431,1962,577,363,940,89,1029
公投第１６案,臺中市,豐原區,社皮里,432,2313,757,545,1302,116,1418
公投第１６案,臺中市,豐原區,三村里,433,1510,514,331,845,93,938
公投第１６案,臺中市,豐原區,三村里,434,1824,605,415,1020,78,1098
公投第１６案,臺中市,豐原區,三村里,435,1363,449,305,754,60,814
公投第１６案,臺中市,豐原區,三村里,436,1535,537,363,900,75,975
公投第１６案,臺中市,豐原區,東勢里,437,1457,474,357,831,84,915
公投第１６案,臺中市,豐原區,民生里,438,1184,361,305,666,66,732
公投第１６案,臺中市,豐原區,田心里,439,2299,635,401,1036,83,1119
公投第１６案,臺中市,豐原區,田心里,440,1940,936,107,1043,111,1154
公投第１６案,臺中市,豐原區,田心里,441,2067,653,440,1093,64,1157
公投第１６案,臺中市,豐原區,豐田里,442,2038,683,407,1090,71,1161
公投第１６案,臺中市,豐原區,豐田里,443,1835,543,442,985,72,1057
公投第１６案,臺中市,豐原區,豐田里,444,1979,622,421,1043,98,1141
公投第１６案,臺中市,豐原區,豐田里,445,2014,647,379,1026,135,1161
公投第１６案,臺中市,豐原區,豐田里,446,2257,739,474,1213,107,1320
公投第１６案,臺中市,豐原區,鎌村里,447,1406,484,316,800,87,887
公投第１６案,臺中市,豐原區,鎌村里,448,1418,467,341,808,56,864
公投第１６案,臺中市,豐原區,鎌村里,449,1772,625,405,1030,92,1122
公投第１６案,臺中市,豐原區,陽明里,450,1202,422,293,715,54,769
公投第１６案,臺中市,豐原區,陽明里,451,1447,501,352,853,46,899
公投第１６案,臺中市,豐原區,南陽里,452,1758,571,398,969,117,1086
公投第１６案,臺中市,豐原區,南陽里,453,1546,538,365,903,84,987
公投第１６案,臺中市,豐原區,南陽里,454,1815,654,379,1033,94,1127
公投第１６案,臺中市,豐原區,南陽里,455,1932,650,439,1089,82,1171
公投第１６案,臺中市,豐原區,南陽里,456,1770,625,438,1063,73,1136
公投第１６案,臺中市,豐原區,南陽里,457,1560,495,318,813,56,869
公投第１６案,臺中市,豐原區,北陽里,458,1810,611,354,965,90,1055
公投第１６案,臺中市,豐原區,北陽里,459,1653,574,382,956,89,1045
公投第１６案,臺中市,豐原區,北陽里,460,1444,465,319,784,74,858
公投第１６案,臺中市,豐原區,北陽里,461,1318,466,317,783,56,839
公投第１６案,臺中市,豐原區,北陽里,462,1566,516,333,849,105,954
公投第１６案,臺中市,豐原區,北陽里,463,1748,591,349,940,76,1016
公投第１６案,臺中市,豐原區,北陽里,464,1772,493,352,845,112,957
公投第１６案,臺中市,豐原區,北陽里,465,1721,536,370,906,116,1022
公投第１６案,臺中市,豐原區,東陽里,466,1578,517,369,886,66,952
公投第１６案,臺中市,豐原區,南村里,467,1859,585,371,956,131,1087
公投第１６案,臺中市,豐原區,南村里,468,1479,457,346,803,70,873
公投第１６案,臺中市,豐原區,南村里,469,1889,627,408,1035,68,1103
公投第１６案,臺中市,豐原區,南田里,470,1803,600,352,952,81,1033
公投第１６案,臺中市,豐原區,南田里,471,1421,448,272,720,87,807
公投第１６案,臺中市,豐原區,南嵩里,472,1585,554,354,908,96,1004
公投第１６案,臺中市,豐原區,南嵩里,473,1774,647,359,1006,108,1114
公投第１６案,臺中市,豐原區,翁明里,474,2132,669,483,1152,106,1258
公投第１６案,臺中市,豐原區,翁子里,475,1515,466,352,818,90,908
公投第１６案,臺中市,豐原區,翁子里,476,1359,382,279,661,51,712
公投第１６案,臺中市,豐原區,翁社里,477,948,322,242,564,38,602
公投第１６案,臺中市,豐原區,翁社里,478,1134,377,259,636,78,714
公投第１６案,臺中市,豐原區,朴子里,479,1114,407,262,669,79,748
公投第１６案,臺中市,豐原區,朴子里,480,1050,324,240,564,76,640
公投第１６案,臺中市,豐原區,朴子里,481,1182,427,263,690,84,774
公投第１６案,臺中市,神岡區,神岡里,482,1684,558,351,909,93,1002
公投第１６案,臺中市,神岡區,神岡里,483,1559,491,355,846,75,921
公投第１６案,臺中市,神岡區,庄前里,484,1095,329,233,562,63,625
公投第１６案,臺中市,神岡區,庄前里,485,1044,363,295,658,50,708
公投第１６案,臺中市,神岡區,北庄里,486,1310,441,299,740,115,855
公投第１６案,臺中市,神岡區,北庄里,487,1294,414,300,714,114,828
公投第１６案,臺中市,神岡區,庄後里,488,1143,348,272,620,67,687
公投第１６案,臺中市,神岡區,庄後里,489,1022,322,227,549,85,634
公投第１６案,臺中市,神岡區,圳前里,490,1269,372,249,621,80,701
公投第１６案,臺中市,神岡區,圳前里,491,1085,298,173,471,44,515
公投第１６案,臺中市,神岡區,圳堵里,492,942,310,217,527,65,592
公投第１６案,臺中市,神岡區,圳堵里,493,1154,330,247,577,71,648
公投第１６案,臺中市,神岡區,新庄里,494,1390,389,296,685,86,771
公投第１６案,臺中市,神岡區,新庄里,495,1372,418,326,744,123,867
公投第１６案,臺中市,神岡區,新庄里,496,1328,391,265,656,42,698
公投第１６案,臺中市,神岡區,山皮里,497,1038,313,230,543,32,575
公投第１６案,臺中市,神岡區,社口里,498,1452,432,299,731,71,802
公投第１６案,臺中市,神岡區,社口里,499,1551,519,359,878,82,960
公投第１６案,臺中市,神岡區,社口里,500,1567,456,315,771,90,861
公投第１６案,臺中市,神岡區,社口里,501,1449,450,352,802,43,845
公投第１６案,臺中市,神岡區,社口里,502,1246,334,269,603,42,645
公投第１６案,臺中市,神岡區,社南里,503,1431,454,301,755,95,850
公投第１６案,臺中市,神岡區,社南里,504,1163,363,281,644,91,735
公投第１６案,臺中市,神岡區,社南里,505,1402,464,344,808,101,909
公投第１６案,臺中市,神岡區,社南里,506,1271,408,275,683,71,754
公投第１６案,臺中市,神岡區,三角里,507,1198,385,256,641,90,731
公投第１６案,臺中市,神岡區,三角里,508,1312,410,279,689,101,790
公投第１６案,臺中市,神岡區,大社里,509,1590,454,332,786,117,903
公投第１６案,臺中市,神岡區,大社里,510,1324,397,284,681,47,728
公投第１６案,臺中市,神岡區,大社里,511,1415,426,266,692,76,768
公投第１６案,臺中市,神岡區,岸裡里,512,1483,493,347,840,100,940
公投第１６案,臺中市,神岡區,岸裡里,513,1402,366,298,664,71,735
公投第１６案,臺中市,神岡區,豐洲里,514,1275,399,236,635,76,711
公投第１６案,臺中市,神岡區,豐洲里,515,1288,380,270,650,61,711
公投第１６案,臺中市,神岡區,豐洲里,516,1080,308,216,524,89,613
公投第１６案,臺中市,神岡區,豐洲里,517,1344,392,294,686,53,739
公投第１６案,臺中市,神岡區,豐洲里,518,1061,317,285,602,65,667
公投第１６案,臺中市,神岡區,豐洲里,519,1176,400,286,686,57,743
公投第１６案,臺中市,神岡區,神洲里,520,1244,400,285,685,95,780
公投第１６案,臺中市,神岡區,神洲里,521,1318,423,331,754,98,852
公投第１６案,臺中市,神岡區,溪洲里,522,1471,409,313,722,16,738
公投第１６案,臺中市,神岡區,溪洲里,523,1323,453,327,780,97,877
公投第１６案,臺中市,大雅區,上雅里,524,2027,656,420,1076,88,1164
公投第１６案,臺中市,大雅區,上雅里,525,1967,545,379,924,79,1003
公投第１６案,臺中市,大雅區,上雅里,526,1912,609,354,963,63,1026
公投第１６案,臺中市,大雅區,大雅里,527,1537,529,336,865,74,939
公投第１６案,臺中市,大雅區,大雅里,528,1439,465,331,796,83,879
公投第１６案,臺中市,大雅區,大雅里,529,1402,427,310,737,99,836
公投第１６案,臺中市,大雅區,文雅里,530,2013,626,406,1032,75,1107
公投第１６案,臺中市,大雅區,文雅里,531,1917,615,405,1020,104,1124
公投第１６案,臺中市,大雅區,文雅里,532,2011,620,416,1036,66,1102
公投第１６案,臺中市,大雅區,三和里,533,1887,649,366,1015,76,1091
公投第１６案,臺中市,大雅區,三和里,534,1480,475,348,823,78,901
公投第１６案,臺中市,大雅區,三和里,535,1816,593,367,960,84,1044
公投第１６案,臺中市,大雅區,二和里,536,1898,503,349,852,132,984
公投第１６案,臺中市,大雅區,二和里,537,2008,654,394,1048,100,1148
公投第１６案,臺中市,大雅區,二和里,538,1976,645,418,1063,86,1149
公投第１６案,臺中市,大雅區,四德里,539,1673,517,351,868,109,977
公投第１６案,臺中市,大雅區,四德里,540,1409,494,311,805,71,876
公投第１６案,臺中市,大雅區,四德里,541,1382,181,598,779,33,812
公投第１６案,臺中市,大雅區,西寶里,542,1635,489,339,828,105,933
公投第１６案,臺中市,大雅區,西寶里,543,1565,557,313,870,75,945
公投第１６案,臺中市,大雅區,西寶里,544,1528,481,287,768,65,833
公投第１６案,臺中市,大雅區,上楓里,545,1963,600,375,975,65,1040
公投第１６案,臺中市,大雅區,上楓里,546,2073,595,392,987,83,1070
公投第１６案,臺中市,大雅區,上楓里,547,1984,580,402,982,121,1103
公投第１６案,臺中市,大雅區,大楓里,548,1688,530,345,875,66,941
公投第１６案,臺中市,大雅區,大楓里,549,1387,416,321,737,67,804
公投第１６案,臺中市,大雅區,大楓里,550,1701,544,340,884,149,1033
公投第１６案,臺中市,大雅區,雅楓里,551,1721,544,338,882,97,979
公投第１６案,臺中市,大雅區,雅楓里,552,1879,483,304,787,81,868
公投第１６案,臺中市,大雅區,員林里,553,1568,559,348,907,82,989
公投第１６案,臺中市,大雅區,員林里,554,1761,507,403,910,117,1027
公投第１６案,臺中市,大雅區,員林里,555,1752,565,359,924,146,1070
公投第１６案,臺中市,大雅區,員林里,556,1264,407,294,701,57,758
公投第１６案,臺中市,大雅區,員林里,557,1302,418,323,741,73,814
公投第１６案,臺中市,大雅區,員林里,558,1449,464,282,746,87,833
公投第１６案,臺中市,大雅區,六寶里,559,1621,560,318,878,147,1025
公投第１６案,臺中市,大雅區,六寶里,560,1647,486,322,808,116,924
公投第１６案,臺中市,大雅區,六寶里,561,1441,446,296,742,49,791
公投第１６案,臺中市,大雅區,六寶里,562,1460,477,270,747,50,797
公投第１６案,臺中市,大雅區,秀山里,563,1832,602,440,1042,99,1141
公投第１６案,臺中市,大雅區,秀山里,564,1371,467,310,777,95,872
公投第１６案,臺中市,大雅區,橫山里,565,1418,403,275,678,14,692
公投第１６案,臺中市,大雅區,橫山里,566,1473,503,315,818,69,887
公投第１６案,臺中市,大雅區,橫山里,567,1335,414,300,714,78,792
公投第１６案,臺中市,大雅區,忠義里,568,1733,617,254,871,108,979
公投第１６案,臺中市,大雅區,忠義里,569,1884,599,234,833,129,962
公投第１６案,臺中市,潭子區,潭秀里,570,1306,408,305,713,82,795
公投第１６案,臺中市,潭子區,潭北里,571,1128,361,272,633,56,689
公投第１６案,臺中市,潭子區,潭北里,572,1159,358,295,653,74,727
公投第１６案,臺中市,潭子區,潭陽里,573,1630,542,355,897,107,1004
公投第１６案,臺中市,潭子區,潭陽里,574,1532,496,327,823,56,879
公投第１６案,臺中市,潭子區,潭陽里,575,1677,460,339,799,72,871
公投第１６案,臺中市,潭子區,潭陽里,576,1744,490,346,836,89,925
公投第１６案,臺中市,潭子區,潭陽里,577,1795,572,393,965,68,1033
公投第１６案,臺中市,潭子區,潭陽里,578,1171,377,235,612,62,674
公投第１６案,臺中市,潭子區,潭陽里,579,1427,476,282,758,57,815
公投第１６案,臺中市,潭子區,福仁里,580,1709,573,341,914,67,981
公投第１６案,臺中市,潭子區,福仁里,581,1723,559,334,893,75,968
公投第１６案,臺中市,潭子區,福仁里,582,1782,552,360,912,73,985
公投第１６案,臺中市,潭子區,福仁里,583,1407,439,274,713,55,768
公投第１６案,臺中市,潭子區,福仁里,584,1771,587,377,964,58,1022
公投第１６案,臺中市,潭子區,福仁里,585,1795,617,368,985,99,1084
公投第１６案,臺中市,潭子區,頭家里,586,1612,555,369,924,89,1013
公投第１６案,臺中市,潭子區,頭家里,587,1894,598,387,985,56,1041
公投第１６案,臺中市,潭子區,頭家里,588,1689,555,333,888,72,960
公投第１６案,臺中市,潭子區,頭家東里,589,1525,437,280,717,92,809
公投第１６案,臺中市,潭子區,頭家東里,590,1622,484,358,842,67,909
公投第１６案,臺中市,潭子區,頭家東里,591,1200,385,261,646,77,723
公投第１６案,臺中市,潭子區,家興里,592,1355,408,274,682,35,717
公投第１６案,臺中市,潭子區,家興里,593,1777,546,365,911,64,975
公投第１６案,臺中市,潭子區,家興里,594,1923,634,402,1036,63,1099
公投第１６案,臺中市,潭子區,家興里,595,1674,508,314,822,89,911
公投第１６案,臺中市,潭子區,家福里,596,1451,488,344,832,80,912
公投第１６案,臺中市,潭子區,家福里,597,1486,468,322,790,75,865
公投第１６案,臺中市,潭子區,家福里,598,1511,496,356,852,60,912
公投第１６案,臺中市,潭子區,甘蔗里,599,1666,594,320,914,80,994
公投第１６案,臺中市,潭子區,甘蔗里,600,1750,578,353,931,53,984
公投第１６案,臺中市,潭子區,甘蔗里,601,1437,447,299,746,64,810
公投第１６案,臺中市,潭子區,甘蔗里,602,1735,598,305,903,70,973
公投第１６案,臺中市,潭子區,甘蔗里,603,1612,520,318,838,72,910
公投第１６案,臺中市,潭子區,甘蔗里,604,1143,415,249,664,41,705
公投第１６案,臺中市,潭子區,東寶里,605,2096,659,413,1072,54,1126
公投第１６案,臺中市,潭子區,東寶里,606,1549,612,240,852,89,941
公投第１６案,臺中市,潭子區,東寶里,607,1573,495,363,858,40,898
公投第１６案,臺中市,潭子區,東寶里,608,1585,518,281,799,48,847
公投第１６案,臺中市,潭子區,東寶里,609,1572,518,314,832,52,884
公投第１６案,臺中市,潭子區,東寶里,610,1738,619,342,961,77,1038
公投第１６案,臺中市,潭子區,東寶里,611,1883,578,369,947,100,1047
公投第１６案,臺中市,潭子區,大富里,612,1401,419,310,729,68,797
公投第１６案,臺中市,潭子區,大富里,613,1352,459,289,748,86,834
公投第１６案,臺中市,潭子區,大豐里,614,2085,698,418,1116,121,1237
公投第１６案,臺中市,潭子區,大豐里,615,2047,683,425,1108,133,1241
公投第１６案,臺中市,潭子區,大豐里,616,1673,498,346,844,46,890
公投第１６案,臺中市,潭子區,栗林里,617,1874,581,409,990,66,1056
公投第１６案,臺中市,潭子區,栗林里,618,1051,322,245,567,66,633
公投第１６案,臺中市,潭子區,栗林里,619,1674,483,346,829,56,885
公投第１６案,臺中市,潭子區,嘉仁里,620,1831,585,422,1007,74,1081
公投第１６案,臺中市,潭子區,嘉仁里,621,2003,600,391,991,99,1090
公投第１６案,臺中市,潭子區,新田里,622,1535,476,283,759,74,833
公投第１６案,臺中市,潭子區,聚興里,623,2286,631,379,1010,159,1169
公投第１６案,臺中市,潭子區,聚興里,624,1861,554,360,914,84,998
公投第１６案,臺中市,西屯區,西安里,625,1638,539,379,918,105,1023
公投第１６案,臺中市,西屯區,西安里,626,1335,402,275,677,56,733
公投第１６案,臺中市,西屯區,西安里,627,1776,605,364,969,71,1040
公投第１６案,臺中市,西屯區,至善里,628,1351,445,279,724,50,774
公投第１６案,臺中市,西屯區,至善里,629,1338,466,298,764,53,817
公投第１６案,臺中市,西屯區,至善里,630,1582,562,289,851,67,918
公投第１６案,臺中市,西屯區,西平里,631,1710,568,271,839,66,905
公投第１６案,臺中市,西屯區,西平里,632,1595,482,297,779,73,852
公投第１６案,臺中市,西屯區,西平里,633,1585,547,287,834,101,935
公投第１６案,臺中市,西屯區,西墩里,634,1749,508,343,851,113,964
公投第１６案,臺中市,西屯區,西墩里,635,1877,639,350,989,103,1092
公投第１６案,臺中市,西屯區,西墩里,636,1697,503,373,876,51,927
公投第１６案,臺中市,西屯區,潮洋里,637,1480,495,352,847,60,907
公投第１６案,臺中市,西屯區,潮洋里,638,1483,524,360,884,85,969
公投第１６案,臺中市,西屯區,潮洋里,639,2484,515,328,843,60,903
公投第１６案,臺中市,西屯區,龍潭里,640,781,283,173,456,68,524
公投第１６案,臺中市,西屯區,惠來里,641,1477,539,297,836,59,895
公投第１６案,臺中市,西屯區,惠來里,642,1784,550,391,941,60,1001
公投第１６案,臺中市,西屯區,惠來里,643,1686,570,342,912,54,966
公投第１６案,臺中市,西屯區,惠來里,644,1692,574,343,917,56,973
公投第１６案,臺中市,西屯區,惠來里,645,1659,570,279,849,52,901
公投第１６案,臺中市,西屯區,惠來里,646,1648,476,420,896,52,948
公投第１６案,臺中市,西屯區,惠來里,647,1536,552,333,885,61,946
公投第１６案,臺中市,西屯區,惠來里,648,1666,538,382,920,77,997
公投第１６案,臺中市,西屯區,上石里,649,1428,480,302,782,66,848
公投第１６案,臺中市,西屯區,上石里,650,1810,555,369,924,70,994
公投第１６案,臺中市,西屯區,上石里,651,1574,491,344,835,59,894
公投第１６案,臺中市,西屯區,上安里,652,1650,553,336,889,47,936
公投第１６案,臺中市,西屯區,上安里,653,1681,544,342,886,91,977
公投第１６案,臺中市,西屯區,上安里,654,1656,522,323,845,77,922
公投第１６案,臺中市,西屯區,上德里,655,1243,408,254,662,97,759
公投第１６案,臺中市,西屯區,上德里,656,1471,535,336,871,78,949
公投第１６案,臺中市,西屯區,上德里,657,1431,528,317,845,51,896
公投第１６案,臺中市,西屯區,逢甲里,658,1714,540,358,898,80,978
公投第１６案,臺中市,西屯區,逢甲里,659,1424,475,277,752,88,840
公投第１６案,臺中市,西屯區,逢甲里,660,1176,367,269,636,65,701
公投第１６案,臺中市,西屯區,逢福里,661,1456,477,304,781,102,883
公投第１６案,臺中市,西屯區,逢福里,662,1451,543,306,849,67,916
公投第１６案,臺中市,西屯區,逢福里,663,1063,406,242,648,49,697
公投第１６案,臺中市,西屯區,逢福里,664,1357,426,305,731,68,799
公投第１６案,臺中市,西屯區,鵬程里,665,1355,493,248,741,99,840
公投第１６案,臺中市,西屯區,鵬程里,666,1384,559,247,806,48,854
公投第１６案,臺中市,西屯區,何厝里,667,1613,639,250,889,78,967
公投第１６案,臺中市,西屯區,何厝里,668,1562,512,315,827,74,901
公投第１６案,臺中市,西屯區,何明里,669,1219,418,297,715,86,801
公投第１６案,臺中市,西屯區,何明里,670,1235,373,282,655,65,720
公投第１６案,臺中市,西屯區,何明里,671,1131,330,273,603,78,681
公投第１６案,臺中市,西屯區,何南里,672,1494,537,333,870,69,939
公投第１６案,臺中市,西屯區,何南里,673,1325,434,263,697,80,777
公投第１６案,臺中市,西屯區,何南里,674,1386,447,323,770,62,832
公投第１６案,臺中市,西屯區,何成里,675,1816,615,358,973,99,1072
公投第１６案,臺中市,西屯區,何成里,676,1734,538,336,874,61,935
公投第１６案,臺中市,西屯區,何成里,677,1777,577,384,961,91,1052
公投第１６案,臺中市,西屯區,何成里,678,1818,559,352,911,84,995
公投第１６案,臺中市,西屯區,何安里,679,1699,568,295,863,104,967
公投第１６案,臺中市,西屯區,何安里,680,1715,491,341,832,58,890
公投第１６案,臺中市,西屯區,何安里,681,1654,533,322,855,45,900
公投第１６案,臺中市,西屯區,何仁里,682,1636,560,285,845,47,892
公投第１６案,臺中市,西屯區,何仁里,683,1298,371,293,664,53,717
公投第１６案,臺中市,西屯區,何仁里,684,1391,154,597,751,87,838
公投第１６案,臺中市,西屯區,何仁里,685,1853,605,398,1003,88,1091
公投第１６案,臺中市,西屯區,何德里,686,1820,569,345,914,96,1010
公投第１６案,臺中市,西屯區,何德里,687,1809,577,395,972,81,1053
公投第１６案,臺中市,西屯區,何福里,688,1352,463,311,774,72,846
公投第１６案,臺中市,西屯區,何福里,689,1521,479,300,779,103,882
公投第１６案,臺中市,西屯區,何福里,690,1486,496,364,860,49,909
公投第１６案,臺中市,西屯區,何源里,691,1674,530,330,860,88,948
公投第１６案,臺中市,西屯區,何源里,692,1610,563,359,922,85,1007
公投第１６案,臺中市,西屯區,何源里,693,1695,570,354,924,67,991
公投第１６案,臺中市,西屯區,何源里,694,1684,587,285,872,77,949
公投第１６案,臺中市,西屯區,大河里,695,1221,395,298,693,48,741
公投第１６案,臺中市,西屯區,大河里,696,1252,460,317,777,77,854
公投第１６案,臺中市,西屯區,大河里,697,1301,417,312,729,84,813
公投第１６案,臺中市,西屯區,大石里,698,1049,401,216,617,53,670
公投第１６案,臺中市,西屯區,大石里,699,1113,408,197,605,70,675
公投第１６案,臺中市,西屯區,大福里,700,1557,482,284,766,91,857
公投第１６案,臺中市,西屯區,大福里,701,1640,512,312,824,88,912
公投第１６案,臺中市,西屯區,大鵬里,702,1402,471,353,824,112,936
公投第１６案,臺中市,西屯區,大鵬里,703,1717,496,312,808,99,907
公投第１６案,臺中市,西屯區,大鵬里,704,1688,442,341,783,100,883
公投第１６案,臺中市,西屯區,港尾里,705,1168,321,250,571,147,718
公投第１６案,臺中市,西屯區,港尾里,706,1729,519,345,864,79,943
公投第１６案,臺中市,西屯區,港尾里,707,2007,609,361,970,92,1062
公投第１６案,臺中市,西屯區,廣福里,708,1296,420,266,686,113,799
公投第１６案,臺中市,西屯區,廣福里,709,1068,287,201,488,49,537
公投第１６案,臺中市,西屯區,林厝里,710,1707,480,288,768,140,908
公投第１６案,臺中市,西屯區,林厝里,711,1636,555,348,903,75,978
公投第１６案,臺中市,西屯區,永安里,712,1761,478,302,780,71,851
公投第１６案,臺中市,西屯區,永安里,713,1314,394,287,681,87,768
公投第１６案,臺中市,西屯區,永安里,714,1233,445,276,721,66,787
公投第１６案,臺中市,西屯區,永安里,715,1549,472,316,788,68,856
公投第１６案,臺中市,西屯區,永安里,716,1639,525,292,817,55,872
公投第１６案,臺中市,西屯區,永安里,717,1486,432,305,737,80,817
公投第１６案,臺中市,西屯區,永安里,718,1806,563,369,932,54,986
公投第１６案,臺中市,西屯區,永安里,719,1451,469,287,756,36,792
公投第１６案,臺中市,西屯區,福安里,720,1302,422,287,709,62,771
公投第１６案,臺中市,西屯區,福安里,721,1353,503,272,775,72,847
公投第１６案,臺中市,西屯區,福雅里,722,2162,739,438,1177,84,1261
公投第１６案,臺中市,西屯區,福雅里,723,1520,491,338,829,40,869
公投第１６案,臺中市,西屯區,福雅里,724,1935,607,393,1000,58,1058
公投第１６案,臺中市,西屯區,福林里,725,1847,599,349,948,85,1033
公投第１６案,臺中市,西屯區,福林里,726,1738,591,373,964,45,1009
公投第１６案,臺中市,西屯區,福林里,727,1640,563,363,926,81,1007
公投第１６案,臺中市,西屯區,福林里,728,1908,656,386,1042,58,1100
公投第１６案,臺中市,西屯區,福瑞里,729,1402,475,284,759,56,815
公投第１６案,臺中市,西屯區,福瑞里,730,1515,458,288,746,67,813
公投第１６案,臺中市,西屯區,福聯里,731,1541,420,266,686,56,742
公投第１６案,臺中市,西屯區,福聯里,732,1502,473,298,771,64,835
公投第１６案,臺中市,西屯區,福和里,733,1526,472,338,810,120,930
公投第１６案,臺中市,西屯區,福和里,734,1425,454,322,776,98,874
公投第１６案,臺中市,西屯區,福和里,735,1334,454,308,762,57,819
公投第１６案,臺中市,西屯區,福中里,736,1649,537,383,920,75,995
公投第１６案,臺中市,西屯區,福中里,737,1566,479,300,779,70,849
公投第１６案,臺中市,西屯區,福恩里,738,1629,553,377,930,65,995
公投第１６案,臺中市,西屯區,福恩里,739,1628,579,329,908,57,965
公投第１６案,臺中市,西屯區,福恩里,740,1442,527,301,828,61,889
公投第１６案,臺中市,西屯區,協和里,741,1206,351,254,605,67,672
公投第１６案,臺中市,西屯區,協和里,742,1086,341,255,596,91,687
公投第１６案,臺中市,西屯區,協和里,743,1088,358,249,607,73,680
公投第１６案,臺中市,西屯區,協和里,744,1140,395,235,630,47,677
公投第１６案,臺中市,南屯區,南屯里,745,1321,460,267,727,79,806
公投第１６案,臺中市,南屯區,南屯里,746,1346,419,341,760,83,843
公投第１６案,臺中市,南屯區,南屯里,747,1428,463,329,792,70,862
公投第１６案,臺中市,南屯區,南屯里,748,1442,487,288,775,53,828
公投第１６案,臺中市,南屯區,南屯里,749,1408,513,356,869,40,909
公投第１６案,臺中市,南屯區,南屯里,750,1404,486,328,814,47,861
公投第１６案,臺中市,南屯區,豐樂里,751,1354,489,319,808,54,862
公投第１６案,臺中市,南屯區,豐樂里,752,1332,466,300,766,70,836
公投第１６案,臺中市,南屯區,豐樂里,753,1463,499,361,860,65,925
公投第１６案,臺中市,南屯區,豐樂里,754,1413,467,310,777,80,857
公投第１６案,臺中市,南屯區,豐樂里,755,1218,455,296,751,33,784
公投第１６案,臺中市,南屯區,豐樂里,756,1308,386,299,685,58,743
公投第１６案,臺中市,南屯區,豐樂里,757,1527,504,374,878,82,960
公投第１６案,臺中市,南屯區,豐樂里,758,1294,460,291,751,59,810
公投第１６案,臺中市,南屯區,楓樹里,759,1516,448,289,737,76,813
公投第１６案,臺中市,南屯區,楓樹里,760,1529,490,318,808,147,955
公投第１６案,臺中市,南屯區,楓樹里,761,1397,453,329,782,78,860
公投第１６案,臺中市,南屯區,楓樹里,762,1406,357,380,737,54,791
公投第１６案,臺中市,南屯區,中和里,763,1497,435,307,742,85,827
公投第１６案,臺中市,南屯區,中和里,764,1424,419,298,717,101,818
公投第１６案,臺中市,南屯區,中和里,765,1488,401,244,645,84,729
公投第１６案,臺中市,南屯區,鎮平里,766,608,210,143,353,54,407
公投第１６案,臺中市,南屯區,鎮平里,767,813,254,185,439,91,530
公投第１６案,臺中市,南屯區,春社里,768,1190,373,273,646,87,733
公投第１６案,臺中市,南屯區,春社里,769,1174,360,266,626,41,667
公投第１６案,臺中市,南屯區,春社里,770,1224,415,273,688,14,702
公投第１６案,臺中市,南屯區,春社里,771,1466,409,245,654,66,720
公投第１６案,臺中市,南屯區,春社里,772,1333,314,120,434,39,473
公投第１６案,臺中市,南屯區,春安里,773,814,279,171,450,72,522
公投第１６案,臺中市,南屯區,文山里,774,1436,439,252,691,103,794
公投第１６案,臺中市,南屯區,文山里,775,1515,496,317,813,94,907
公投第１６案,臺中市,南屯區,文山里,776,1545,404,273,677,122,799
公投第１６案,臺中市,南屯區,文山里,777,1383,446,298,744,70,814
公投第１６案,臺中市,南屯區,文山里,778,1433,381,424,805,61,866
公投第１６案,臺中市,南屯區,文山里,779,1134,304,265,569,55,624
公投第１６案,臺中市,南屯區,文山里,780,1216,399,306,705,56,761
公投第１６案,臺中市,南屯區,寶山里,781,1271,394,243,637,99,736
公投第１６案,臺中市,南屯區,寶山里,782,1203,341,262,603,62,665
公投第１６案,臺中市,南屯區,寶山里,783,1268,420,266,686,56,742
公投第１６案,臺中市,南屯區,寶山里,784,1390,446,302,748,85,833
公投第１６案,臺中市,南屯區,新生里,785,1397,425,309,734,77,811
公投第１６案,臺中市,南屯區,永定里,786,1607,472,357,829,94,923
公投第１６案,臺中市,南屯區,永定里,787,1582,542,336,878,68,946
公投第１６案,臺中市,南屯區,永定里,788,1611,561,361,922,51,973
公投第１６案,臺中市,南屯區,三厝里,789,1322,488,287,775,66,841
公投第１６案,臺中市,南屯區,三厝里,790,1321,493,303,796,67,863
公投第１６案,臺中市,南屯區,三厝里,791,1360,458,302,760,55,815
公投第１６案,臺中市,南屯區,三厝里,792,1361,482,308,790,34,824
公投第１６案,臺中市,南屯區,三厝里,793,1257,456,273,729,56,785
公投第１６案,臺中市,南屯區,三義里,794,1207,429,302,731,53,784
公投第１６案,臺中市,南屯區,三義里,795,1282,400,378,778,42,820
公投第１６案,臺中市,南屯區,三義里,796,1248,477,294,771,50,821
公投第１６案,臺中市,南屯區,三義里,797,1304,475,318,793,60,853
公投第１６案,臺中市,南屯區,三義里,798,1214,424,279,703,42,745
公投第１６案,臺中市,南屯區,三和里,799,1102,382,255,637,74,711
公投第１６案,臺中市,南屯區,三和里,800,1630,691,301,992,61,1053
公投第１６案,臺中市,南屯區,三和里,801,1333,494,291,785,47,832
公投第１６案,臺中市,南屯區,三和里,802,1292,448,316,764,56,820
公投第１６案,臺中市,南屯區,三和里,803,1272,443,275,718,70,788
公投第１６案,臺中市,南屯區,三和里,804,1345,489,287,776,49,825
公投第１６案,臺中市,南屯區,黎明里,805,981,338,229,567,125,692
公投第１６案,臺中市,南屯區,黎明里,806,1097,393,235,628,75,703
公投第１６案,臺中市,南屯區,黎明里,807,991,404,207,611,39,650
公投第１６案,臺中市,南屯區,黎明里,808,1170,416,249,665,50,715
公投第１６案,臺中市,南屯區,溝墘里,809,1171,413,291,704,48,752
公投第１６案,臺中市,南屯區,溝墘里,810,1349,442,289,731,83,814
公投第１６案,臺中市,南屯區,溝墘里,811,1368,504,324,828,46,874
公投第１６案,臺中市,南屯區,溝墘里,812,1263,469,293,762,57,819
公投第１６案,臺中市,南屯區,大業里,813,1547,558,341,899,73,972
公投第１６案,臺中市,南屯區,大業里,814,1649,564,337,901,96,997
公投第１６案,臺中市,南屯區,大業里,815,1629,563,299,862,63,925
公投第１６案,臺中市,南屯區,大業里,816,1580,454,317,771,85,856
公投第１６案,臺中市,南屯區,惠中里,817,1444,534,351,885,61,946
公投第１６案,臺中市,南屯區,惠中里,818,1413,479,298,777,47,824
公投第１６案,臺中市,南屯區,惠中里,819,1377,446,291,737,72,809
公投第１６案,臺中市,南屯區,惠中里,820,1527,528,351,879,48,927
公投第１６案,臺中市,南屯區,惠中里,821,1335,491,288,779,63,842
公投第１６案,臺中市,南屯區,田心里,822,1544,562,421,983,52,1035
公投第１６案,臺中市,南屯區,田心里,823,1482,488,409,897,74,971
公投第１６案,臺中市,南屯區,田心里,824,1488,494,327,821,107,928
公投第１６案,臺中市,南屯區,田心里,825,1538,449,288,737,76,813
公投第１６案,臺中市,南屯區,向心里,826,1674,580,396,976,83,1059
公投第１６案,臺中市,南屯區,向心里,827,1996,501,291,792,71,863
公投第１６案,臺中市,南屯區,向心里,828,1514,527,297,824,100,924
公投第１６案,臺中市,南屯區,文心里,829,1217,437,263,700,90,790
公投第１６案,臺中市,南屯區,文心里,830,1347,438,306,744,62,806
公投第１６案,臺中市,南屯區,文心里,831,1109,406,229,635,57,692
公投第１６案,臺中市,南屯區,同心里,832,1546,503,343,846,52,898
公投第１６案,臺中市,南屯區,同心里,833,1408,501,337,838,68,906
公投第１６案,臺中市,南屯區,同心里,834,1057,314,227,541,48,589
公投第１６案,臺中市,南屯區,同心里,835,1133,375,257,632,62,694
公投第１６案,臺中市,南屯區,大同里,836,1278,439,269,708,66,774
公投第１６案,臺中市,南屯區,大同里,837,1144,399,291,690,66,756
公投第１６案,臺中市,南屯區,大同里,838,1140,373,271,644,60,704
公投第１６案,臺中市,南屯區,大同里,839,1171,421,265,686,52,738
公投第１６案,臺中市,南屯區,大興里,840,1303,468,316,784,52,836
公投第１６案,臺中市,南屯區,大興里,841,1402,419,309,728,59,787
公投第１６案,臺中市,南屯區,大興里,842,1571,521,326,847,74,921
公投第１６案,臺中市,南屯區,大誠里,843,1139,394,294,688,48,736
公投第１６案,臺中市,南屯區,大誠里,844,1216,412,314,726,56,782
公投第１６案,臺中市,南屯區,大誠里,845,1162,439,254,693,48,741
公投第１６案,臺中市,北屯區,北屯里,846,1670,617,353,970,93,1063
公投第１６案,臺中市,北屯區,北屯里,847,1706,526,311,837,95,932
公投第１６案,臺中市,北屯區,北京里,848,1507,488,270,758,98,856
公投第１６案,臺中市,北屯區,北京里,849,1652,572,333,905,81,986
公投第１６案,臺中市,北屯區,北興里,850,1107,340,217,557,39,596
公投第１６案,臺中市,北屯區,北興里,851,2151,653,395,1048,110,1158
公投第１６案,臺中市,北屯區,三光里,852,1612,547,371,918,51,969
公投第１６案,臺中市,北屯區,三光里,853,1743,553,354,907,74,981
公投第１６案,臺中市,北屯區,三光里,854,2099,624,419,1043,73,1116
公投第１６案,臺中市,北屯區,三光里,855,1595,560,302,862,49,911
公投第１６案,臺中市,北屯區,三和里,856,1923,572,355,927,93,1020
公投第１６案,臺中市,北屯區,三和里,857,1641,497,326,823,79,902
公投第１６案,臺中市,北屯區,三和里,858,1157,422,270,692,52,744
公投第１６案,臺中市,北屯區,三和里,859,1041,396,209,605,60,665
公投第１６案,臺中市,北屯區,東光里,860,1563,474,304,778,69,847
公投第１６案,臺中市,北屯區,東光里,861,1559,447,296,743,96,839
公投第１６案,臺中市,北屯區,東光里,862,1411,422,254,676,34,710
公投第１６案,臺中市,北屯區,水景里,863,1761,597,390,987,57,1044
公投第１６案,臺中市,北屯區,水景里,864,1361,474,296,770,95,865
公投第１６案,臺中市,北屯區,水景里,865,1852,554,378,932,123,1055
公投第１６案,臺中市,北屯區,水景里,866,1928,636,412,1048,67,1115
公投第１６案,臺中市,北屯區,水景里,867,1492,535,369,904,58,962
公投第１６案,臺中市,北屯區,水景里,868,1998,633,351,984,117,1101
公投第１６案,臺中市,北屯區,水景里,869,1272,447,320,767,60,827
公投第１６案,臺中市,北屯區,水景里,870,1317,446,307,753,56,809
公投第１６案,臺中市,北屯區,軍功里,871,1327,352,283,635,90,725
公投第１６案,臺中市,北屯區,軍功里,872,1280,391,252,643,40,683
公投第１６案,臺中市,北屯區,軍功里,873,1865,564,350,914,69,983
公投第１６案,臺中市,北屯區,軍功里,874,1230,499,230,729,57,786
公投第１６案,臺中市,北屯區,軍功里,875,1356,417,255,672,62,734
公投第１６案,臺中市,北屯區,軍功里,876,1732,581,331,912,74,986
公投第１６案,臺中市,北屯區,軍功里,877,1586,543,332,875,75,950
公投第１６案,臺中市,北屯區,軍功里,878,1441,457,290,747,65,812
公投第１６案,臺中市,北屯區,和平里,879,2045,574,429,1003,106,1109
公投第１６案,臺中市,北屯區,和平里,880,1914,565,352,917,94,1011
公投第１６案,臺中市,北屯區,和平里,881,1918,528,391,919,61,980
公投第１６案,臺中市,北屯區,和平里,882,2079,644,387,1031,53,1084
公投第１６案,臺中市,北屯區,和平里,883,2040,635,426,1061,94,1155
公投第１６案,臺中市,北屯區,廍子里,884,2027,615,343,958,51,1009
公投第１６案,臺中市,北屯區,廍子里,885,1402,445,282,727,62,789
公投第１６案,臺中市,北屯區,廍子里,886,1826,378,601,979,88,1067
公投第１６案,臺中市,北屯區,廍子里,887,2162,633,390,1023,75,1098
公投第１６案,臺中市,北屯區,廍子里,888,2332,633,425,1058,42,1100
公投第１６案,臺中市,北屯區,民政里,889,985,324,194,518,63,581
公投第１６案,臺中市,北屯區,東山里,890,2037,546,405,951,57,1008
公投第１６案,臺中市,北屯區,大坑里,891,1032,328,250,578,56,634
公投第１６案,臺中市,北屯區,大坑里,892,1062,373,207,580,48,628
公投第１６案,臺中市,北屯區,民德里,893,909,275,187,462,62,524
公投第１６案,臺中市,北屯區,舊社里,894,1445,498,298,796,78,874
公投第１６案,臺中市,北屯區,舊社里,895,1842,514,469,983,74,1057
公投第１６案,臺中市,北屯區,舊社里,896,1187,408,245,653,64,717
公投第１６案,臺中市,北屯區,舊社里,897,1456,479,291,770,72,842
公投第１６案,臺中市,北屯區,松茂里,898,1866,654,335,989,83,1072
公投第１６案,臺中市,北屯區,松茂里,899,1667,521,326,847,59,906
公投第１６案,臺中市,北屯區,松茂里,900,1683,572,365,937,40,977
公投第１６案,臺中市,北屯區,松強里,901,1642,508,337,845,69,914
公投第１６案,臺中市,北屯區,松強里,902,1475,473,343,816,41,857
公投第１６案,臺中市,北屯區,松強里,903,1644,527,314,841,58,899
公投第１６案,臺中市,北屯區,松強里,904,1603,545,357,902,51,953
公投第１６案,臺中市,北屯區,松勇里,905,1949,707,385,1092,69,1161
公投第１６案,臺中市,北屯區,松勇里,906,1790,686,357,1043,87,1130
公投第１６案,臺中市,北屯區,松勇里,907,1440,457,327,784,67,851
公投第１６案,臺中市,北屯區,松安里,908,1601,521,369,890,89,979
公投第１６案,臺中市,北屯區,松安里,909,1527,465,321,786,75,861
公投第１６案,臺中市,北屯區,松安里,910,1675,502,318,820,74,894
公投第１６案,臺中市,北屯區,松和里,911,1579,452,287,739,76,815
公投第１６案,臺中市,北屯區,松和里,912,1524,466,319,785,100,885
公投第１６案,臺中市,北屯區,松和里,913,1677,527,311,838,81,919
公投第１６案,臺中市,北屯區,松和里,914,1599,512,321,833,73,906
公投第１６案,臺中市,北屯區,松竹里,915,1458,499,300,799,87,886
公投第１６案,臺中市,北屯區,松竹里,916,1571,538,334,872,74,946
公投第１６案,臺中市,北屯區,松竹里,917,1579,510,340,850,95,945
公投第１６案,臺中市,北屯區,松竹里,918,1849,542,460,1002,90,1092
公投第１６案,臺中市,北屯區,松竹里,919,1682,572,315,887,81,968
公投第１６案,臺中市,北屯區,平興里,920,1760,539,335,874,95,969
公投第１６案,臺中市,北屯區,平興里,921,1699,533,363,896,99,995
公投第１６案,臺中市,北屯區,平興里,922,1626,584,349,933,74,1007
公投第１６案,臺中市,北屯區,平興里,923,1491,506,342,848,11,859
公投第１６案,臺中市,北屯區,平田里,924,1640,496,354,850,63,913
公投第１６案,臺中市,北屯區,平田里,925,2052,640,387,1027,104,1131
公投第１６案,臺中市,北屯區,平田里,926,1875,597,406,1003,60,1063
公投第１６案,臺中市,北屯區,平昌里,927,1559,496,322,818,55,873
公投第１６案,臺中市,北屯區,平昌里,928,1480,450,323,773,110,883
公投第１６案,臺中市,北屯區,平昌里,929,1397,465,308,773,64,837
公投第１６案,臺中市,北屯區,平安里,930,1889,597,410,1007,86,1093
公投第１６案,臺中市,北屯區,平安里,931,1728,532,346,878,100,978
公投第１６案,臺中市,北屯區,平安里,932,1592,462,328,790,104,894
公投第１６案,臺中市,北屯區,平順里,933,1656,510,303,813,105,918
公投第１６案,臺中市,北屯區,平順里,934,1524,445,300,745,91,836
公投第１６案,臺中市,北屯區,平心里,935,1502,464,353,817,62,879
公投第１６案,臺中市,北屯區,平心里,936,1772,497,440,937,49,986
公投第１６案,臺中市,北屯區,平心里,937,1461,500,310,810,64,874
公投第１６案,臺中市,北屯區,平福里,938,1769,561,296,857,46,903
公投第１６案,臺中市,北屯區,平福里,939,1894,647,413,1060,75,1135
公投第１６案,臺中市,北屯區,平德里,940,2033,612,376,988,81,1069
公投第１６案,臺中市,北屯區,平德里,941,1947,599,376,975,94,1069
公投第１６案,臺中市,北屯區,平德里,942,2188,712,483,1195,61,1256
公投第１６案,臺中市,北屯區,平和里,943,1661,659,245,904,102,1006
公投第１６案,臺中市,北屯區,平和里,944,1667,575,344,919,50,969
公投第１６案,臺中市,北屯區,平和里,945,1728,548,340,888,81,969
公投第１６案,臺中市,北屯區,平陽里,946,1688,500,360,860,59,919
公投第１６案,臺中市,北屯區,平陽里,947,1475,490,295,785,61,846
公投第１６案,臺中市,北屯區,平陽里,948,1681,600,368,968,57,1025
公投第１６案,臺中市,北屯區,仁和里,949,2078,737,400,1137,86,1223
公投第１６案,臺中市,北屯區,仁和里,950,2059,695,283,978,84,1062
公投第１６案,臺中市,北屯區,仁和里,951,1792,579,378,957,94,1051
公投第１６案,臺中市,北屯區,仁和里,952,2974,595,385,980,70,1050
公投第１６案,臺中市,北屯區,仁愛里,953,1072,347,201,548,79,627
公投第１６案,臺中市,北屯區,仁美里,954,2099,788,449,1237,85,1322
公投第１６案,臺中市,北屯區,仁美里,955,1823,657,415,1072,90,1162
公投第１６案,臺中市,北屯區,仁美里,956,2022,700,434,1134,100,1234
公投第１６案,臺中市,北屯區,仁美里,957,1992,641,427,1068,62,1130
公投第１６案,臺中市,北屯區,四民里,958,1585,537,373,910,71,981
公投第１６案,臺中市,北屯區,同榮里,959,1565,543,349,892,69,961
公投第１６案,臺中市,北屯區,同榮里,960,1780,544,308,852,57,909
公投第１６案,臺中市,北屯區,同榮里,961,1874,674,404,1078,77,1155
公投第１６案,臺中市,北屯區,后庄里,962,1755,638,341,979,70,1049
公投第１６案,臺中市,北屯區,后庄里,963,1497,590,339,929,75,1004
公投第１６案,臺中市,北屯區,后庄里,964,1567,559,349,908,81,989
公投第１６案,臺中市,北屯區,后庄里,965,1624,543,295,838,76,914
公投第１６案,臺中市,北屯區,后庄里,966,1614,600,311,911,81,992
公投第１６案,臺中市,北屯區,后庄里,967,1595,546,293,839,74,913
公投第１６案,臺中市,北屯區,新平里,968,1782,552,318,870,87,957
公投第１６案,臺中市,北屯區,新平里,969,1357,359,273,632,61,693
公投第１６案,臺中市,北屯區,新平里,970,1071,357,206,563,62,625
公投第１６案,臺中市,北屯區,陳平里,971,1372,427,256,683,76,759
公投第１６案,臺中市,北屯區,陳平里,972,1415,496,268,764,83,847
公投第１６案,臺中市,北屯區,陳平里,973,1789,626,383,1009,101,1110
公投第１６案,臺中市,北屯區,忠平里,974,1907,695,381,1076,118,1194
公投第１６案,臺中市,北屯區,忠平里,975,2008,722,371,1093,93,1186
公投第１６案,臺中市,北屯區,大德里,976,1541,506,291,797,81,878
公投第１６案,臺中市,北屯區,大德里,977,1669,578,336,914,82,996
公投第１６案,臺中市,北屯區,大德里,978,1685,595,308,903,52,955
公投第１６案,臺中市,北屯區,水湳里,979,1785,570,397,967,85,1052
公投第１６案,臺中市,北屯區,水湳里,980,1596,515,363,878,102,980
公投第１６案,臺中市,北屯區,水湳里,981,1731,618,335,953,91,1044
公投第１６案,臺中市,北屯區,水湳里,982,1496,481,290,771,79,850
公投第１６案,臺中市,北區,中正里,983,1437,430,287,717,51,768
公投第１６案,臺中市,北區,六合里,984,1708,479,321,800,111,911
公投第１６案,臺中市,北區,光大里,985,1051,290,202,492,57,549
公投第１６案,臺中市,北區,光大里,986,996,307,219,526,58,584
公投第１６案,臺中市,北區,文莊里,987,1504,567,261,828,38,866
公投第１６案,臺中市,北區,文莊里,988,975,333,219,552,54,606
公投第１６案,臺中市,北區,文莊里,989,886,287,187,474,49,523
公投第１６案,臺中市,北區,大湖里,990,1276,312,218,530,53,583
公投第１６案,臺中市,北區,大湖里,991,938,245,186,431,53,484
公投第１６案,臺中市,北區,五常里,992,1404,394,272,666,105,771
公投第１６案,臺中市,北區,錦平里,993,996,335,203,538,25,563
公投第１６案,臺中市,北區,錦平里,994,869,243,191,434,59,493
公投第１６案,臺中市,北區,新北里,995,704,235,152,387,42,429
公投第１６案,臺中市,北區,新北里,996,979,274,206,480,49,529
公投第１６案,臺中市,北區,新興里,997,773,229,151,380,29,409
公投第１６案,臺中市,北區,新興里,998,759,253,158,411,41,452
公投第１６案,臺中市,北區,樂英里,999,1438,511,237,748,91,839
公投第１６案,臺中市,北區,樂英里,1000,1212,361,223,584,44,628
公投第１６案,臺中市,北區,錦村里,1001,1731,569,360,929,49,978
公投第１６案,臺中市,北區,錦村里,1002,1445,405,326,731,57,788
公投第１６案,臺中市,北區,建成里,1003,1855,568,374,942,87,1029
公投第１６案,臺中市,北區,建成里,1004,1728,487,293,780,95,875
公投第１６案,臺中市,北區,建成里,1005,1878,542,357,899,69,968
公投第１６案,臺中市,北區,建德里,1006,1793,585,229,814,120,934
公投第１６案,臺中市,北區,建德里,1007,1555,522,302,824,96,920
公投第１６案,臺中市,北區,錦洲里,1008,1761,484,343,827,45,872
公投第１６案,臺中市,北區,錦洲里,1009,1579,495,296,791,69,860
公投第１６案,臺中市,北區,錦祥里,1010,2192,652,395,1047,133,1180
公投第１６案,臺中市,北區,錦祥里,1011,1560,534,320,854,78,932
公投第１６案,臺中市,北區,金華里,1012,1476,490,311,801,56,857
公投第１６案,臺中市,北區,金華里,1013,1006,360,212,572,46,618
公投第１６案,臺中市,北區,金龍里,1014,1403,461,301,762,56,818
公投第１６案,臺中市,北區,金龍里,1015,1446,454,282,736,39,775
公投第１６案,臺中市,北區,金龍里,1016,1460,446,313,759,64,823
公投第１６案,臺中市,北區,邱厝里,1017,1233,393,265,658,39,697
公投第１６案,臺中市,北區,邱厝里,1018,1027,422,225,647,42,689
公投第１６案,臺中市,北區,建興里,1019,1207,403,252,655,38,693
公投第１６案,臺中市,北區,建興里,1020,1167,388,268,656,61,717
公投第１６案,臺中市,北區,建興里,1021,1150,344,273,617,37,654
公投第１６案,臺中市,北區,建興里,1022,1061,330,247,577,51,628
公投第１６案,臺中市,北區,建興里,1023,1005,318,224,542,41,583
公投第１６案,臺中市,北區,頂厝里,1024,1250,386,282,668,40,708
公投第１６案,臺中市,北區,頂厝里,1025,1448,445,333,778,86,864
公投第１６案,臺中市,北區,頂厝里,1026,1379,477,267,744,82,826
公投第１６案,臺中市,北區,崇德里,1027,1652,517,319,836,116,952
公投第１６案,臺中市,北區,崇德里,1028,1867,563,360,923,88,1011
公投第１６案,臺中市,北區,賴厝里,1029,2078,314,220,534,23,557
公投第１６案,臺中市,北區,賴厝里,1030,1562,537,328,865,82,947
公投第１６案,臺中市,北區,賴厝里,1031,1430,469,306,775,50,825
公投第１６案,臺中市,北區,賴福里,1032,2018,657,420,1077,95,1172
公投第１６案,臺中市,北區,賴福里,1033,1710,536,307,843,42,885
公投第１６案,臺中市,北區,賴興里,1034,1432,434,311,745,48,793
公投第１６案,臺中市,北區,賴興里,1035,1157,402,239,641,64,705
公投第１６案,臺中市,北區,賴興里,1036,1188,425,248,673,32,705
公投第１６案,臺中市,北區,賴旺里,1037,1419,449,281,730,71,801
公投第１６案,臺中市,北區,賴旺里,1038,1653,534,298,832,58,890
公投第１６案,臺中市,北區,賴旺里,1039,1233,381,266,647,84,731
公投第１６案,臺中市,北區,賴明里,1040,1243,389,283,672,38,710
公投第１６案,臺中市,北區,賴明里,1041,1219,374,245,619,20,639
公投第１６案,臺中市,北區,賴明里,1042,1272,395,306,701,58,759
公投第１６案,臺中市,北區,梅川里,1043,1285,414,284,698,49,747
公投第１６案,臺中市,北區,梅川里,1044,1780,555,417,972,65,1037
公投第１６案,臺中市,北區,賴村里,1045,1461,443,267,710,45,755
公投第１６案,臺中市,北區,賴村里,1046,1310,420,295,715,66,781
公投第１６案,臺中市,北區,賴村里,1047,1669,499,300,799,68,867
公投第１６案,臺中市,北區,育德里,1048,1932,622,377,999,128,1127
公投第１６案,臺中市,北區,育德里,1049,1682,480,396,876,58,934
公投第１６案,臺中市,北區,淡溝里,1050,1891,554,416,970,40,1010
公投第１６案,臺中市,北區,淡溝里,1051,1882,590,393,983,82,1065
公投第１６案,臺中市,北區,淡溝里,1052,1159,369,255,624,28,652
公投第１６案,臺中市,北區,健行里,1053,1553,484,319,803,70,873
公投第１６案,臺中市,北區,健行里,1054,1607,505,340,845,41,886
公投第１６案,臺中市,北區,健行里,1055,1773,548,389,937,59,996
公投第１６案,臺中市,北區,健行里,1056,1524,480,324,804,76,880
公投第１６案,臺中市,北區,明德里,1057,1613,518,377,895,110,1005
公投第１６案,臺中市,北區,明德里,1058,1877,627,384,1011,81,1092
公投第１６案,臺中市,北區,明德里,1059,1792,546,389,935,100,1035
公投第１６案,臺中市,北區,明新里,1060,1392,467,300,767,64,831
公投第１６案,臺中市,北區,明新里,1061,1297,416,263,679,56,735
公投第１６案,臺中市,北區,長青里,1062,1556,485,386,871,78,949
公投第１６案,臺中市,北區,長青里,1063,1497,442,331,773,54,827
公投第１６案,臺中市,北區,長青里,1064,1550,462,328,790,79,869
公投第１６案,臺中市,北區,長青里,1065,1434,444,286,730,96,826
公投第１６案,臺中市,北區,立人里,1066,1793,614,348,962,75,1037
公投第１６案,臺中市,北區,立人里,1067,1866,599,364,963,78,1041
公投第１６案,臺中市,北區,中達里,1068,1346,429,308,737,65,802
公投第１６案,臺中市,北區,中達里,1069,1267,388,265,653,74,727
公投第１６案,臺中市,中區,綠川里,1070,1652,515,382,897,117,1014
公投第１６案,臺中市,中區,繼光里,1071,1531,392,352,744,104,848
公投第１６案,臺中市,中區,公園里,1072,1431,419,307,726,71,797
公投第１６案,臺中市,中區,光復里,1073,1060,330,235,565,52,617
公投第１６案,臺中市,中區,光復里,1074,982,302,186,488,63,551
公投第１６案,臺中市,中區,大墩里,1075,1191,370,255,625,93,718
公投第１６案,臺中市,中區,大墩里,1076,855,221,200,421,73,494
公投第１６案,臺中市,中區,柳川里,1077,1135,291,199,490,44,534
公投第１６案,臺中市,中區,柳川里,1078,705,228,160,388,18,406
公投第１６案,臺中市,中區,大誠里,1079,1009,309,230,539,62,601
公投第１６案,臺中市,中區,大誠里,1080,1304,337,290,627,107,734
公投第１６案,臺中市,中區,中華里,1081,1841,485,361,846,55,901
公投第１６案,臺中市,西區,三民里,1082,1400,267,200,467,47,514
公投第１６案,臺中市,西區,三民里,1083,861,302,226,528,27,555
公投第１６案,臺中市,西區,利民里,1084,1416,463,308,771,69,840
公投第１６案,臺中市,西區,民生里,1085,1020,349,235,584,51,635
公投第１６案,臺中市,西區,民生里,1086,778,259,209,468,45,513
公投第１６案,臺中市,西區,廣民里,1087,1465,445,291,736,69,805
公投第１６案,臺中市,西區,平和里,1088,1017,319,242,561,30,591
公投第１６案,臺中市,西區,平和里,1089,868,271,216,487,39,526
公投第１６案,臺中市,西區,東昇里,1090,1251,425,304,729,80,809
公投第１６案,臺中市,西區,東昇里,1091,1044,357,271,628,55,683
公投第１６案,臺中市,西區,公民里,1092,1487,480,324,804,58,862
公投第１６案,臺中市,西區,公民里,1093,1573,518,336,854,59,913
公投第１６案,臺中市,西區,公民里,1094,1731,586,385,971,81,1052
公投第１６案,臺中市,西區,藍興里,1095,1209,389,285,674,53,727
公投第１６案,臺中市,西區,藍興里,1096,1564,509,330,839,56,895
公投第１６案,臺中市,西區,藍興里,1097,1175,409,273,682,50,732
公投第１６案,臺中市,西區,公舘里,1098,1505,469,321,790,63,853
公投第１６案,臺中市,西區,公舘里,1099,1418,512,294,806,46,852
公投第１６案,臺中市,西區,公舘里,1100,1497,390,265,655,10,665
公投第１６案,臺中市,西區,公舘里,1101,1260,397,300,697,58,755
公投第１６案,臺中市,西區,安龍里,1102,1399,464,317,781,70,851
公投第１６案,臺中市,西區,安龍里,1103,1447,473,289,762,72,834
公投第１６案,臺中市,西區,吉龍里,1104,1683,530,373,903,83,986
公投第１６案,臺中市,西區,吉龍里,1105,1585,528,342,870,80,950
公投第１６案,臺中市,西區,吉龍里,1106,1557,526,342,868,68,936
公投第１６案,臺中市,西區,吉龍里,1107,1663,495,326,821,88,909
公投第１６案,臺中市,西區,土庫里,1108,1921,598,426,1024,98,1122
公投第１６案,臺中市,西區,土庫里,1109,1952,521,451,972,58,1030
公投第１６案,臺中市,西區,土庫里,1110,1708,544,356,900,70,970
公投第１６案,臺中市,西區,大忠里,1111,1131,417,254,671,49,720
公投第１６案,臺中市,西區,大忠里,1112,1916,608,342,950,87,1037
公投第１６案,臺中市,西區,大忠里,1113,1275,399,325,724,54,778
公投第１６案,臺中市,西區,民龍里,1114,1822,543,352,895,70,965
公投第１６案,臺中市,西區,民龍里,1115,1374,446,308,754,55,809
公投第１６案,臺中市,西區,和龍里,1116,1129,330,242,572,77,649
公投第１６案,臺中市,西區,和龍里,1117,1201,359,256,615,58,673
公投第１６案,臺中市,西區,後龍里,1118,1639,478,385,863,73,936
公投第１６案,臺中市,西區,後龍里,1119,1863,564,431,995,95,1090
公投第１６案,臺中市,西區,双龍里,1120,1287,455,304,759,70,829
公投第１６案,臺中市,西區,双龍里,1121,1504,494,353,847,71,918
公投第１６案,臺中市,西區,昇平里,1122,1308,443,278,721,44,765
公投第１６案,臺中市,西區,昇平里,1123,1433,459,316,775,69,844
公投第１６案,臺中市,西區,昇平里,1124,1450,408,363,771,52,823
公投第１６案,臺中市,西區,昇平里,1125,1465,496,368,864,71,935
公投第１６案,臺中市,西區,中興里,1126,1818,553,348,901,89,990
公投第１６案,臺中市,西區,中興里,1127,1782,513,423,936,98,1034
公投第１６案,臺中市,西區,公益里,1128,1428,415,361,776,95,871
公投第１６案,臺中市,西區,公益里,1129,1366,374,292,666,62,728
公投第１６案,臺中市,西區,公德里,1130,1498,471,330,801,52,853
公投第１６案,臺中市,西區,公德里,1131,1350,446,309,755,59,814
公投第１６案,臺中市,西區,公德里,1132,1339,447,311,758,54,812
公投第１６案,臺中市,西區,公正里,1133,1613,582,335,917,51,968
公投第１６案,臺中市,西區,公正里,1134,1454,471,301,772,79,851
公投第１６案,臺中市,西區,公正里,1135,1597,531,359,890,73,963
公投第１６案,臺中市,西區,公正里,1136,1411,457,336,793,99,892
公投第１６案,臺中市,西區,公平里,1137,1493,431,371,802,87,889
公投第１６案,臺中市,西區,公平里,1138,1600,553,339,892,92,984
公投第１６案,臺中市,西區,公平里,1139,1710,524,351,875,79,954
公投第１６案,臺中市,西區,忠明里,1140,1139,389,252,641,39,680
公投第１６案,臺中市,西區,忠明里,1141,1105,362,277,639,42,681
公投第１６案,臺中市,西區,忠明里,1142,1498,495,298,793,73,866
公投第１６案,臺中市,西區,忠明里,1143,1921,543,364,907,66,973
公投第１６案,臺中市,西區,忠誠里,1144,1340,401,309,710,81,791
公投第１６案,臺中市,西區,忠誠里,1145,1536,531,341,872,60,932
公投第１６案,臺中市,西區,忠誠里,1146,1361,394,314,708,95,803
公投第１６案,臺中市,西區,忠誠里,1147,1430,515,321,836,59,895
公投第１６案,臺中市,東區,新庄里,1148,1138,224,182,406,31,437
公投第１６案,臺中市,東區,新庄里,1149,984,306,215,521,41,562
公投第１６案,臺中市,東區,新庄里,1150,877,267,195,462,60,522
公投第１６案,臺中市,東區,振興里,1151,1070,346,259,605,56,661
公投第１６案,臺中市,東區,振興里,1152,1106,371,249,620,61,681
公投第１６案,臺中市,東區,振興里,1153,953,297,217,514,67,581
公投第１６案,臺中市,東區,東橋里,1154,1195,385,275,660,49,709
公投第１６案,臺中市,東區,東橋里,1155,1251,370,277,647,60,707
公投第１６案,臺中市,東區,東橋里,1156,1190,347,282,629,51,680
公投第１６案,臺中市,東區,東興里,1157,1394,409,314,723,68,791
公投第１６案,臺中市,東區,東興里,1158,1443,457,363,820,70,890
公投第１６案,臺中市,東區,泉源里,1159,762,217,178,395,47,442
公投第１６案,臺中市,東區,泉源里,1160,1140,364,296,660,61,721
公投第１６案,臺中市,東區,干城里,1161,1211,366,315,681,83,764
公投第１６案,臺中市,東區,干城里,1162,755,275,173,448,33,481
公投第１６案,臺中市,東區,旱溪里,1163,1491,454,289,743,97,840
公投第１６案,臺中市,東區,旱溪里,1164,1000,267,217,484,59,543
公投第１６案,臺中市,東區,樂成里,1165,1114,372,226,598,81,679
公投第１６案,臺中市,東區,樂成里,1166,1101,341,242,583,47,630
公投第１６案,臺中市,東區,東門里,1167,1169,367,294,661,89,750
公投第１６案,臺中市,東區,東門里,1168,1283,405,304,709,95,804
公投第１６案,臺中市,東區,東門里,1169,1168,406,273,679,59,738
公投第１６案,臺中市,東區,東門里,1170,1386,400,304,704,50,754
公投第１６案,臺中市,東區,東門里,1171,1557,509,350,859,69,928
公投第１６案,臺中市,東區,十甲里,1172,1380,414,329,743,71,814
公投第１６案,臺中市,東區,十甲里,1173,1674,527,375,902,79,981
公投第１６案,臺中市,東區,十甲里,1174,1604,642,300,942,57,999
公投第１６案,臺中市,東區,東英里,1175,1815,579,420,999,90,1089
公投第１６案,臺中市,東區,東英里,1176,1700,528,344,872,75,947
公投第１６案,臺中市,東區,東英里,1177,1592,498,325,823,92,915
公投第１６案,臺中市,東區,東英里,1178,1850,546,368,914,107,1021
公投第１６案,臺中市,東區,東南里,1179,1252,442,250,692,59,751
公投第１６案,臺中市,東區,東南里,1180,1250,429,299,728,66,794
公投第１６案,臺中市,東區,東南里,1181,1241,418,264,682,68,750
公投第１６案,臺中市,東區,東勢里,1182,1318,390,252,642,69,711
公投第１６案,臺中市,東區,東勢里,1183,1288,389,250,639,96,735
公投第１６案,臺中市,東區,合作里,1184,1442,499,299,798,103,901
公投第１６案,臺中市,東區,合作里,1185,1202,406,239,645,71,716
公投第１６案,臺中市,東區,合作里,1186,1452,505,271,776,80,856
公投第１６案,臺中市,東區,富仁里,1187,1480,471,295,766,58,824
公投第１６案,臺中市,東區,富仁里,1188,1736,643,284,927,86,1013
公投第１６案,臺中市,東區,富仁里,1189,867,257,188,445,56,501
公投第１６案,臺中市,東區,富台里,1190,1693,554,268,822,67,889
公投第１６案,臺中市,東區,東信里,1191,1538,488,355,843,98,941
公投第１６案,臺中市,東區,東信里,1192,1593,444,420,864,129,993
公投第１６案,臺中市,東區,東信里,1193,1481,445,315,760,51,811
公投第１６案,臺中市,東區,東信里,1194,1414,458,333,791,77,868
公投第１６案,臺中市,東區,東信里,1195,1297,361,293,654,62,716
公投第１６案,臺中市,東區,東信里,1196,1394,384,360,744,86,830
公投第１６案,臺中市,南區,長春里,1197,937,301,217,518,54,572
公投第１６案,臺中市,南區,長春里,1198,1001,342,255,597,60,657
公投第１６案,臺中市,南區,長榮里,1199,1249,415,324,739,85,824
公投第１６案,臺中市,南區,長榮里,1200,1202,451,294,745,78,823
公投第１６案,臺中市,南區,城隍里,1201,1130,319,267,586,131,717
公投第１６案,臺中市,南區,城隍里,1202,1239,411,296,707,80,787
公投第１６案,臺中市,南區,城隍里,1203,1238,365,276,641,88,729
公投第１６案,臺中市,南區,國光里,1204,1272,413,303,716,73,789
公投第１６案,臺中市,南區,國光里,1205,1273,399,302,701,70,771
公投第１６案,臺中市,南區,國光里,1206,1317,416,300,716,89,805
公投第１６案,臺中市,南區,南門里,1207,1160,433,308,741,47,788
公投第１６案,臺中市,南區,南門里,1208,1205,431,294,725,64,789
公投第１６案,臺中市,南區,南門里,1209,1111,351,280,631,57,688
公投第１６案,臺中市,南區,德義里,1210,1407,490,360,850,77,927
公投第１６案,臺中市,南區,德義里,1211,1419,458,329,787,68,855
公投第１６案,臺中市,南區,積善里,1212,1157,400,250,650,88,738
公投第１６案,臺中市,南區,積善里,1213,1415,468,303,771,48,819
公投第１６案,臺中市,南區,江川里,1214,1289,446,341,787,65,852
公投第１６案,臺中市,南區,江川里,1215,1454,468,329,797,83,880
公投第１６案,臺中市,南區,新榮里,1216,1491,439,320,759,74,833
公投第１６案,臺中市,南區,新榮里,1217,1394,480,287,767,55,822
公投第１６案,臺中市,南區,新榮里,1218,1430,455,314,769,89,858
公投第１６案,臺中市,南區,福興里,1219,1342,392,278,670,169,839
公投第１６案,臺中市,南區,福興里,1220,1304,416,340,756,129,885
公投第１６案,臺中市,南區,福興里,1221,1190,401,289,690,66,756
公投第１６案,臺中市,南區,福平里,1222,1273,435,243,678,81,759
公投第１６案,臺中市,南區,福平里,1223,1387,502,317,819,86,905
公投第１６案,臺中市,南區,福平里,1224,1356,452,287,739,71,810
公投第１６案,臺中市,南區,福平里,1225,1304,444,298,742,75,817
公投第１６案,臺中市,南區,福順里,1226,1256,477,290,767,57,824
公投第１６案,臺中市,南區,福順里,1227,1364,481,333,814,45,859
公投第１６案,臺中市,南區,福順里,1228,1361,417,330,747,104,851
公投第１６案,臺中市,南區,福順里,1229,1407,511,316,827,47,874
公投第１６案,臺中市,南區,和平里,1230,1308,403,306,709,92,801
公投第１６案,臺中市,南區,和平里,1231,1250,358,311,669,64,733
公投第１６案,臺中市,南區,和平里,1232,1284,413,272,685,58,743
公投第１６案,臺中市,南區,平和里,1233,1175,399,273,672,82,754
公投第１６案,臺中市,南區,平和里,1234,1158,429,282,711,57,768
公投第１６案,臺中市,南區,平和里,1235,1168,415,227,642,75,717
公投第１６案,臺中市,南區,南和里,1236,1626,581,374,955,83,1038
公投第１６案,臺中市,南區,南和里,1237,2115,506,318,824,51,875
公投第１６案,臺中市,南區,南和里,1238,1805,586,359,945,63,1008
公投第１６案,臺中市,南區,南和里,1239,1695,552,332,884,57,941
公投第１６案,臺中市,南區,永興里,1240,1643,590,379,969,77,1046
公投第１６案,臺中市,南區,永興里,1241,1423,485,355,840,44,884
公投第１６案,臺中市,南區,永興里,1242,1542,498,345,843,76,919
公投第１６案,臺中市,南區,永興里,1243,1533,521,339,860,58,918
公投第１６案,臺中市,南區,永興里,1244,1531,557,346,903,91,994
公投第１６案,臺中市,南區,永和里,1245,1392,402,293,695,62,757
公投第１６案,臺中市,南區,永和里,1246,1592,516,340,856,59,915
公投第１６案,臺中市,南區,永和里,1247,1431,475,354,829,67,896
公投第１６案,臺中市,南區,樹義里,1248,1799,532,368,900,86,986
公投第１６案,臺中市,南區,樹義里,1249,1708,616,381,997,86,1083
公投第１６案,臺中市,南區,樹義里,1250,1700,482,419,901,80,981
公投第１６案,臺中市,南區,樹義里,1251,1751,646,399,1045,57,1102
公投第１６案,臺中市,南區,樹義里,1252,2109,681,495,1176,91,1267
公投第１６案,臺中市,南區,樹義里,1253,1697,542,379,921,84,1005
公投第１６案,臺中市,南區,工學里,1254,1456,486,327,813,56,869
公投第１６案,臺中市,南區,工學里,1255,1726,603,453,1056,91,1147
公投第１６案,臺中市,南區,工學里,1256,1723,640,361,1001,80,1081
公投第１６案,臺中市,南區,工學里,1257,1569,550,339,889,84,973
公投第１６案,臺中市,南區,樹德里,1258,1274,377,312,689,105,794
公投第１６案,臺中市,南區,樹德里,1259,1390,519,346,865,57,922
公投第１６案,臺中市,南區,樹德里,1260,1295,477,320,797,52,849
公投第１６案,臺中市,南區,樹德里,1261,1312,419,301,720,79,799
公投第１６案,臺中市,南區,樹德里,1262,1417,522,323,845,57,902
公投第１６案,臺中市,南區,樹德里,1263,1230,489,329,818,37,855
公投第１６案,臺中市,南區,西川里,1264,1308,418,278,696,94,790
公投第１６案,臺中市,南區,西川里,1265,1467,471,333,804,73,877
公投第１６案,臺中市,南區,西川里,1266,1399,408,371,779,80,859
公投第１６案,臺中市,南區,崇倫里,1267,1207,370,280,650,83,733
公投第１６案,臺中市,南區,崇倫里,1268,1317,421,293,714,60,774
公投第１６案,臺中市,南區,崇倫里,1269,1563,499,363,862,52,914
公投第１６案,臺中市,南區,崇倫里,1270,1221,453,277,730,39,769
公投第１６案,臺中市,太平區,太平里,1271,1821,550,361,911,84,995
公投第１６案,臺中市,太平區,太平里,1272,1680,455,304,759,78,837
公投第１６案,臺中市,太平區,太平里,1273,1947,555,444,999,131,1130
公投第１６案,臺中市,太平區,長億里,1274,1910,640,414,1054,99,1153
公投第１６案,臺中市,太平區,長億里,1275,1894,538,402,940,82,1022
公投第１６案,臺中市,太平區,長億里,1276,1953,671,401,1072,107,1179
公投第１６案,臺中市,太平區,永成里,1277,1846,573,368,941,115,1056
公投第１６案,臺中市,太平區,永成里,1278,1493,490,322,812,64,876
公投第１６案,臺中市,太平區,永成里,1279,1605,490,314,804,94,898
公投第１６案,臺中市,太平區,永成里,1280,1619,578,308,886,56,942
公投第１６案,臺中市,太平區,中平里,1281,2011,648,337,985,107,1092
公投第１６案,臺中市,太平區,中平里,1282,2056,604,410,1014,54,1068
公投第１６案,臺中市,太平區,中政里,1283,1876,573,362,935,103,1038
公投第１６案,臺中市,太平區,中政里,1284,1815,623,264,887,103,990
公投第１６案,臺中市,太平區,平安里,1285,1281,380,267,647,63,710
公投第１６案,臺中市,太平區,平安里,1286,1004,315,259,574,76,650
公投第１６案,臺中市,太平區,中興里,1287,1886,598,422,1020,111,1131
公投第１６案,臺中市,太平區,中興里,1288,1431,416,344,760,99,859
公投第１６案,臺中市,太平區,永平里,1289,1930,550,394,944,113,1057
公投第１６案,臺中市,太平區,永平里,1290,2164,587,420,1007,105,1112
公投第１６案,臺中市,太平區,東平里,1291,2048,622,376,998,113,1111
公投第１６案,臺中市,太平區,東平里,1292,2035,595,392,987,97,1084
公投第１６案,臺中市,太平區,成功里,1293,1685,491,329,820,109,929
公投第１６案,臺中市,太平區,成功里,1294,2185,533,415,948,128,1076
公投第１６案,臺中市,太平區,東和里,1295,1176,326,255,581,39,620
公投第１６案,臺中市,太平區,東和里,1296,1597,480,305,785,71,856
公投第１６案,臺中市,太平區,建國里,1297,1378,394,265,659,82,741
公投第１６案,臺中市,太平區,建國里,1298,1546,502,306,808,35,843
公投第１６案,臺中市,太平區,建興里,1299,1890,529,339,868,87,955
公投第１６案,臺中市,太平區,建興里,1300,1053,307,216,523,70,593
公投第１６案,臺中市,太平區,坪林里,1301,1582,521,330,851,105,956
公投第１６案,臺中市,太平區,坪林里,1302,1699,573,52,625,82,707
公投第１６案,臺中市,太平區,大興里,1303,1493,417,312,729,84,813
公投第１６案,臺中市,太平區,大興里,1304,1063,296,216,512,66,578
公投第１６案,臺中市,太平區,勤益里,1305,1117,405,201,606,70,676
公投第１６案,臺中市,太平區,勤益里,1306,1084,377,220,597,59,656
公投第１６案,臺中市,太平區,光華里,1307,1776,524,327,851,54,905
公投第１６案,臺中市,太平區,光華里,1308,1729,522,354,876,67,943
公投第１６案,臺中市,太平區,光華里,1309,1658,449,286,735,80,815
公投第１６案,臺中市,太平區,光明里,1310,2010,618,366,984,88,1072
公投第１６案,臺中市,太平區,光明里,1311,1752,587,319,906,69,975
公投第１６案,臺中市,太平區,中山里,1312,1654,572,330,902,95,997
公投第１６案,臺中市,太平區,中山里,1313,1951,484,256,740,47,787
公投第１６案,臺中市,太平區,豐年里,1314,2170,758,492,1250,104,1354
公投第１６案,臺中市,太平區,豐年里,1315,2231,761,481,1242,88,1330
公投第１６案,臺中市,太平區,宜欣里,1316,1623,541,311,852,70,922
公投第１６案,臺中市,太平區,宜欣里,1317,1548,407,275,682,79,761
公投第１６案,臺中市,太平區,宜欣里,1318,1442,452,262,714,80,794
公投第１６案,臺中市,太平區,宜欣里,1319,1501,378,297,675,48,723
公投第１６案,臺中市,太平區,宜佳里,1320,2025,560,364,924,52,976
公投第１６案,臺中市,太平區,宜佳里,1321,1885,537,362,899,114,1013
公投第１６案,臺中市,太平區,宜佳里,1322,2155,594,351,945,110,1055
公投第１６案,臺中市,太平區,宜昌里,1323,1775,445,365,810,74,884
公投第１６案,臺中市,太平區,宜昌里,1324,2021,518,307,825,90,915
公投第１６案,臺中市,太平區,新坪里,1325,2075,682,350,1032,179,1211
公投第１６案,臺中市,太平區,新坪里,1326,1723,509,319,828,68,896
公投第１６案,臺中市,太平區,新坪里,1327,2049,664,394,1058,83,1141
公投第１６案,臺中市,太平區,新坪里,1328,1415,446,295,741,41,782
公投第１６案,臺中市,太平區,新吉里,1329,1778,563,346,909,87,996
公投第１６案,臺中市,太平區,新吉里,1330,1706,501,332,833,75,908
公投第１６案,臺中市,太平區,新吉里,1331,2090,661,394,1055,79,1134
公投第１６案,臺中市,太平區,新城里,1332,2093,586,396,982,84,1066
公投第１６案,臺中市,太平區,新城里,1333,1688,440,291,731,69,800
公投第１６案,臺中市,太平區,新城里,1334,1488,430,266,696,64,760
公投第１６案,臺中市,太平區,新光里,1335,1667,520,384,904,75,979
公投第１６案,臺中市,太平區,新光里,1336,1793,571,360,931,88,1019
公投第１６案,臺中市,太平區,新光里,1337,1903,611,389,1000,84,1084
公投第１６案,臺中市,太平區,新光里,1338,1834,537,376,913,110,1023
公投第１６案,臺中市,太平區,新興里,1339,1526,495,266,761,60,821
公投第１６案,臺中市,太平區,新興里,1340,1483,547,326,873,44,917
公投第１６案,臺中市,太平區,新興里,1341,1694,548,355,903,56,959
公投第１６案,臺中市,太平區,新高里,1342,1952,575,321,896,76,972
公投第１６案,臺中市,太平區,新高里,1343,1995,578,439,1017,62,1079
公投第１６案,臺中市,太平區,新高里,1344,1311,620,101,721,40,761
公投第１６案,臺中市,太平區,新高里,1345,1537,540,415,955,61,1016
公投第１６案,臺中市,太平區,新福里,1346,1974,532,364,896,76,972
公投第１６案,臺中市,太平區,新福里,1347,1828,577,379,956,60,1016
公投第１６案,臺中市,太平區,新福里,1348,2191,647,367,1014,63,1077
公投第１６案,臺中市,太平區,頭汴里,1349,1825,504,329,833,129,962
公投第１６案,臺中市,太平區,聖和里,1350,1559,449,285,734,16,750
公投第１６案,臺中市,太平區,東汴里,1351,1225,359,242,601,88,689
公投第１６案,臺中市,太平區,興隆里,1352,1678,492,362,854,82,936
公投第１６案,臺中市,太平區,興隆里,1353,1501,383,279,662,141,803
公投第１６案,臺中市,太平區,福隆里,1354,1450,456,371,827,95,922
公投第１６案,臺中市,太平區,福隆里,1355,2126,587,395,982,119,1101
公投第１６案,臺中市,太平區,黃竹里,1356,699,220,162,382,67,449
公投第１６案,臺中市,太平區,光隆里,1357,1428,359,291,650,35,685
公投第１６案,臺中市,太平區,光隆里,1358,1666,489,366,855,109,964
公投第１６案,臺中市,太平區,永隆里,1359,1241,367,262,629,72,701
公投第１６案,臺中市,太平區,永隆里,1360,1266,427,260,687,72,759
公投第１６案,臺中市,太平區,德隆里,1361,1166,371,234,605,62,667
公投第１６案,臺中市,太平區,德隆里,1362,1790,568,399,967,92,1059
公投第１６案,臺中市,太平區,德隆里,1363,1754,422,305,727,84,811
公投第１６案,臺中市,大里區,東湖里,1364,1614,497,289,786,76,862
公投第１６案,臺中市,大里區,東湖里,1365,1599,465,276,741,59,800
公投第１６案,臺中市,大里區,東湖里,1366,1715,488,283,771,104,875
公投第１６案,臺中市,大里區,東湖里,1367,1264,419,247,666,46,712
公投第１６案,臺中市,大里區,東湖里,1368,1416,429,257,686,61,747
公投第１６案,臺中市,大里區,東湖里,1369,1188,356,229,585,56,641
公投第１６案,臺中市,大里區,東湖里,1370,1359,344,276,620,104,724
公投第１６案,臺中市,大里區,西湖里,1371,1457,452,325,777,73,850
公投第１６案,臺中市,大里區,西湖里,1372,1403,469,303,772,59,831
公投第１６案,臺中市,大里區,大里里,1373,1697,516,332,848,84,932
公投第１６案,臺中市,大里區,大里里,1374,1811,530,433,963,133,1096
公投第１６案,臺中市,大里區,新里里,1375,1830,539,352,891,93,984
公投第１６案,臺中市,大里區,新里里,1376,2228,427,350,777,187,964
公投第１６案,臺中市,大里區,新里里,1377,1997,632,380,1012,125,1137
公投第１６案,臺中市,大里區,新里里,1378,2033,793,420,1213,82,1295
公投第１６案,臺中市,大里區,新里里,1379,1835,551,414,965,94,1059
公投第１６案,臺中市,大里區,國光里,1380,1268,423,257,680,43,723
公投第１６案,臺中市,大里區,國光里,1381,1645,535,331,866,77,943
公投第１６案,臺中市,大里區,國光里,1382,1561,543,311,854,64,918
公投第１６案,臺中市,大里區,國光里,1383,1301,490,297,787,60,847
公投第１６案,臺中市,大里區,樹王里,1384,1621,464,301,765,105,870
公投第１６案,臺中市,大里區,樹王里,1385,1797,464,393,857,90,947
公投第１６案,臺中市,大里區,祥興里,1386,1230,364,241,605,47,652
公投第１６案,臺中市,大里區,祥興里,1387,1488,455,268,723,86,809
公投第１６案,臺中市,大里區,祥興里,1388,1459,416,270,686,103,789
公投第１６案,臺中市,大里區,祥興里,1389,1647,484,360,844,90,934
公投第１６案,臺中市,大里區,祥興里,1390,1100,344,265,609,85,694
公投第１６案,臺中市,大里區,內新里,1391,1410,434,305,739,72,811
公投第１６案,臺中市,大里區,內新里,1392,1807,538,323,861,98,959
公投第１６案,臺中市,大里區,內新里,1393,1331,395,301,696,58,754
公投第１６案,臺中市,大里區,內新里,1394,1801,559,345,904,64,968
公投第１６案,臺中市,大里區,內新里,1395,1909,557,336,893,76,969
公投第１６案,臺中市,大里區,中新里,1396,1699,438,309,747,115,862
公投第１６案,臺中市,大里區,中新里,1397,1627,532,334,866,84,950
公投第１６案,臺中市,大里區,中新里,1398,1912,597,352,949,92,1041
公投第１６案,臺中市,大里區,東昇里,1399,1753,489,348,837,108,945
公投第１６案,臺中市,大里區,東昇里,1400,1602,477,310,787,89,876
公投第１６案,臺中市,大里區,大元里,1401,1144,344,220,564,96,660
公投第１６案,臺中市,大里區,大元里,1402,1655,508,353,861,102,963
公投第１６案,臺中市,大里區,大元里,1403,1438,447,281,728,77,805
公投第１６案,臺中市,大里區,夏田里,1404,1000,291,229,520,77,597
公投第１６案,臺中市,大里區,仁化里,1405,1711,535,329,864,95,959
公投第１６案,臺中市,大里區,仁化里,1406,1698,566,281,847,15,862
公投第１６案,臺中市,大里區,仁化里,1407,1914,561,367,928,135,1063
公投第１６案,臺中市,大里區,仁化里,1408,1465,470,284,754,70,824
公投第１６案,臺中市,大里區,仁化里,1409,1581,468,312,780,125,905
公投第１６案,臺中市,大里區,仁德里,1410,1509,473,310,783,115,898
公投第１６案,臺中市,大里區,仁德里,1411,1570,477,278,755,67,822
公投第１６案,臺中市,大里區,仁德里,1412,1425,446,304,750,82,832
公投第１６案,臺中市,大里區,仁德里,1413,1384,385,346,731,91,822
公投第１６案,臺中市,大里區,健民里,1414,1204,325,220,545,40,585
公投第１６案,臺中市,大里區,健民里,1415,1761,487,313,800,62,862
公投第１６案,臺中市,大里區,健民里,1416,1473,390,273,663,44,707
公投第１６案,臺中市,大里區,塗城里,1417,1675,535,327,862,85,947
公投第１６案,臺中市,大里區,塗城里,1418,1755,577,320,897,94,991
公投第１６案,臺中市,大里區,塗城里,1419,1593,484,336,820,122,942
公投第１６案,臺中市,大里區,塗城里,1420,1799,524,380,904,93,997
公投第１６案,臺中市,大里區,塗城里,1421,1606,492,316,808,107,915
公投第１６案,臺中市,大里區,東興里,1422,1875,555,378,933,65,998
公投第１６案,臺中市,大里區,東興里,1423,1670,609,270,879,82,961
公投第１６案,臺中市,大里區,東興里,1424,1898,545,372,917,101,1018
公投第１６案,臺中市,大里區,東興里,1425,1679,500,310,810,66,876
公投第１６案,臺中市,大里區,大明里,1426,1373,388,269,657,97,754
公投第１６案,臺中市,大里區,大明里,1427,1299,412,242,654,99,753
公投第１６案,臺中市,大里區,大明里,1428,1430,457,284,741,67,808
公投第１６案,臺中市,大里區,永隆里,1429,1805,678,392,1070,71,1141
公投第１６案,臺中市,大里區,永隆里,1430,1806,648,457,1105,59,1164
公投第１６案,臺中市,大里區,永隆里,1431,1826,784,329,1113,77,1190
公投第１６案,臺中市,大里區,永隆里,1432,1805,691,411,1102,75,1177
公投第１６案,臺中市,大里區,永隆里,1433,1907,628,439,1067,84,1151
公投第１６案,臺中市,大里區,日新里,1434,1103,376,264,640,60,700
公投第１６案,臺中市,大里區,日新里,1435,1419,431,261,692,59,751
公投第１６案,臺中市,大里區,日新里,1436,1434,414,295,709,90,799
公投第１６案,臺中市,大里區,西榮里,1437,1875,554,274,828,71,899
公投第１６案,臺中市,大里區,西榮里,1438,1862,536,384,920,70,990
公投第１６案,臺中市,大里區,西榮里,1439,1850,536,393,929,61,990
公投第１６案,臺中市,大里區,長榮里,1440,1622,498,358,856,79,935
公投第１６案,臺中市,大里區,長榮里,1441,1638,558,355,913,93,1006
公投第１６案,臺中市,大里區,長榮里,1442,1633,555,369,924,96,1020
公投第１６案,臺中市,大里區,長榮里,1443,1662,542,341,883,73,956
公投第１６案,臺中市,大里區,長榮里,1444,1917,682,386,1068,67,1135
公投第１６案,臺中市,大里區,金城里,1445,1701,445,359,804,89,893
公投第１６案,臺中市,大里區,金城里,1446,1549,443,278,721,110,831
公投第１６案,臺中市,大里區,金城里,1447,1567,473,382,855,79,934
公投第１６案,臺中市,大里區,金城里,1448,1614,503,310,813,98,911
公投第１６案,臺中市,大里區,金城里,1449,1811,554,365,919,131,1050
公投第１６案,臺中市,大里區,金城里,1450,1336,408,283,691,65,756
公投第１６案,臺中市,大里區,立仁里,1451,1759,473,372,845,93,938
公投第１６案,臺中市,大里區,立仁里,1452,1783,502,336,838,101,939
公投第１６案,臺中市,大里區,立仁里,1453,1736,483,318,801,93,894
公投第１６案,臺中市,大里區,立德里,1454,1874,615,361,976,72,1048
公投第１６案,臺中市,大里區,立德里,1455,1889,520,412,932,148,1080
公投第１６案,臺中市,大里區,立德里,1456,1947,577,395,972,72,1044
公投第１６案,臺中市,大里區,立德里,1457,1938,640,407,1047,88,1135
公投第１６案,臺中市,大里區,新仁里,1458,1836,588,340,928,95,1023
公投第１６案,臺中市,大里區,新仁里,1459,1913,591,366,957,90,1047
公投第１６案,臺中市,大里區,新仁里,1460,1913,544,348,892,109,1001
公投第１６案,臺中市,大里區,新仁里,1461,1937,559,367,926,77,1003
公投第１６案,臺中市,大里區,瑞城里,1462,1508,437,322,759,64,823
公投第１６案,臺中市,大里區,瑞城里,1463,1340,429,313,742,40,782
公投第１６案,臺中市,大里區,瑞城里,1464,1656,529,344,873,97,970
公投第１６案,臺中市,大里區,瑞城里,1465,1290,393,267,660,73,733
公投第１６案,臺中市,大里區,瑞城里,1466,1655,509,351,860,63,923
公投第１６案,臺中市,大里區,瑞城里,1467,1260,359,226,585,37,622
公投第１６案,臺中市,大里區,瑞城里,1468,1247,377,294,671,56,727
公投第１６案,臺中市,大里區,瑞城里,1469,1548,391,310,701,161,862
公投第１６案,臺中市,霧峰區,桐林里,1470,1205,408,266,674,70,744
公投第１６案,臺中市,霧峰區,吉峰里,1471,1620,491,342,833,89,922
公投第１６案,臺中市,霧峰區,吉峰里,1472,1559,537,308,845,111,956
公投第１６案,臺中市,霧峰區,吉峰里,1473,1660,535,305,840,96,936
公投第１６案,臺中市,霧峰區,吉峰里,1474,1602,551,340,891,89,980
公投第１６案,臺中市,霧峰區,吉峰里,1475,1325,395,255,650,83,733
公投第１６案,臺中市,霧峰區,吉峰里,1476,1515,485,311,796,95,891
公投第１６案,臺中市,霧峰區,甲寅里,1477,1561,437,347,784,94,878
公投第１６案,臺中市,霧峰區,甲寅里,1478,1691,480,332,812,98,910
公投第１６案,臺中市,霧峰區,甲寅里,1479,1486,472,292,764,93,857
公投第１６案,臺中市,霧峰區,本鄉里,1480,975,300,226,526,86,612
公投第１６案,臺中市,霧峰區,本鄉里,1481,1358,493,283,776,77,853
公投第１６案,臺中市,霧峰區,中正里,1482,1141,410,279,689,70,759
公投第１６案,臺中市,霧峰區,中正里,1483,855,271,204,475,87,562
公投第１６案,臺中市,霧峰區,錦榮里,1484,1202,379,249,628,91,719
公投第１６案,臺中市,霧峰區,萊園里,1485,1078,304,226,530,71,601
公投第１６案,臺中市,霧峰區,本堂里,1486,1456,471,298,769,95,864
公投第１６案,臺中市,霧峰區,本堂里,1487,1573,552,320,872,83,955
公投第１６案,臺中市,霧峰區,本堂里,1488,1591,561,289,850,91,941
公投第１６案,臺中市,霧峰區,本堂里,1489,1214,451,244,695,84,779
公投第１６案,臺中市,霧峰區,北柳里,1490,1267,369,271,640,85,725
公投第１６案,臺中市,霧峰區,北柳里,1491,1277,435,245,680,88,768
公投第１６案,臺中市,霧峰區,北柳里,1492,1366,415,311,726,52,778
公投第１６案,臺中市,霧峰區,南柳里,1493,994,354,231,585,103,688
公投第１６案,臺中市,霧峰區,南柳里,1494,863,295,202,497,44,541
公投第１６案,臺中市,霧峰區,四德里,1495,1274,392,249,641,91,732
公投第１６案,臺中市,霧峰區,四德里,1496,1162,336,243,579,103,682
公投第１６案,臺中市,霧峰區,五福里,1497,1252,397,277,674,105,779
公投第１６案,臺中市,霧峰區,五福里,1498,1322,420,263,683,107,790
公投第１６案,臺中市,霧峰區,丁台里,1499,1116,355,261,616,92,708
公投第１６案,臺中市,霧峰區,丁台里,1500,1156,353,275,628,113,741
公投第１６案,臺中市,霧峰區,北勢里,1501,1147,360,254,614,115,729
公投第１６案,臺中市,霧峰區,北勢里,1502,928,331,216,547,81,628
公投第１６案,臺中市,霧峰區,南勢里,1503,1296,412,237,649,79,728
公投第１６案,臺中市,霧峰區,萬豐里,1504,1314,344,240,584,128,712
公投第１６案,臺中市,霧峰區,萬豐里,1505,1328,418,272,690,111,801
公投第１６案,臺中市,霧峰區,舊正里,1506,989,300,191,491,96,587
公投第１６案,臺中市,霧峰區,舊正里,1507,1088,372,218,590,90,680
公投第１６案,臺中市,霧峰區,坑口里,1508,1363,493,272,765,91,856
公投第１６案,臺中市,霧峰區,坑口里,1509,1573,512,354,866,99,965
公投第１６案,臺中市,霧峰區,峰谷里,1510,1117,303,250,553,93,646
公投第１６案,臺中市,霧峰區,六股里,1511,1342,447,308,755,109,864
公投第１６案,臺中市,霧峰區,六股里,1512,1024,348,226,574,110,684
公投第１６案,臺中市,東勢區,慶福里,1513,1299,376,255,631,93,724
公投第１６案,臺中市,東勢區,慶東里,1514,1007,296,216,512,61,573
公投第１６案,臺中市,東勢區,慶東里,1515,859,224,181,405,75,480
公投第１６案,臺中市,東勢區,上城里,1516,991,347,208,555,94,649
公投第１６案,臺中市,東勢區,下城里,1517,863,228,168,396,40,436
公投第１６案,臺中市,東勢區,詒福里,1518,1628,471,328,799,124,923
公投第１６案,臺中市,東勢區,新盛里,1519,1335,359,262,621,86,707
公投第１６案,臺中市,東勢區,新盛里,1520,1092,264,347,611,87,698
公投第１６案,臺中市,東勢區,新盛里,1521,1050,343,259,602,71,673
公投第１６案,臺中市,東勢區,新盛里,1522,1431,467,273,740,88,828
公投第１６案,臺中市,東勢區,福隆里,1523,1372,455,288,743,79,822
公投第１６案,臺中市,東勢區,福隆里,1524,1412,473,308,781,59,840
公投第１６案,臺中市,東勢區,福隆里,1525,878,264,161,425,92,517
公投第１６案,臺中市,東勢區,隆興里,1526,1475,379,268,647,106,753
公投第１６案,臺中市,東勢區,中嵙里,1527,872,262,167,429,37,466
公投第１６案,臺中市,東勢區,中嵙里,1528,1006,269,190,459,110,569
公投第１６案,臺中市,東勢區,泰昌里,1529,1222,379,255,634,45,679
公投第１６案,臺中市,東勢區,泰昌里,1530,1228,430,302,732,76,808
公投第１６案,臺中市,東勢區,泰昌里,1531,1036,359,217,576,38,614
公投第１６案,臺中市,東勢區,上新里,1532,977,314,232,546,57,603
公投第１６案,臺中市,東勢區,廣興里,1533,1395,456,242,698,65,763
公投第１６案,臺中市,東勢區,延平里,1534,1169,366,253,619,120,739
公投第１６案,臺中市,東勢區,延平里,1535,1027,346,229,575,67,642
公投第１６案,臺中市,東勢區,南平里,1536,984,340,194,534,54,588
公投第１６案,臺中市,東勢區,南平里,1537,866,346,190,536,52,588
公投第１６案,臺中市,東勢區,東安里,1538,1031,288,210,498,139,637
公投第１６案,臺中市,東勢區,中寧里,1539,865,331,176,507,69,576
公投第１６案,臺中市,東勢區,北興里,1540,1357,502,276,778,80,858
公投第１６案,臺中市,東勢區,粵寧里,1541,736,236,178,414,37,451
公投第１６案,臺中市,東勢區,粵寧里,1542,1314,315,384,699,81,780
公投第１６案,臺中市,東勢區,下新里,1543,1677,449,341,790,123,913
公投第１６案,臺中市,東勢區,東新里,1544,950,341,196,537,41,578
公投第１６案,臺中市,東勢區,東新里,1545,1007,345,221,566,63,629
公投第１６案,臺中市,東勢區,興隆里,1546,1214,319,259,578,46,624
公投第１６案,臺中市,東勢區,茂興里,1547,907,281,189,470,50,520
公投第１６案,臺中市,東勢區,茂興里,1548,902,226,214,440,57,497
公投第１６案,臺中市,東勢區,泰興里,1549,720,192,113,305,14,319
公投第１６案,臺中市,東勢區,埤頭里,1550,666,172,111,283,25,308
公投第１６案,臺中市,東勢區,明正里,1551,1361,404,235,639,102,741
公投第１６案,臺中市,石岡區,石岡里,1552,1244,412,244,656,72,728
公投第１６案,臺中市,石岡區,萬安里,1553,1539,470,310,780,80,860
公投第１６案,臺中市,石岡區,九房里,1554,1202,383,275,658,52,710
公投第１６案,臺中市,石岡區,金星里,1555,1272,341,251,592,105,697
公投第１６案,臺中市,石岡區,龍興里,1556,652,207,123,330,60,390
公投第１６案,臺中市,石岡區,萬興里,1557,1457,504,336,840,119,959
公投第１６案,臺中市,石岡區,梅子里,1558,1836,595,315,910,109,1019
公投第１６案,臺中市,石岡區,土牛里,1559,1001,307,214,521,62,583
公投第１６案,臺中市,石岡區,德興里,1560,1448,486,337,823,65,888
公投第１６案,臺中市,石岡區,和盛里,1561,1229,408,269,677,86,763
公投第１６案,臺中市,新社區,新社里,1562,1011,302,221,523,40,563
公投第１６案,臺中市,新社區,新社里,1563,1195,390,251,641,52,693
公投第１６案,臺中市,新社區,新社里,1564,1053,351,251,602,43,645
公投第１６案,臺中市,新社區,復盛里,1565,961,209,148,357,47,404
公投第１６案,臺中市,新社區,復盛里,1566,919,256,191,447,31,478
公投第１６案,臺中市,新社區,中正里,1567,1367,461,276,737,99,836
公投第１６案,臺中市,新社區,月湖里,1568,1010,290,172,462,63,525
公投第１６案,臺中市,新社區,崑山里,1569,1169,268,220,488,80,568
公投第１６案,臺中市,新社區,大南里,1570,989,299,194,493,70,563
公投第１６案,臺中市,新社區,大南里,1571,894,289,145,434,43,477
公投第１６案,臺中市,新社區,永源里,1572,1033,325,173,498,39,537
公投第１６案,臺中市,新社區,永源里,1573,1058,244,158,402,37,439
公投第１６案,臺中市,新社區,永源里,1574,845,224,149,373,30,403
公投第１６案,臺中市,新社區,中興里,1575,576,166,190,356,35,391
公投第１６案,臺中市,新社區,協成里,1576,1229,331,212,543,82,625
公投第１６案,臺中市,新社區,協成里,1577,890,202,145,347,53,400
公投第１６案,臺中市,新社區,協成里,1578,781,205,146,351,53,404
公投第１６案,臺中市,新社區,東興里,1579,1244,387,234,621,58,679
公投第１６案,臺中市,新社區,慶西里,1580,213,42,29,71,10,81
公投第１６案,臺中市,新社區,慶西里,1581,676,157,124,281,29,310
公投第１６案,臺中市,新社區,中和里,1582,585,162,84,246,36,282
公投第１６案,臺中市,新社區,福興里,1583,938,280,171,451,75,526
公投第１６案,臺中市,新社區,福興里,1584,224,63,40,103,8,111
公投第１６案,臺中市,和平區,南勢里,1585,956,309,244,553,59,612
公投第１６案,臺中市,和平區,南勢里,1586,963,342,209,551,68,619
公投第１６案,臺中市,和平區,天輪里,1587,456,142,104,246,13,259
公投第１６案,臺中市,和平區,博愛里,1588,1011,355,212,567,73,640
公投第１６案,臺中市,和平區,博愛里,1589,636,222,129,351,27,378
公投第１６案,臺中市,和平區,自由里,1590,270,85,55,140,9,149
公投第１６案,臺中市,和平區,自由里,1591,460,226,95,321,36,357
公投第１６案,臺中市,和平區,自由里,1592,321,137,87,224,18,242
公投第１６案,臺中市,和平區,達觀里,1593,783,253,188,441,54,495
公投第１６案,臺中市,和平區,達觀里,1594,336,125,65,190,10,200
公投第１６案,臺中市,和平區,中坑里,1595,451,162,135,297,16,313
公投第１６案,臺中市,和平區,梨山里,1596,366,96,81,177,16,193
公投第１６案,臺中市,和平區,梨山里,1597,771,198,113,311,14,325
公投第１６案,臺中市,和平區,梨山里,1598,574,172,102,274,43,317
公投第１６案,臺中市,和平區,梨山里,1599,274,73,63,136,32,168
公投第１６案,臺中市,和平區,平等里,1600,157,35,45,80,7,87
公投第１６案,臺中市,和平區,平等里,1601,713,185,134,319,34,353
公投第１６案,臺南市,後壁區,後壁里,1,743,205,162,367,58,425
公投第１６案,臺南市,後壁區,後壁里,2,898,208,180,388,45,433
公投第１６案,臺南市,後壁區,侯伯里,3,786,181,121,302,68,370
公投第１６案,臺南市,後壁區,侯伯里,4,534,108,100,208,64,272
公投第１６案,臺南市,後壁區,嘉苳里,5,1034,263,180,443,87,530
公投第１６案,臺南市,後壁區,嘉苳里,6,232,44,45,89,17,106
公投第１６案,臺南市,後壁區,土溝里,7,479,102,85,187,47,234
公投第１６案,臺南市,後壁區,土溝里,8,837,175,158,333,43,376
公投第１６案,臺南市,後壁區,上茄苳里,9,1085,209,175,384,45,429
公投第１６案,臺南市,後壁區,上茄苳里,10,1157,220,153,373,22,395
公投第１６案,臺南市,後壁區,菁豐里,11,755,186,119,305,80,385
公投第１６案,臺南市,後壁區,菁豐里,12,458,126,78,204,42,246
公投第１６案,臺南市,後壁區,菁寮里,13,371,87,59,146,26,172
公投第１６案,臺南市,後壁區,菁寮里,14,676,143,123,266,61,327
公投第１６案,臺南市,後壁區,菁寮里,15,428,94,58,152,40,192
公投第１６案,臺南市,後壁區,新嘉里,16,547,103,74,177,18,195
公投第１６案,臺南市,後壁區,新嘉里,17,455,97,86,183,49,232
公投第１６案,臺南市,後壁區,長短樹里,18,984,173,152,325,78,403
公投第１６案,臺南市,後壁區,長短樹里,19,483,108,78,186,37,223
公投第１６案,臺南市,後壁區,長短樹里,20,536,126,66,192,33,225
公投第１６案,臺南市,後壁區,竹新里,21,958,177,113,290,16,306
公投第１６案,臺南市,後壁區,竹新里,22,441,132,78,210,41,251
公投第１６案,臺南市,後壁區,新東里,23,677,153,134,287,70,357
公投第１６案,臺南市,後壁區,新東里,24,996,252,185,437,80,517
公投第１６案,臺南市,後壁區,頂安里,25,1255,282,231,513,34,547
公投第１６案,臺南市,後壁區,長安里,26,678,164,107,271,20,291
公投第１６案,臺南市,後壁區,長安里,27,553,98,86,184,16,200
公投第１６案,臺南市,後壁區,福安里,28,616,119,79,198,20,218
公投第１６案,臺南市,後壁區,福安里,29,1189,281,203,484,48,532
公投第１６案,臺南市,白河區,白河里,30,1176,308,231,539,83,622
公投第１６案,臺南市,白河區,白河里,31,546,152,97,249,21,270
公投第１６案,臺南市,白河區,永安里,32,859,245,183,428,35,463
公投第１６案,臺南市,白河區,永安里,33,946,264,189,453,59,512
公投第１６案,臺南市,白河區,永安里,34,1116,278,213,491,58,549
公投第１６案,臺南市,白河區,外角里,35,1397,300,185,485,38,523
公投第１６案,臺南市,白河區,庄內里,36,756,159,103,262,23,285
公投第１６案,臺南市,白河區,庄內里,37,871,216,150,366,58,424
公投第１６案,臺南市,白河區,秀祐里,38,897,228,168,396,48,444
公投第１６案,臺南市,白河區,河東里,39,784,118,104,222,40,262
公投第１６案,臺南市,白河區,河東里,40,572,122,87,209,26,235
公投第１６案,臺南市,白河區,虎山里,41,457,74,53,127,9,136
公投第１６案,臺南市,白河區,大林里,42,600,98,74,172,24,196
公投第１６案,臺南市,白河區,崁頭里,43,375,65,38,103,5,108
公投第１６案,臺南市,白河區,六溪里,44,508,61,50,111,15,126
公投第１６案,臺南市,白河區,關嶺里,45,631,81,86,167,12,179
公投第１６案,臺南市,白河區,關嶺里,46,391,57,40,97,16,113
公投第１６案,臺南市,白河區,仙草里,47,799,119,102,221,21,242
公投第１６案,臺南市,白河區,仙草里,48,506,74,60,134,23,157
公投第１６案,臺南市,白河區,詔豐里,49,832,179,113,292,44,336
公投第１６案,臺南市,白河區,詔豐里,50,1179,274,212,486,42,528
公投第１６案,臺南市,白河區,大竹里,51,744,117,106,223,14,237
公投第１６案,臺南市,白河區,大竹里,52,699,139,94,233,29,262
公投第１６案,臺南市,白河區,廣蓮里,53,633,99,94,193,16,209
公投第１６案,臺南市,白河區,廣蓮里,54,859,213,164,377,81,458
公投第１６案,臺南市,白河區,竹門里,55,884,204,121,325,56,381
公投第１６案,臺南市,白河區,崎內里,56,740,92,85,177,16,193
公投第１６案,臺南市,白河區,昇安里,57,1334,294,188,482,66,548
公投第１６案,臺南市,白河區,汴頭里,58,723,164,108,272,81,353
公投第１６案,臺南市,白河區,內角里,59,682,172,124,296,80,376
公投第１６案,臺南市,白河區,馬稠後里,60,855,221,155,376,63,439
公投第１６案,臺南市,白河區,馬稠後里,61,543,107,71,178,36,214
公投第１６案,臺南市,東山區,東山里,62,1401,316,222,538,82,620
公投第１６案,臺南市,東山區,東中里,63,1185,241,170,411,54,465
公投第１６案,臺南市,東山區,東中里,64,1303,239,206,445,84,529
公投第１６案,臺南市,東山區,東正里,65,732,154,100,254,38,292
公投第１６案,臺南市,東山區,東正里,66,721,135,86,221,51,272
公投第１６案,臺南市,東山區,大客里,67,1104,196,142,338,59,397
公投第１６案,臺南市,東山區,三榮里,68,943,188,129,317,42,359
公投第１６案,臺南市,東山區,科里里,69,653,81,53,134,3,137
公投第１６案,臺南市,東山區,科里里,70,596,127,86,213,77,290
公投第１６案,臺南市,東山區,東河里,71,878,189,132,321,75,396
公投第１６案,臺南市,東山區,聖賢里,72,771,122,134,256,64,320
公投第１６案,臺南市,東山區,聖賢里,73,483,105,80,185,25,210
公投第１６案,臺南市,東山區,聖賢里,74,640,171,99,270,47,317
公投第１６案,臺南市,東山區,南溪里,75,425,47,43,90,7,97
公投第１６案,臺南市,東山區,水雲里,76,394,81,47,128,17,145
公投第１６案,臺南市,東山區,林安里,77,373,85,68,153,36,189
公投第１６案,臺南市,東山區,東原里,78,1257,200,150,350,52,402
公投第１６案,臺南市,東山區,東原里,79,887,113,74,187,12,199
公投第１６案,臺南市,東山區,嶺南里,80,658,102,48,150,11,161
公投第１６案,臺南市,東山區,南勢里,81,1101,148,125,273,39,312
公投第１６案,臺南市,東山區,青山里,82,1057,145,97,242,19,261
公投第１６案,臺南市,東山區,高原里,83,639,144,107,251,50,301
公投第１６案,臺南市,東山區,高原里,84,270,43,53,96,21,117
公投第１６案,臺南市,鹽水區,水秀里,85,1037,271,203,474,80,554
公投第１６案,臺南市,鹽水區,水秀里,86,480,121,110,231,26,257
公投第１６案,臺南市,鹽水區,津城里,87,636,200,136,336,43,379
公投第１６案,臺南市,鹽水區,津城里,88,321,72,64,136,16,152
公投第１６案,臺南市,鹽水區,津城里,89,497,162,92,254,40,294
公投第１６案,臺南市,鹽水區,月港里,90,759,222,178,400,25,425
公投第１６案,臺南市,鹽水區,月港里,91,341,88,50,138,25,163
公投第１６案,臺南市,鹽水區,月港里,92,507,121,118,239,32,271
公投第１６案,臺南市,鹽水區,橋南里,93,863,171,164,335,28,363
公投第１６案,臺南市,鹽水區,橋南里,94,1373,321,263,584,42,626
公投第１６案,臺南市,鹽水區,橋南里,95,1507,397,283,680,70,750
公投第１６案,臺南市,鹽水區,岸內里,96,1374,368,275,643,83,726
公投第１６案,臺南市,鹽水區,岸內里,97,1244,297,204,501,69,570
公投第１６案,臺南市,鹽水區,岸內里,98,1022,284,188,472,63,535
公投第１６案,臺南市,鹽水區,汫水里,99,921,166,114,280,49,329
公投第１６案,臺南市,鹽水區,義中里,100,847,201,197,398,59,457
公投第１６案,臺南市,鹽水區,義中里,101,736,121,118,239,3,242
公投第１６案,臺南市,鹽水區,三明里,102,761,190,139,329,25,354
公投第１６案,臺南市,鹽水區,三明里,103,285,76,50,126,14,140
公投第１６案,臺南市,鹽水區,三明里,104,493,104,87,191,34,225
公投第１６案,臺南市,鹽水區,文昌里,105,621,138,72,210,23,233
公投第１６案,臺南市,鹽水區,文昌里,106,392,77,46,123,10,133
公投第１６案,臺南市,鹽水區,歡雅里,107,925,229,145,374,45,419
公投第１６案,臺南市,鹽水區,歡雅里,108,728,152,110,262,46,308
公投第１６案,臺南市,鹽水區,三和里,109,214,22,30,52,28,80
公投第１６案,臺南市,鹽水區,三和里,110,387,98,60,158,18,176
公投第１６案,臺南市,鹽水區,三和里,111,301,86,38,124,26,150
公投第１６案,臺南市,鹽水區,竹林里,112,755,131,117,248,40,288
公投第１６案,臺南市,鹽水區,竹林里,113,365,65,58,123,25,148
公投第１６案,臺南市,鹽水區,坔頭港里,114,935,215,151,366,36,402
公投第１６案,臺南市,鹽水區,坔頭港里,115,494,113,61,174,40,214
公投第１６案,臺南市,新營區,忠政里,116,1693,426,290,716,78,794
公投第１６案,臺南市,新營區,忠政里,117,1561,449,289,738,131,869
公投第１６案,臺南市,新營區,忠政里,118,1487,436,300,736,67,803
公投第１６案,臺南市,新營區,民權里,119,1232,332,252,584,43,627
公投第１６案,臺南市,新營區,民權里,120,1067,296,213,509,30,539
公投第１６案,臺南市,新營區,三仙里,121,1419,345,249,594,46,640
公投第１６案,臺南市,新營區,三仙里,122,1466,483,253,736,43,779
公投第１６案,臺南市,新營區,永平里,123,932,269,228,497,72,569
公投第１６案,臺南市,新營區,永平里,124,1099,266,186,452,37,489
公投第１６案,臺南市,新營區,永平里,125,757,183,129,312,40,352
公投第１６案,臺南市,新營區,大宏里,126,888,239,223,462,35,497
公投第１６案,臺南市,新營區,大宏里,127,1115,295,218,513,32,545
公投第１６案,臺南市,新營區,大宏里,128,937,234,176,410,27,437
公投第１６案,臺南市,新營區,王公里,129,1387,379,250,629,54,683
公投第１６案,臺南市,新營區,王公里,130,1526,494,195,689,67,756
公投第１６案,臺南市,新營區,王公里,131,1301,417,269,686,43,729
公投第１６案,臺南市,新營區,新東里,132,1538,496,304,800,65,865
公投第１６案,臺南市,新營區,新東里,133,1584,509,292,801,52,853
公投第１６案,臺南市,新營區,新東里,134,1583,550,313,863,37,900
公投第１６案,臺南市,新營區,新東里,135,1530,469,292,761,74,835
公投第１６案,臺南市,新營區,中營里,136,1193,349,279,628,65,693
公投第１６案,臺南市,新營區,土庫里,137,1439,305,198,503,26,529
公投第１６案,臺南市,新營區,興業里,138,1438,439,309,748,64,812
公投第１６案,臺南市,新營區,興業里,139,359,96,89,185,25,210
公投第１６案,臺南市,新營區,南興里,140,1233,258,198,456,47,503
公投第１６案,臺南市,新營區,南興里,141,1227,300,165,465,31,496
公投第１６案,臺南市,新營區,民生里,142,1320,306,255,561,25,586
公投第１６案,臺南市,新營區,民生里,143,1930,479,264,743,40,783
公投第１６案,臺南市,新營區,新北里,144,1501,456,264,720,70,790
公投第１６案,臺南市,新營區,新北里,145,1475,394,270,664,53,717
公投第１６案,臺南市,新營區,新北里,146,1753,531,333,864,71,935
公投第１６案,臺南市,新營區,新南里,147,1748,455,328,783,59,842
公投第１６案,臺南市,新營區,新南里,148,1741,491,328,819,66,885
公投第１６案,臺南市,新營區,新南里,149,1433,372,276,648,32,680
公投第１６案,臺南市,新營區,民榮里,150,1595,464,292,756,72,828
公投第１６案,臺南市,新營區,民榮里,151,959,223,169,392,15,407
公投第１６案,臺南市,新營區,民榮里,152,1865,627,305,932,105,1037
公投第１６案,臺南市,新營區,埤寮里,153,1678,385,298,683,98,781
公投第１６案,臺南市,新營區,護鎮里,154,1373,327,230,557,60,617
公投第１６案,臺南市,新營區,太南里,155,1431,272,210,482,45,527
公投第１６案,臺南市,新營區,太南里,156,291,63,32,95,1,96
公投第１６案,臺南市,新營區,太北里,157,1749,445,346,791,54,845
公投第１６案,臺南市,新營區,南紙里,158,1862,497,278,775,49,824
公投第１６案,臺南市,新營區,南紙里,159,1821,532,328,860,118,978
公投第１６案,臺南市,新營區,嘉芳里,160,1845,459,317,776,70,846
公投第１６案,臺南市,新營區,姑爺里,161,542,107,71,178,13,191
公投第１６案,臺南市,新營區,姑爺里,162,402,85,48,133,3,136
公投第１６案,臺南市,新營區,五興里,163,703,179,162,341,70,411
公投第１６案,臺南市,新營區,五興里,164,941,226,147,373,50,423
公投第１６案,臺南市,柳營區,士林里,165,1166,271,227,498,65,563
公投第１６案,臺南市,柳營區,士林里,166,625,183,137,320,19,339
公投第１６案,臺南市,柳營區,光福里,167,738,164,114,278,31,309
公投第１６案,臺南市,柳營區,光福里,168,834,254,148,402,34,436
公投第１６案,臺南市,柳營區,中埕里,169,1104,262,196,458,43,501
公投第１６案,臺南市,柳營區,東昇里,170,1015,235,167,402,27,429
公投第１６案,臺南市,柳營區,東昇里,171,1720,490,310,800,139,939
公投第１６案,臺南市,柳營區,八翁里,172,1391,345,231,576,81,657
公投第１６案,臺南市,柳營區,人和里,173,425,95,79,174,10,184
公投第１６案,臺南市,柳營區,人和里,174,318,56,47,103,24,127
公投第１６案,臺南市,柳營區,太康里,175,753,197,132,329,49,378
公投第１６案,臺南市,柳營區,太康里,176,730,173,102,275,69,344
公投第１６案,臺南市,柳營區,重溪里,177,725,172,133,305,48,353
公投第１６案,臺南市,柳營區,重溪里,178,787,235,135,370,50,420
公投第１６案,臺南市,柳營區,重溪里,179,297,75,64,139,31,170
公投第１６案,臺南市,柳營區,篤農里,180,673,199,115,314,55,369
公投第１６案,臺南市,柳營區,篤農里,181,640,187,119,306,64,370
公投第１６案,臺南市,柳營區,大農里,182,660,158,103,261,24,285
公投第１６案,臺南市,柳營區,神農里,183,1212,274,187,461,56,517
公投第１６案,臺南市,柳營區,神農里,184,202,55,31,86,3,89
公投第１６案,臺南市,柳營區,果毅里,185,1049,243,165,408,98,506
公投第１６案,臺南市,柳營區,果毅里,186,158,37,32,69,2,71
公投第１６案,臺南市,柳營區,旭山里,187,921,224,153,377,87,464
公投第１６案,臺南市,柳營區,旭山里,188,504,112,71,183,25,208
公投第１６案,臺南市,柳營區,旭山里,189,157,38,21,59,6,65
公投第１６案,臺南市,北門區,永隆里,190,484,105,81,186,16,202
公投第１６案,臺南市,北門區,永隆里,191,401,103,44,147,18,165
公投第１６案,臺南市,北門區,北門里,192,456,93,54,147,8,155
公投第１６案,臺南市,北門區,北門里,193,382,110,74,184,20,204
公投第１６案,臺南市,北門區,玉港里,194,356,93,60,153,24,177
公投第１６案,臺南市,北門區,玉港里,195,389,73,59,132,7,139
公投第１６案,臺南市,北門區,保吉里,196,742,171,111,282,12,294
公投第１６案,臺南市,北門區,保吉里,197,599,143,73,216,15,231
公投第１６案,臺南市,北門區,蚵寮里,198,594,116,92,208,35,243
公投第１６案,臺南市,北門區,蚵寮里,199,572,110,108,218,26,244
公投第１６案,臺南市,北門區,蚵寮里,200,318,52,37,89,4,93
公投第１６案,臺南市,北門區,雙春里,201,473,92,70,162,17,179
公投第１６案,臺南市,北門區,錦湖里,202,954,168,106,274,15,289
公投第１６案,臺南市,北門區,慈安里,203,737,207,137,344,45,389
公投第１６案,臺南市,北門區,三光里,204,679,122,86,208,13,221
公投第１６案,臺南市,北門區,三光里,205,521,94,70,164,33,197
公投第１６案,臺南市,北門區,文山里,206,632,109,76,185,24,209
公投第１６案,臺南市,北門區,文山里,207,636,128,84,212,15,227
公投第１６案,臺南市,學甲區,秀昌里,208,862,232,175,407,73,480
公投第１６案,臺南市,學甲區,秀昌里,209,611,186,135,321,11,332
公投第１６案,臺南市,學甲區,秀昌里,210,936,237,203,440,36,476
公投第１６案,臺南市,學甲區,明宜里,211,1066,251,205,456,46,502
公投第１６案,臺南市,學甲區,明宜里,212,869,236,201,437,41,478
公投第１６案,臺南市,學甲區,慈福里,213,635,175,113,288,37,325
公投第１６案,臺南市,學甲區,慈福里,214,822,217,134,351,25,376
公投第１６案,臺南市,學甲區,慈福里,215,443,101,67,168,19,187
公投第１６案,臺南市,學甲區,仁得里,216,1370,373,267,640,45,685
公投第１６案,臺南市,學甲區,仁得里,217,1117,339,203,542,62,604
公投第１６案,臺南市,學甲區,仁得里,218,1365,358,228,586,94,680
公投第１６案,臺南市,學甲區,新達里,219,1489,380,241,621,92,713
公投第１６案,臺南市,學甲區,新達里,220,627,114,96,210,46,256
公投第１６案,臺南市,學甲區,新榮里,221,1052,274,204,478,31,509
公投第１６案,臺南市,學甲區,新榮里,222,1183,298,219,517,37,554
公投第１６案,臺南市,學甲區,大灣里,223,979,215,145,360,31,391
公投第１６案,臺南市,學甲區,豐和里,224,1241,244,233,477,81,558
公投第１６案,臺南市,學甲區,中洲里,225,843,171,128,299,27,326
公投第１６案,臺南市,學甲區,中洲里,226,580,142,99,241,38,279
公投第１６案,臺南市,學甲區,光華里,227,832,179,97,276,19,295
公投第１６案,臺南市,學甲區,光華里,228,406,60,77,137,12,149
公投第１６案,臺南市,學甲區,宅港里,229,818,234,149,383,42,425
公投第１６案,臺南市,學甲區,平和里,230,1052,212,151,363,27,390
公投第１６案,臺南市,學甲區,三慶里,231,578,112,111,223,12,235
公投第１６案,臺南市,學甲區,三慶里,232,430,75,65,140,28,168
公投第１６案,臺南市,學甲區,三慶里,233,361,96,57,153,12,165
公投第１６案,臺南市,將軍區,長榮里,234,1110,335,220,555,72,627
公投第１６案,臺南市,將軍區,西甲里,235,1418,450,249,699,45,744
公投第１６案,臺南市,將軍區,西甲里,236,969,225,179,404,29,433
公投第１６案,臺南市,將軍區,忠嘉里,237,519,136,120,256,49,305
公投第１６案,臺南市,將軍區,忠嘉里,238,1106,272,198,470,44,514
公投第１６案,臺南市,將軍區,忠嘉里,239,542,131,95,226,43,269
公投第１６案,臺南市,將軍區,忠嘉里,240,315,57,48,105,12,117
公投第１６案,臺南市,將軍區,苓仔寮里,241,584,129,77,206,32,238
公投第１６案,臺南市,將軍區,苓仔寮里,242,398,91,70,161,14,175
公投第１６案,臺南市,將軍區,苓仔寮里,243,608,119,89,208,23,231
公投第１６案,臺南市,將軍區,苓仔寮里,244,442,116,82,198,20,218
公投第１６案,臺南市,將軍區,巷埔里,245,650,100,117,217,15,232
公投第１６案,臺南市,將軍區,巷埔里,246,573,98,75,173,14,187
公投第１６案,臺南市,將軍區,將軍里,247,617,126,71,197,13,210
公投第１６案,臺南市,將軍區,將軍里,248,573,143,97,240,24,264
公投第１６案,臺南市,將軍區,將軍里,249,434,114,70,184,30,214
公投第１６案,臺南市,將軍區,玉山里,250,849,164,124,288,21,309
公投第１６案,臺南市,將軍區,廣山里,251,645,143,85,228,29,257
公投第１６案,臺南市,將軍區,長沙里,252,690,118,93,211,16,227
公投第１６案,臺南市,將軍區,長沙里,253,663,94,80,174,13,187
公投第１６案,臺南市,將軍區,平沙里,254,1175,233,166,399,40,439
公投第１６案,臺南市,將軍區,鯤鯓里,255,837,150,94,244,34,278
公投第１６案,臺南市,將軍區,鯤鯓里,256,1061,239,180,419,136,555
公投第１６案,臺南市,將軍區,鯤溟里,257,976,181,99,280,26,306
公投第１６案,臺南市,七股區,後港里,258,534,129,91,220,19,239
公投第１６案,臺南市,七股區,後港里,259,508,132,107,239,21,260
公投第１６案,臺南市,七股區,大潭里,260,665,132,72,204,8,212
公投第１６案,臺南市,七股區,篤加里,261,834,195,119,314,24,338
公投第１６案,臺南市,七股區,頂山里,262,810,162,115,277,22,299
公投第１６案,臺南市,七股區,西寮里,263,480,83,52,135,12,147
公投第１６案,臺南市,七股區,塩埕里,264,445,90,61,151,10,161
公投第１６案,臺南市,七股區,中寮里,265,680,113,67,180,13,193
公投第１６案,臺南市,七股區,龍山里,266,838,147,97,244,14,258
公投第１６案,臺南市,七股區,龍山里,267,780,137,87,224,30,254
公投第１６案,臺南市,七股區,溪南里,268,350,91,72,163,21,184
公投第１６案,臺南市,七股區,七股里,269,907,254,182,436,82,518
公投第１６案,臺南市,七股區,玉成里,270,780,172,113,285,31,316
公投第１６案,臺南市,七股區,大埕里,271,1658,395,243,638,49,687
公投第１６案,臺南市,七股區,大埕里,272,913,228,125,353,36,389
公投第１６案,臺南市,七股區,樹林里,273,1202,299,211,510,81,591
公投第１６案,臺南市,七股區,樹林里,274,696,126,101,227,11,238
公投第１６案,臺南市,七股區,竹橋里,275,647,155,109,264,42,306
公投第１６案,臺南市,七股區,竹橋里,276,622,197,127,324,63,387
公投第１６案,臺南市,七股區,義合里,277,1175,307,246,553,114,667
公投第１６案,臺南市,七股區,義合里,278,698,136,141,277,25,302
公投第１６案,臺南市,七股區,永吉里,279,983,268,165,433,75,508
公投第１６案,臺南市,七股區,三股里,280,1366,252,179,431,55,486
公投第１６案,臺南市,七股區,十份里,281,1379,311,205,516,89,605
公投第１６案,臺南市,佳里區,東寧里,282,1391,389,302,691,81,772
公投第１６案,臺南市,佳里區,東寧里,283,829,267,171,438,44,482
公投第１６案,臺南市,佳里區,忠仁里,284,1401,325,214,539,80,619
公投第１６案,臺南市,佳里區,忠仁里,285,1452,352,233,585,22,607
公投第１６案,臺南市,佳里區,鎮山里,286,1382,399,273,672,66,738
公投第１６案,臺南市,佳里區,鎮山里,287,1463,438,264,702,71,773
公投第１６案,臺南市,佳里區,鎮山里,288,1280,328,238,566,57,623
公投第１６案,臺南市,佳里區,鎮山里,289,1486,428,271,699,104,803
公投第１６案,臺南市,佳里區,安西里,290,1378,411,280,691,67,758
公投第１６案,臺南市,佳里區,安西里,291,1505,455,276,731,74,805
公投第１６案,臺南市,佳里區,安西里,292,1860,524,340,864,106,970
公投第１６案,臺南市,佳里區,安西里,293,1134,304,193,497,136,633
公投第１６案,臺南市,佳里區,文新里,294,1426,426,266,692,64,756
公投第１６案,臺南市,佳里區,文新里,295,1779,515,346,861,76,937
公投第１６案,臺南市,佳里區,文新里,296,1906,599,356,955,82,1037
公投第１６案,臺南市,佳里區,建南里,297,1425,380,267,647,66,713
公投第１６案,臺南市,佳里區,建南里,298,1255,359,239,598,57,655
公投第１６案,臺南市,佳里區,建南里,299,1524,406,241,647,99,746
公投第１６案,臺南市,佳里區,南勢里,300,1631,469,288,757,55,812
公投第１６案,臺南市,佳里區,南勢里,301,1546,464,320,784,75,859
公投第１６案,臺南市,佳里區,南勢里,302,1187,388,268,656,49,705
公投第１６案,臺南市,佳里區,六安里,303,1381,410,254,664,49,713
公投第１６案,臺南市,佳里區,六安里,304,1364,376,248,624,34,658
公投第１６案,臺南市,佳里區,六安里,305,1314,389,271,660,27,687
公投第１６案,臺南市,佳里區,佳化里,306,1164,350,211,561,75,636
公投第１６案,臺南市,佳里區,佳化里,307,961,276,181,457,54,511
公投第１６案,臺南市,佳里區,佳興里,308,1218,308,215,523,67,590
公投第１６案,臺南市,佳里區,佳興里,309,919,260,180,440,45,485
公投第１６案,臺南市,佳里區,營溪里,310,689,187,127,314,33,347
公投第１６案,臺南市,佳里區,營溪里,311,383,78,77,155,14,169
公投第１６案,臺南市,佳里區,海澄里,312,1507,379,257,636,83,719
公投第１６案,臺南市,佳里區,海澄里,313,702,200,99,299,45,344
公投第１６案,臺南市,佳里區,下營里,314,907,288,154,442,52,494
公投第１６案,臺南市,佳里區,下營里,315,937,281,210,491,64,555
公投第１６案,臺南市,佳里區,塭內里,316,1030,225,210,435,111,546
公投第１６案,臺南市,佳里區,塭內里,317,981,258,190,448,61,509
公投第１６案,臺南市,佳里區,塭內里,318,787,187,136,323,23,346
公投第１６案,臺南市,佳里區,民安里,319,1513,366,307,673,92,765
公投第１６案,臺南市,佳里區,子龍里,320,714,155,114,269,20,289
公投第１６案,臺南市,佳里區,子龍里,321,745,169,146,315,54,369
公投第１６案,臺南市,佳里區,子龍里,322,951,206,182,388,33,421
公投第１６案,臺南市,西港區,西港里,323,933,255,164,419,23,442
公投第１６案,臺南市,西港區,西港里,324,901,232,199,431,33,464
公投第１６案,臺南市,西港區,西港里,325,1314,329,222,551,38,589
公投第１６案,臺南市,西港區,慶安里,326,1349,334,272,606,88,694
公投第１６案,臺南市,西港區,慶安里,327,1014,278,213,491,72,563
公投第１６案,臺南市,西港區,慶安里,328,1900,389,265,654,61,715
公投第１６案,臺南市,西港區,南海里,329,1663,393,271,664,59,723
公投第１６案,臺南市,西港區,南海里,330,738,140,136,276,21,297
公投第１６案,臺南市,西港區,港東里,331,1211,353,225,578,66,644
公投第１６案,臺南市,西港區,港東里,332,382,86,66,152,30,182
公投第１６案,臺南市,西港區,檨林里,333,786,194,126,320,17,337
公投第１６案,臺南市,西港區,檨林里,334,838,201,143,344,25,369
公投第１６案,臺南市,西港區,後營里,335,1449,306,238,544,52,596
公投第１６案,臺南市,西港區,營西里,336,1479,284,233,517,49,566
公投第１６案,臺南市,西港區,金砂里,337,763,216,139,355,69,424
公投第１６案,臺南市,西港區,劉厝里,338,1297,290,206,496,38,534
公投第１６案,臺南市,西港區,竹林里,339,1393,334,226,560,44,604
公投第１６案,臺南市,西港區,永樂里,340,958,196,141,337,21,358
公投第１６案,臺南市,西港區,永樂里,341,391,115,66,181,20,201
公投第１６案,臺南市,西港區,新復里,342,805,205,161,366,54,420
公投第１６案,臺南市,下營區,下營里,343,1558,344,231,575,56,631
公投第１６案,臺南市,下營區,仁里里,344,1112,225,164,389,40,429
公投第１６案,臺南市,下營區,仁里里,345,893,205,156,361,61,422
公投第１６案,臺南市,下營區,宅內里,346,1623,329,252,581,64,645
公投第１６案,臺南市,下營區,後街里,347,1568,389,274,663,97,760
公投第１６案,臺南市,下營區,新興里,348,985,251,196,447,59,506
公投第１６案,臺南市,下營區,新興里,349,953,247,136,383,23,406
公投第１６案,臺南市,下營區,營前里,350,1031,258,173,431,35,466
公投第１６案,臺南市,下營區,營前里,351,1077,311,201,512,86,598
公投第１６案,臺南市,下營區,大吉里,352,703,130,108,238,45,283
公投第１６案,臺南市,下營區,大吉里,353,854,186,138,324,23,347
公投第１６案,臺南市,下營區,茅營里,354,1164,283,206,489,68,557
公投第１６案,臺南市,下營區,茅營里,355,1091,248,182,430,28,458
公投第１６案,臺南市,下營區,開化里,356,959,247,174,421,69,490
公投第１６案,臺南市,下營區,開化里,357,935,238,157,395,39,434
公投第１６案,臺南市,下營區,西連里,358,893,233,163,396,54,450
公投第１６案,臺南市,下營區,賀建里,359,1293,368,205,573,99,672
公投第１６案,臺南市,下營區,紅甲里,360,1185,302,221,523,103,626
公投第１６案,臺南市,下營區,紅甲里,361,1070,209,144,353,22,375
公投第１６案,臺南市,六甲區,六甲里,362,819,230,177,407,59,466
公投第１６案,臺南市,六甲區,六甲里,363,645,166,137,303,18,321
公投第１６案,臺南市,六甲區,六甲里,364,1444,283,316,599,52,651
公投第１６案,臺南市,六甲區,甲東里,365,1554,316,266,582,50,632
公投第１６案,臺南市,六甲區,甲東里,366,1171,243,193,436,46,482
公投第１６案,臺南市,六甲區,甲南里,367,1351,325,252,577,70,647
公投第１６案,臺南市,六甲區,七甲里,368,1010,218,164,382,83,465
公投第１６案,臺南市,六甲區,七甲里,369,919,218,154,372,62,434
公投第１６案,臺南市,六甲區,二甲里,370,1369,328,249,577,76,653
公投第１６案,臺南市,六甲區,二甲里,371,976,266,170,436,69,505
公投第１６案,臺南市,六甲區,二甲里,372,1015,296,198,494,58,552
公投第１６案,臺南市,六甲區,水林里,373,1176,282,194,476,46,522
公投第１６案,臺南市,六甲區,水林里,374,939,233,193,426,56,482
公投第１６案,臺南市,六甲區,中社里,375,712,174,143,317,56,373
公投第１６案,臺南市,六甲區,中社里,376,881,225,181,406,50,456
公投第１６案,臺南市,六甲區,龜港里,377,1184,347,269,616,71,687
公投第１６案,臺南市,六甲區,菁埔里,378,599,178,148,326,35,361
公投第１６案,臺南市,六甲區,王爺里,379,759,126,91,217,12,229
公投第１６案,臺南市,六甲區,大丘里,380,621,120,96,216,28,244
公投第１６案,臺南市,麻豆區,新興里,381,1205,309,234,543,61,604
公投第１６案,臺南市,麻豆區,新興里,382,660,178,152,330,37,367
公投第１６案,臺南市,麻豆區,巷口里,383,523,136,121,257,32,289
公投第１６案,臺南市,麻豆區,巷口里,384,1597,501,226,727,52,779
公投第１６案,臺南市,麻豆區,東角里,385,1262,358,276,634,68,702
公投第１６案,臺南市,麻豆區,東角里,386,1325,386,306,692,57,749
公投第１６案,臺南市,麻豆區,晋江里,387,1384,359,260,619,46,665
公投第１６案,臺南市,麻豆區,晋江里,388,1121,304,231,535,30,565
公投第１６案,臺南市,麻豆區,中興里,389,1021,224,232,456,21,477
公投第１６案,臺南市,麻豆區,中興里,390,954,126,312,438,27,465
公投第１６案,臺南市,麻豆區,興農里,391,1513,343,265,608,40,648
公投第１６案,臺南市,麻豆區,油車里,392,1726,385,302,687,61,748
公投第１６案,臺南市,麻豆區,油車里,393,1804,497,325,822,84,906
公投第１６案,臺南市,麻豆區,北勢里,394,1106,245,211,456,45,501
公投第１６案,臺南市,麻豆區,大埕里,395,1503,393,313,706,50,756
公投第１６案,臺南市,麻豆區,大埕里,396,1302,358,249,607,52,659
公投第１６案,臺南市,麻豆區,清水里,397,645,170,121,291,14,305
公投第１６案,臺南市,麻豆區,清水里,398,777,224,173,397,41,438
公投第１６案,臺南市,麻豆區,南勢里,399,1612,378,286,664,55,719
公投第１６案,臺南市,麻豆區,南勢里,400,718,170,118,288,15,303
公投第１６案,臺南市,麻豆區,寮廍里,401,1656,374,253,627,37,664
公投第１６案,臺南市,麻豆區,埤頭里,402,1355,317,250,567,98,665
公投第１６案,臺南市,麻豆區,埤頭里,403,977,220,127,347,25,372
公投第１６案,臺南市,麻豆區,海埔里,404,1012,223,187,410,32,442
公投第１６案,臺南市,麻豆區,海埔里,405,626,165,153,318,21,339
公投第１６案,臺南市,麻豆區,海埔里,406,467,72,57,129,6,135
公投第１６案,臺南市,麻豆區,港尾里,407,1260,290,227,517,31,548
公投第１６案,臺南市,麻豆區,麻口里,408,1111,306,207,513,55,568
公投第１６案,臺南市,麻豆區,安業里,409,550,145,114,259,35,294
公投第１６案,臺南市,麻豆區,安業里,410,798,179,177,356,54,410
公投第１６案,臺南市,麻豆區,謝厝寮里,411,852,250,167,417,87,504
公投第１６案,臺南市,麻豆區,謝厝寮里,412,830,190,121,311,14,325
公投第１６案,臺南市,麻豆區,安正里,413,941,195,166,361,18,379
公投第１６案,臺南市,麻豆區,井東里,414,1158,294,231,525,56,581
公投第１６案,臺南市,麻豆區,井東里,415,612,144,100,244,16,260
公投第１６案,臺南市,官田區,官田里,416,1104,242,198,440,22,462
公投第１６案,臺南市,官田區,官田里,417,965,258,168,426,48,474
公投第１６案,臺南市,官田區,二鎮里,418,1402,369,264,633,53,686
公投第１６案,臺南市,官田區,二鎮里,419,1653,465,379,844,61,905
公投第１６案,臺南市,官田區,烏山頭里,420,966,224,164,388,51,439
公投第１６案,臺南市,官田區,烏山頭里,421,284,68,41,109,15,124
公投第１６案,臺南市,官田區,大崎里,422,402,59,48,107,6,113
公投第１６案,臺南市,官田區,隆田里,423,982,242,215,457,11,468
公投第１６案,臺南市,官田區,隆田里,424,975,241,139,380,29,409
公投第１６案,臺南市,官田區,隆本里,425,802,209,141,350,47,397
公投第１６案,臺南市,官田區,隆本里,426,1118,317,227,544,55,599
公投第１６案,臺南市,官田區,隆本里,427,1455,375,290,665,33,698
公投第１６案,臺南市,官田區,南廍里,428,1208,309,241,550,43,593
公投第１６案,臺南市,官田區,東西庄里,429,1293,311,209,520,71,591
公投第１６案,臺南市,官田區,東西庄里,430,607,115,100,215,24,239
公投第１６案,臺南市,官田區,渡拔里,431,501,106,98,204,36,240
公投第１６案,臺南市,官田區,渡拔里,432,728,192,141,333,65,398
公投第１６案,臺南市,官田區,渡拔里,433,842,189,171,360,26,386
公投第１６案,臺南市,官田區,渡拔里,434,515,129,91,220,55,275
公投第１６案,臺南市,官田區,社子里,435,873,198,115,313,19,332
公投第１６案,臺南市,大內區,石湖里,436,759,141,125,266,57,323
公投第１６案,臺南市,大內區,石湖里,437,262,46,38,84,3,87
公投第１６案,臺南市,大內區,石林里,438,646,112,85,197,21,218
公投第１６案,臺南市,大內區,石城里,439,1473,320,198,518,77,595
公投第１６案,臺南市,大內區,內江里,440,915,270,156,426,67,493
公投第１６案,臺南市,大內區,大內里,441,779,217,171,388,43,431
公投第１６案,臺南市,大內區,內郭里,442,637,180,158,338,51,389
公投第１６案,臺南市,大內區,頭社里,443,993,212,166,378,41,419
公投第１６案,臺南市,大內區,環湖里,444,766,217,134,351,57,408
公投第１６案,臺南市,大內區,二溪里,445,841,242,132,374,40,414
公投第１６案,臺南市,大內區,曲溪里,446,583,153,91,244,41,285
公投第１６案,臺南市,楠西區,楠西里,447,978,246,164,410,68,478
公投第１６案,臺南市,楠西區,楠西里,448,870,253,175,428,44,472
公投第１６案,臺南市,楠西區,灣丘里,449,1160,198,134,332,9,341
公投第１６案,臺南市,楠西區,密枝里,450,699,149,114,263,22,285
公投第１６案,臺南市,楠西區,照興里,451,990,200,122,322,22,344
公投第１６案,臺南市,楠西區,鹿田里,452,928,216,151,367,36,403
公投第１６案,臺南市,楠西區,龜丹里,453,660,151,110,261,53,314
公投第１６案,臺南市,楠西區,東勢里,454,1187,298,208,506,77,583
公投第１６案,臺南市,楠西區,東勢里,455,1056,280,168,448,36,484
公投第１６案,臺南市,南化區,南化里,456,690,190,135,325,46,371
公投第１６案,臺南市,南化區,南化里,457,695,169,157,326,56,382
公投第１６案,臺南市,南化區,小崙里,458,806,174,135,309,50,359
公投第１６案,臺南市,南化區,東和里,459,654,138,86,224,46,270
公投第１６案,臺南市,南化區,西埔里,460,783,139,107,246,36,282
公投第１６案,臺南市,南化區,中坑里,461,425,112,74,186,21,207
公投第１６案,臺南市,南化區,北平里,462,559,147,89,236,39,275
公投第１６案,臺南市,南化區,北寮里,463,1189,287,165,452,31,483
公投第１６案,臺南市,南化區,玉山里,464,1044,270,222,492,39,531
公投第１６案,臺南市,南化區,關山里,465,941,257,198,455,31,486
公投第１６案,臺南市,玉井區,玉井里,466,1242,339,214,553,32,585
公投第１６案,臺南市,玉井區,玉田里,467,1141,329,216,545,45,590
公投第１６案,臺南市,玉井區,玉田里,468,698,179,123,302,28,330
公投第１６案,臺南市,玉井區,玉田里,469,849,244,145,389,26,415
公投第１６案,臺南市,玉井區,玉田里,470,949,269,171,440,69,509
公投第１６案,臺南市,玉井區,中正里,471,618,178,94,272,31,303
公投第１６案,臺南市,玉井區,中正里,472,594,143,82,225,9,234
公投第１６案,臺南市,玉井區,竹圍里,473,927,208,150,358,21,379
公投第１６案,臺南市,玉井區,竹圍里,474,512,129,97,226,46,272
公投第１６案,臺南市,玉井區,沙田里,475,509,127,83,210,32,242
公投第１６案,臺南市,玉井區,三埔里,476,496,133,100,233,29,262
公投第１６案,臺南市,玉井區,三和里,477,759,188,124,312,12,324
公投第１６案,臺南市,玉井區,望明里,478,669,134,95,229,17,246
公投第１６案,臺南市,玉井區,望明里,479,787,186,125,311,72,383
公投第１６案,臺南市,玉井區,層林里,480,620,146,89,235,50,285
公投第１６案,臺南市,玉井區,豐里里,481,987,253,185,438,64,502
公投第１６案,臺南市,左鎮區,光和里,482,392,95,67,162,25,187
公投第１６案,臺南市,左鎮區,榮和里,483,644,176,116,292,43,335
公投第１６案,臺南市,左鎮區,左鎮里,484,468,93,71,164,16,180
公投第１６案,臺南市,左鎮區,中正里,485,753,156,119,275,38,313
公投第１６案,臺南市,左鎮區,睦光里,486,345,73,59,132,28,160
公投第１６案,臺南市,左鎮區,內庄里,487,393,93,57,150,15,165
公投第１６案,臺南市,左鎮區,岡林里,488,420,83,69,152,18,170
公投第１６案,臺南市,左鎮區,草山里,489,313,54,44,98,10,108
公投第１６案,臺南市,左鎮區,二寮里,490,186,33,30,63,3,66
公投第１６案,臺南市,左鎮區,澄山里,491,504,89,75,164,56,220
公投第１６案,臺南市,善化區,東關里,492,1132,254,218,472,35,507
公投第１６案,臺南市,善化區,坐駕里,493,1845,501,322,823,85,908
公投第１６案,臺南市,善化區,坐駕里,494,2090,526,390,916,137,1053
公投第１６案,臺南市,善化區,光文里,495,1582,476,307,783,89,872
公投第１６案,臺南市,善化區,光文里,496,1901,497,462,959,86,1045
公投第１６案,臺南市,善化區,光文里,497,1818,493,373,866,84,950
公投第１６案,臺南市,善化區,文昌里,498,1639,448,319,767,91,858
公投第１６案,臺南市,善化區,文昌里,499,1061,308,243,551,45,596
公投第１６案,臺南市,善化區,南關里,500,1786,511,356,867,121,988
公投第１６案,臺南市,善化區,頂街里,501,1147,315,220,535,49,584
公投第１６案,臺南市,善化區,文正里,502,1581,367,334,701,88,789
公投第１６案,臺南市,善化區,胡家里,503,1240,311,227,538,116,654
公投第１６案,臺南市,善化區,胡厝里,504,1743,358,258,616,48,664
公投第１６案,臺南市,善化區,什乃里,505,1246,353,269,622,74,696
公投第１６案,臺南市,善化區,溪美里,506,961,264,171,435,31,466
公投第１６案,臺南市,善化區,溪美里,507,938,244,170,414,17,431
公投第１６案,臺南市,善化區,六分里,508,722,175,153,328,26,354
公投第１６案,臺南市,善化區,六德里,509,1062,253,167,420,34,454
公投第１６案,臺南市,善化區,田寮里,510,1715,433,319,752,119,871
公投第１６案,臺南市,善化區,昌隆里,511,1120,256,205,461,81,542
公投第１６案,臺南市,善化區,昌隆里,512,865,189,187,376,54,430
公投第１６案,臺南市,善化區,牛庄里,513,1574,404,322,726,92,818
公投第１６案,臺南市,善化區,嘉北里,514,1535,368,253,621,70,691
公投第１６案,臺南市,善化區,嘉南里,515,1106,260,233,493,87,580
公投第１６案,臺南市,善化區,小新里,516,1402,334,279,613,45,658
公投第１６案,臺南市,善化區,小新里,517,1458,443,317,760,108,868
公投第１６案,臺南市,善化區,小新里,518,1380,331,270,601,39,640
公投第１６案,臺南市,善化區,蓮潭里,519,1232,326,294,620,23,643
公投第１６案,臺南市,善化區,蓮潭里,520,1069,309,244,553,24,577
公投第１６案,臺南市,安定區,蘇林里,521,1251,367,383,750,17,767
公投第１６案,臺南市,安定區,蘇林里,522,899,239,181,420,63,483
公投第１６案,臺南市,安定區,蘇厝里,523,1106,301,215,516,89,605
公投第１６案,臺南市,安定區,蘇厝里,524,948,263,196,459,66,525
公投第１６案,臺南市,安定區,安定里,525,1442,373,250,623,54,677
公投第１６案,臺南市,安定區,安加里,526,1385,293,263,556,101,657
公投第１６案,臺南市,安定區,安加里,527,801,230,172,402,56,458
公投第１６案,臺南市,安定區,港尾里,528,736,164,137,301,38,339
公投第１６案,臺南市,安定區,港尾里,529,781,203,147,350,51,401
公投第１６案,臺南市,安定區,中榮里,530,795,220,174,394,30,424
公投第１６案,臺南市,安定區,中榮里,531,862,255,188,443,60,503
公投第１６案,臺南市,安定區,港口里,532,1487,387,259,646,51,697
公投第１６案,臺南市,安定區,港口里,533,1385,349,274,623,59,682
公投第１６案,臺南市,安定區,港南里,534,1518,377,267,644,43,687
公投第１６案,臺南市,安定區,港南里,535,1094,343,220,563,73,636
公投第１６案,臺南市,安定區,嘉同里,536,1590,427,322,749,131,880
公投第１６案,臺南市,安定區,嘉同里,537,754,226,153,379,44,423
公投第１６案,臺南市,安定區,中沙里,538,716,209,136,345,57,402
公投第１６案,臺南市,安定區,新吉里,539,1492,440,293,733,80,813
公投第１６案,臺南市,安定區,新吉里,540,943,284,180,464,48,512
公投第１６案,臺南市,安定區,海寮里,541,1157,310,241,551,44,595
公投第１６案,臺南市,安定區,海寮里,542,1384,348,298,646,121,767
公投第１６案,臺南市,安定區,文科里,543,967,229,223,452,71,523
公投第１６案,臺南市,安定區,文科里,544,611,163,114,277,45,322
公投第１６案,臺南市,新市區,新市里,545,960,227,187,414,38,452
公投第１６案,臺南市,新市區,新市里,546,1118,329,262,591,62,653
公投第１６案,臺南市,新市區,新市里,547,850,228,155,383,30,413
公投第１６案,臺南市,新市區,新和里,548,1241,337,252,589,72,661
公投第１６案,臺南市,新市區,新和里,549,1297,363,280,643,58,701
公投第１６案,臺南市,新市區,新和里,550,962,297,192,489,52,541
公投第１６案,臺南市,新市區,新和里,551,1237,343,269,612,87,699
公投第１６案,臺南市,新市區,新和里,552,1326,350,281,631,80,711
公投第１６案,臺南市,新市區,社內里,553,1211,329,274,603,89,692
公投第１６案,臺南市,新市區,社內里,554,1305,323,299,622,38,660
公投第１６案,臺南市,新市區,大洲里,555,688,203,106,309,65,374
公投第１６案,臺南市,新市區,豐華里,556,911,259,198,457,58,515
公投第１６案,臺南市,新市區,三舍里,557,1525,374,288,662,64,726
公投第１６案,臺南市,新市區,大營里,558,1091,232,171,403,14,417
公投第１６案,臺南市,新市區,大營里,559,1122,310,216,526,40,566
公投第１６案,臺南市,新市區,大營里,560,1049,278,190,468,42,510
公投第１６案,臺南市,新市區,大社里,561,1564,372,253,625,37,662
公投第１６案,臺南市,新市區,大社里,562,1515,428,303,731,78,809
公投第１６案,臺南市,新市區,大社里,563,1378,453,204,657,31,688
公投第１６案,臺南市,新市區,潭頂里,564,827,270,168,438,77,515
公投第１６案,臺南市,新市區,潭頂里,565,960,295,214,509,105,614
公投第１６案,臺南市,新市區,港墘里,566,951,237,197,434,64,498
公投第１６案,臺南市,新市區,港墘里,567,1264,335,275,610,86,696
公投第１６案,臺南市,新市區,港墘里,568,1173,306,253,559,48,607
公投第１６案,臺南市,新市區,永就里,569,684,198,161,359,30,389
公投第１６案,臺南市,新市區,永就里,570,1055,333,214,547,101,648
公投第１６案,臺南市,新市區,永就里,571,1122,353,287,640,49,689
公投第１６案,臺南市,山上區,明和里,572,855,171,121,292,67,359
公投第１６案,臺南市,山上區,明和里,573,836,178,97,275,41,316
公投第１６案,臺南市,山上區,南洲里,574,753,181,143,324,45,369
公投第１６案,臺南市,山上區,南洲里,575,788,175,145,320,54,374
公投第１６案,臺南市,山上區,山上里,576,984,261,182,443,48,491
公投第１６案,臺南市,山上區,新莊里,577,972,222,159,381,22,403
公投第１６案,臺南市,山上區,玉峯里,578,553,92,53,145,11,156
公投第１６案,臺南市,山上區,平陽里,579,378,84,54,138,9,147
公投第１６案,臺南市,山上區,豐德里,580,392,93,62,155,26,181
公投第１６案,臺南市,新化區,武安里,581,746,249,152,401,52,453
公投第１６案,臺南市,新化區,武安里,582,1102,323,269,592,59,651
公投第１６案,臺南市,新化區,武安里,583,370,102,91,193,22,215
公投第１６案,臺南市,新化區,武安里,584,947,266,216,482,85,567
公投第１６案,臺南市,新化區,東榮里,585,1154,217,326,543,69,612
公投第１６案,臺南市,新化區,東榮里,586,1082,295,236,531,76,607
公投第１６案,臺南市,新化區,東榮里,587,1075,303,237,540,71,611
公投第１６案,臺南市,新化區,東榮里,588,640,153,150,303,33,336
公投第１６案,臺南市,新化區,護國里,589,410,84,96,180,23,203
公投第１６案,臺南市,新化區,護國里,590,533,151,88,239,32,271
公投第１６案,臺南市,新化區,護國里,591,836,207,193,400,34,434
公投第１６案,臺南市,新化區,護國里,592,978,225,160,385,35,420
公投第１６案,臺南市,新化區,太平里,593,1348,372,294,666,51,717
公投第１６案,臺南市,新化區,太平里,594,1015,281,211,492,41,533
公投第１６案,臺南市,新化區,太平里,595,1228,351,184,535,40,575
公投第１６案,臺南市,新化區,太平里,596,789,214,183,397,53,450
公投第１６案,臺南市,新化區,協興里,597,1022,244,225,469,35,504
公投第１６案,臺南市,新化區,協興里,598,1021,296,164,460,25,485
公投第１６案,臺南市,新化區,協興里,599,1229,372,263,635,72,707
公投第１６案,臺南市,新化區,唪口里,600,1153,326,240,566,24,590
公投第１６案,臺南市,新化區,唪口里,601,1012,212,155,367,33,400
公投第１６案,臺南市,新化區,北勢里,602,1458,411,301,712,88,800
公投第１６案,臺南市,新化區,豐榮里,603,1645,509,332,841,73,914
公投第１６案,臺南市,新化區,豐榮里,604,1016,313,208,521,64,585
公投第１６案,臺南市,新化區,豐榮里,605,559,147,115,262,15,277
公投第１６案,臺南市,新化區,全興里,606,1222,356,270,626,51,677
公投第１６案,臺南市,新化區,全興里,607,1562,494,364,858,58,916
公投第１６案,臺南市,新化區,崙頂里,608,994,240,177,417,34,451
公投第１６案,臺南市,新化區,崙頂里,609,1013,251,211,462,97,559
公投第１６案,臺南市,新化區,知義里,610,1197,341,243,584,89,673
公投第１６案,臺南市,新化區,知義里,611,1021,262,193,455,54,509
公投第１６案,臺南市,新化區,山脚里,612,1428,314,242,556,91,647
公投第１６案,臺南市,新化區,大坑里,613,456,114,62,176,39,215
公投第１６案,臺南市,新化區,𦰡拔里,614,1037,295,224,519,59,578
公投第１６案,臺南市,新化區,𦰡拔里,615,1097,313,214,527,86,613
公投第１６案,臺南市,新化區,羊林里,616,902,243,190,433,65,498
公投第１６案,臺南市,新化區,礁坑里,617,999,217,181,398,113,511
公投第１６案,臺南市,安南區,東和里,618,2549,688,573,1261,46,1307
公投第１６案,臺南市,安南區,󻕯南里,619,2321,578,451,1029,127,1156
公投第１６案,臺南市,安南區,󻕯南里,620,2156,619,486,1105,83,1188
公投第１６案,臺南市,安南區,州南里,621,1662,498,375,873,97,970
公投第１６案,臺南市,安南區,州南里,622,1512,426,318,744,134,878
公投第１６案,臺南市,安南區,州南里,623,1625,409,331,740,84,824
公投第１６案,臺南市,安南區,安順里,624,2143,516,377,893,63,956
公投第１６案,臺南市,安南區,安順里,625,2457,723,489,1212,114,1326
公投第１６案,臺南市,安南區,州北里,626,2148,625,450,1075,127,1202
公投第１６案,臺南市,安南區,州北里,627,2364,644,487,1131,98,1229
公投第１６案,臺南市,安南區,新順里,628,1868,455,346,801,71,872
公投第１６案,臺南市,安南區,新順里,629,1797,724,238,962,79,1041
公投第１６案,臺南市,安南區,新順里,630,2268,649,477,1126,91,1217
公投第１６案,臺南市,安南區,頂安里,631,2291,539,389,928,95,1023
公投第１６案,臺南市,安南區,頂安里,632,2255,597,445,1042,102,1144
公投第１６案,臺南市,安南區,安慶里,633,1940,453,400,853,86,939
公投第１６案,臺南市,安南區,安慶里,634,2013,529,461,990,64,1054
公投第１６案,臺南市,安南區,安慶里,635,2024,556,397,953,87,1040
公投第１６案,臺南市,安南區,溪北里,636,1613,473,407,880,106,986
公投第１６案,臺南市,安南區,溪北里,637,1178,303,243,546,52,598
公投第１６案,臺南市,安南區,安和里,638,2143,548,480,1028,114,1142
公投第１６案,臺南市,安南區,安西里,639,1721,498,369,867,98,965
公投第１６案,臺南市,安南區,安西里,640,1773,547,371,918,86,1004
公投第１６案,臺南市,安南區,溪頂里,641,1428,411,297,708,30,738
公投第１６案,臺南市,安南區,溪頂里,642,1626,476,344,820,72,892
公投第１６案,臺南市,安南區,溪頂里,643,1358,378,293,671,64,735
公投第１６案,臺南市,安南區,安東里,644,1447,481,300,781,63,844
公投第１６案,臺南市,安南區,安東里,645,1358,402,278,680,92,772
公投第１６案,臺南市,安南區,鳳凰里,646,2116,528,403,931,80,1011
公投第１６案,臺南市,安南區,鳳凰里,647,2321,580,441,1021,63,1084
公投第１６案,臺南市,安南區,梅花里,648,2117,864,101,965,60,1025
公投第１６案,臺南市,安南區,梅花里,649,1927,476,396,872,83,955
公投第１６案,臺南市,安南區,理想里,650,2242,562,429,991,152,1143
公投第１６案,臺南市,安南區,理想里,651,2334,587,444,1031,68,1099
公投第１６案,臺南市,安南區,大安里,652,1822,526,373,899,91,990
公投第１６案,臺南市,安南區,大安里,653,1813,513,386,899,110,1009
公投第１６案,臺南市,安南區,原佃里,654,2188,639,411,1050,122,1172
公投第１６案,臺南市,安南區,長安里,655,2399,609,440,1049,121,1170
公投第１６案,臺南市,安南區,長安里,656,2247,557,386,943,86,1029
公投第１６案,臺南市,安南區,公親里,657,1165,355,278,633,86,719
公投第１６案,臺南市,安南區,布袋里,658,1539,391,310,701,71,772
公投第１６案,臺南市,安南區,總頭里,659,1835,482,412,894,126,1020
公投第１６案,臺南市,安南區,南興里,660,1797,493,364,857,120,977
公投第１６案,臺南市,安南區,學東里,661,2223,558,393,951,129,1080
公投第１６案,臺南市,安南區,公󻕯里,662,977,282,268,550,73,623
公投第１６案,臺南市,安南區,佃東里,663,1642,382,325,707,51,758
公投第１６案,臺南市,安南區,佃東里,664,1697,494,356,850,87,937
公投第１６案,臺南市,安南區,佃西里,665,1966,472,358,830,85,915
公投第１６案,臺南市,安南區,淵西里,666,1319,343,273,616,82,698
公投第１６案,臺南市,安南區,淵西里,667,1909,480,362,842,90,932
公投第１６案,臺南市,安南區,海西里,668,1763,503,345,848,96,944
公投第１６案,臺南市,安南區,海西里,669,965,260,193,453,62,515
公投第１６案,臺南市,安南區,海東里,670,1547,352,249,601,99,700
公投第１６案,臺南市,安南區,海東里,671,1784,454,366,820,86,906
公投第１６案,臺南市,安南區,海東里,672,2145,514,423,937,84,1021
公投第１６案,臺南市,安南區,溪心里,673,2443,727,496,1223,92,1315
公投第１６案,臺南市,安南區,溪心里,674,2565,590,447,1037,72,1109
公投第１６案,臺南市,安南區,溪心里,675,2480,660,522,1182,105,1287
公投第１６案,臺南市,安南區,淵東里,676,2349,548,388,936,123,1059
公投第１６案,臺南市,安南區,淵東里,677,2168,557,486,1043,112,1155
公投第１６案,臺南市,安南區,淵中里,678,1630,438,325,763,65,828
公投第１６案,臺南市,安南區,淵中里,679,1675,387,304,691,47,738
公投第１６案,臺南市,安南區,溪墘里,680,1627,488,391,879,131,1010
公投第１６案,臺南市,安南區,溪墘里,681,1493,387,336,723,70,793
公投第１６案,臺南市,安南區,海佃里,682,1397,417,279,696,88,784
公投第１６案,臺南市,安南區,海佃里,683,1416,378,292,670,65,735
公投第１６案,臺南市,安南區,海佃里,684,1460,397,317,714,40,754
公投第１６案,臺南市,安南區,國安里,685,2222,520,386,906,64,970
公投第１６案,臺南市,安南區,溪東里,686,2070,564,418,982,117,1099
公投第１６案,臺南市,安南區,溪東里,687,1739,486,390,876,74,950
公投第１６案,臺南市,安南區,安富里,688,1830,483,348,831,105,936
公投第１６案,臺南市,安南區,安富里,689,1803,517,430,947,105,1052
公投第１６案,臺南市,安南區,安富里,690,1800,476,461,937,80,1017
公投第１６案,臺南市,安南區,幸福里,691,1815,399,350,749,104,853
公投第１６案,臺南市,安南區,幸福里,692,1846,453,349,802,61,863
公投第１６案,臺南市,安南區,海南里,693,905,256,225,481,72,553
公投第１６案,臺南市,安南區,海南里,694,1073,316,258,574,87,661
公投第１６案,臺南市,安南區,城東里,695,1579,475,338,813,97,910
公投第１６案,臺南市,安南區,城南里,696,1876,484,356,840,130,970
公投第１６案,臺南市,安南區,城南里,697,1194,292,247,539,64,603
公投第１６案,臺南市,安南區,青草里,698,1475,290,224,514,43,557
公投第１６案,臺南市,安南區,城西里,699,1380,270,347,617,34,651
公投第１６案,臺南市,安南區,城北里,700,1462,345,289,634,25,659
公投第１６案,臺南市,安南區,城中里,701,1044,315,200,515,88,603
公投第１６案,臺南市,安南區,砂崙里,702,603,191,140,331,64,395
公投第１６案,臺南市,安南區,砂崙里,703,690,204,163,367,31,398
公投第１６案,臺南市,安南區,顯宮里,704,1447,342,320,662,60,722
公投第１６案,臺南市,安南區,鹿耳里,705,910,309,226,535,62,597
公投第１６案,臺南市,安南區,四草里,706,1850,443,338,781,112,893
公投第１６案,臺南市,安南區,塩田里,707,1501,497,299,796,75,871
公投第１６案,臺南市,永康區,五王里,708,1398,388,308,696,71,767
公投第１６案,臺南市,永康區,五王里,709,1478,329,241,570,64,634
公投第１６案,臺南市,永康區,五王里,710,1442,384,287,671,46,717
公投第１６案,臺南市,永康區,五王里,711,1353,362,253,615,50,665
公投第１６案,臺南市,永康區,三合里,712,1160,291,229,520,44,564
公投第１６案,臺南市,永康區,三合里,713,1122,317,237,554,53,607
公投第１６案,臺南市,永康區,三合里,714,1165,311,238,549,23,572
公投第１６案,臺南市,永康區,六合里,715,1317,341,269,610,46,656
公投第１６案,臺南市,永康區,六合里,716,1376,377,267,644,59,703
公投第１６案,臺南市,永康區,六合里,717,1361,410,277,687,41,728
公投第１６案,臺南市,永康區,六合里,718,1374,451,297,748,53,801
公投第１６案,臺南市,永康區,網寮里,719,1709,410,340,750,76,826
公投第１６案,臺南市,永康區,網寮里,720,1717,458,283,741,96,837
公投第１６案,臺南市,永康區,網寮里,721,1759,470,303,773,67,840
公投第１６案,臺南市,永康區,網寮里,722,1636,478,312,790,60,850
公投第１６案,臺南市,永康區,二王里,723,1442,483,189,672,87,759
公投第１６案,臺南市,永康區,二王里,724,1545,446,285,731,46,777
公投第１６案,臺南市,永康區,二王里,725,1565,463,255,718,72,790
公投第１６案,臺南市,永康區,二王里,726,1684,452,302,754,59,813
公投第１６案,臺南市,永康區,二王里,727,1548,426,260,686,36,722
公投第１６案,臺南市,永康區,永康里,728,1389,396,311,707,36,743
公投第１６案,臺南市,永康區,永康里,729,1369,391,267,658,65,723
公投第１６案,臺南市,永康區,永康里,730,1415,398,265,663,104,767
公投第１６案,臺南市,永康區,永康里,731,1386,349,230,579,24,603
公投第１６案,臺南市,永康區,永康里,732,1747,221,166,387,12,399
公投第１６案,臺南市,永康區,永康里,733,1485,420,274,694,70,764
公投第１６案,臺南市,永康區,埔園里,734,1747,471,310,781,104,885
公投第１６案,臺南市,永康區,埔園里,735,1744,432,276,708,42,750
公投第１６案,臺南市,永康區,埔園里,736,1797,426,308,734,104,838
公投第１６案,臺南市,永康區,埔園里,737,1800,514,372,886,86,972
公投第１６案,臺南市,永康區,龍埔里,738,1720,485,306,791,25,816
公投第１６案,臺南市,永康區,龍埔里,739,1708,501,362,863,53,916
公投第１６案,臺南市,永康區,正強里,740,1519,466,307,773,45,818
公投第１６案,臺南市,永康區,正強里,741,1497,425,310,735,103,838
公投第１６案,臺南市,永康區,正強里,742,1509,612,93,705,39,744
公投第１６案,臺南市,永康區,正強里,743,1542,473,341,814,81,895
公投第１６案,臺南市,永康區,正強里,744,1536,473,322,795,47,842
公投第１６案,臺南市,永康區,大橋里,745,1531,422,335,757,68,825
公投第１６案,臺南市,永康區,大橋里,746,1327,412,281,693,72,765
公投第１６案,臺南市,永康區,大橋里,747,1456,423,289,712,36,748
公投第１６案,臺南市,永康區,大橋里,748,1396,400,312,712,63,775
公投第１６案,臺南市,永康區,東橋里,749,1636,437,350,787,58,845
公投第１６案,臺南市,永康區,東橋里,750,1592,471,326,797,60,857
公投第１６案,臺南市,永康區,東橋里,751,2017,504,418,922,37,959
公投第１６案,臺南市,永康區,東橋里,752,672,191,143,334,23,357
公投第１６案,臺南市,永康區,西橋里,753,1611,421,297,718,34,752
公投第１６案,臺南市,永康區,西橋里,754,1502,421,310,731,58,789
公投第１６案,臺南市,永康區,安康里,755,1660,426,273,699,36,735
公投第１６案,臺南市,永康區,安康里,756,1561,371,269,640,42,682
公投第１６案,臺南市,永康區,安康里,757,1590,403,317,720,37,757
公投第１６案,臺南市,永康區,蔦松里,758,924,226,208,434,27,461
公投第１６案,臺南市,永康區,蔦松里,759,938,300,188,488,48,536
公投第１６案,臺南市,永康區,三民里,760,957,289,202,491,53,544
公投第１６案,臺南市,永康區,三民里,761,496,144,91,235,42,277
公投第１６案,臺南市,永康區,塩行里,762,1717,469,360,829,76,905
公投第１６案,臺南市,永康區,塩行里,763,1615,375,325,700,55,755
公投第１６案,臺南市,永康區,塩行里,764,1554,401,311,712,44,756
公投第１６案,臺南市,永康區,塩興里,765,1196,306,231,537,34,571
公投第１６案,臺南市,永康區,塩興里,766,1274,345,265,610,51,661
公投第１６案,臺南市,永康區,塩興里,767,1215,355,242,597,54,651
公投第１６案,臺南市,永康區,塩洲里,768,1457,422,291,713,29,742
公投第１６案,臺南市,永康區,塩洲里,769,1451,407,302,709,42,751
公投第１６案,臺南市,永康區,塩洲里,770,1423,334,289,623,61,684
公投第１６案,臺南市,永康區,塩洲里,771,1394,373,321,694,48,742
公投第１６案,臺南市,永康區,甲頂里,772,890,247,211,458,58,516
公投第１６案,臺南市,永康區,甲頂里,773,1018,303,257,560,52,612
公投第１６案,臺南市,永康區,甲頂里,774,368,129,59,188,26,214
公投第１６案,臺南市,永康區,尚頂里,775,1208,391,263,654,58,712
公投第１６案,臺南市,永康區,尚頂里,776,1187,279,259,538,30,568
公投第１６案,臺南市,永康區,尚頂里,777,1381,370,278,648,52,700
公投第１６案,臺南市,永康區,龍潭里,778,1405,381,268,649,80,729
公投第１６案,臺南市,永康區,龍潭里,779,1445,377,259,636,88,724
公投第１６案,臺南市,永康區,龍潭里,780,1687,468,297,765,76,841
公投第１６案,臺南市,永康區,龍潭里,781,1535,355,283,638,45,683
公投第１６案,臺南市,永康區,永明里,782,1542,471,303,774,62,836
公投第１６案,臺南市,永康區,永明里,783,1618,480,287,767,53,820
公投第１６案,臺南市,永康區,永明里,784,1338,434,273,707,35,742
公投第１６案,臺南市,永康區,王行里,785,1285,348,299,647,84,731
公投第１６案,臺南市,永康區,王行里,786,1240,349,253,602,31,633
公投第１６案,臺南市,永康區,烏竹里,787,1343,351,260,611,59,670
公投第１６案,臺南市,永康區,烏竹里,788,1327,373,325,698,65,763
公投第１６案,臺南市,永康區,西勢里,789,1565,465,294,759,56,815
公投第１６案,臺南市,永康區,西勢里,790,1476,439,270,709,114,823
公投第１６案,臺南市,永康區,西勢里,791,1476,421,293,714,53,767
公投第１６案,臺南市,永康區,西勢里,792,1463,436,338,774,60,834
公投第１６案,臺南市,永康區,新樹里,793,983,284,211,495,78,573
公投第１６案,臺南市,永康區,新樹里,794,1116,333,240,573,72,645
公投第１６案,臺南市,永康區,大灣里,795,1117,293,216,509,81,590
公投第１６案,臺南市,永康區,大灣里,796,1069,283,190,473,36,509
公投第１６案,臺南市,永康區,大灣里,797,1180,386,259,645,53,698
公投第１６案,臺南市,永康區,東灣里,798,1176,337,217,554,89,643
公投第１６案,臺南市,永康區,東灣里,799,1158,310,261,571,37,608
公投第１６案,臺南市,永康區,東灣里,800,1208,338,288,626,86,712
公投第１６案,臺南市,永康區,西灣里,801,1501,390,314,704,100,804
公投第１６案,臺南市,永康區,西灣里,802,1298,372,300,672,53,725
公投第１６案,臺南市,永康區,西灣里,803,1542,438,294,732,44,776
公投第１６案,臺南市,永康區,西灣里,804,1537,468,314,782,75,857
公投第１６案,臺南市,永康區,西灣里,805,1359,433,306,739,83,822
公投第１６案,臺南市,永康區,南灣里,806,1139,267,220,487,43,530
公投第１６案,臺南市,永康區,南灣里,807,1158,284,231,515,57,572
公投第１６案,臺南市,永康區,南灣里,808,1538,365,325,690,90,780
公投第１６案,臺南市,永康區,崑山里,809,1166,292,232,524,28,552
公投第１６案,臺南市,永康區,崑山里,810,1228,314,229,543,46,589
公投第１６案,臺南市,永康區,崑山里,811,1200,340,275,615,63,678
公投第１６案,臺南市,永康區,崑山里,812,1131,326,257,583,51,634
公投第１６案,臺南市,永康區,崑山里,813,1147,305,246,551,35,586
公投第１６案,臺南市,永康區,北灣里,814,1442,372,289,661,69,730
公投第１６案,臺南市,永康區,北灣里,815,1325,370,234,604,45,649
公投第１６案,臺南市,永康區,北灣里,816,1260,308,218,526,49,575
公投第１６案,臺南市,永康區,北興里,817,1631,317,417,734,66,800
公投第１６案,臺南市,永康區,北興里,818,1549,433,276,709,59,768
公投第１６案,臺南市,永康區,北興里,819,1666,461,311,772,42,814
公投第１６案,臺南市,永康區,復興里,820,1012,261,164,425,71,496
公投第１６案,臺南市,永康區,復興里,821,976,242,152,394,26,420
公投第１６案,臺南市,永康區,光復里,822,531,153,108,261,20,281
公投第１６案,臺南市,永康區,建國里,823,859,244,174,418,57,475
公投第１６案,臺南市,永康區,建國里,824,937,239,189,428,38,466
公投第１６案,臺南市,永康區,復國里,825,1307,363,264,627,72,699
公投第１６案,臺南市,永康區,復國里,826,1482,383,271,654,32,686
公投第１６案,臺南市,永康區,復國里,827,1341,321,263,584,41,625
公投第１６案,臺南市,永康區,復國里,828,1376,355,296,651,47,698
公投第１６案,臺南市,永康區,復國里,829,1390,379,258,637,55,692
公投第１６案,臺南市,永康區,復國里,830,1534,430,344,774,59,833
公投第１６案,臺南市,永康區,復華里,831,1460,449,298,747,59,806
公投第１６案,臺南市,永康區,復華里,832,1383,405,257,662,40,702
公投第１６案,臺南市,永康區,復華里,833,1299,393,235,628,47,675
公投第１６案,臺南市,永康區,復華里,834,1264,361,296,657,43,700
公投第１６案,臺南市,永康區,復華里,835,1355,422,300,722,49,771
公投第１６案,臺南市,永康區,復華里,836,1414,401,258,659,33,692
公投第１６案,臺南市,永康區,復華里,837,1109,343,255,598,30,628
公投第１６案,臺南市,永康區,神洲里,838,1151,316,215,531,56,587
公投第１６案,臺南市,永康區,成功里,839,1026,355,234,589,71,660
公投第１６案,臺南市,永康區,成功里,840,1071,249,219,468,36,504
公投第１６案,臺南市,永康區,中華里,841,1387,456,322,778,91,869
公投第１６案,臺南市,永康區,中華里,842,1377,432,325,757,51,808
公投第１６案,臺南市,永康區,中興里,843,1687,509,311,820,63,883
公投第１６案,臺南市,永康區,中興里,844,1700,466,328,794,47,841
公投第１６案,臺南市,永康區,勝利里,845,1444,430,323,753,48,801
公投第１６案,臺南市,永康區,勝利里,846,1485,402,291,693,67,760
公投第１６案,臺南市,永康區,勝利里,847,1717,450,309,759,56,815
公投第１６案,臺南市,永康區,勝利里,848,1701,429,303,732,63,795
公投第１６案,臺南市,永康區,勝利里,849,1382,363,274,637,40,677
公投第１６案,臺南市,北區,開元里,850,1793,488,341,829,77,906
公投第１６案,臺南市,北區,開元里,851,1708,443,298,741,66,807
公投第１６案,臺南市,北區,元寶里,852,997,249,235,484,27,511
公投第１６案,臺南市,北區,元寶里,853,1452,338,267,605,46,651
公投第１６案,臺南市,北區,元寶里,854,1351,357,278,635,34,669
公投第１６案,臺南市,北區,合興里,855,1323,434,321,755,73,828
公投第１６案,臺南市,北區,合興里,856,1073,313,237,550,40,590
公投第１６案,臺南市,北區,合興里,857,1138,319,271,590,42,632
公投第１６案,臺南市,北區,力行里,858,1189,314,257,571,52,623
公投第１６案,臺南市,北區,力行里,859,1262,406,294,700,48,748
公投第１６案,臺南市,北區,重興里,860,1017,352,223,575,30,605
公投第１６案,臺南市,北區,重興里,861,847,257,163,420,27,447
公投第１６案,臺南市,北區,東興里,862,1076,339,239,578,45,623
公投第１６案,臺南市,北區,東興里,863,954,325,206,531,38,569
公投第１６案,臺南市,北區,長勝里,864,1300,355,252,607,81,688
公投第１６案,臺南市,北區,長勝里,865,1390,442,227,669,60,729
公投第１６案,臺南市,北區,長勝里,866,1318,373,315,688,52,740
公投第１６案,臺南市,北區,振興里,867,974,275,210,485,18,503
公投第１６案,臺南市,北區,振興里,868,990,290,207,497,31,528
公投第１６案,臺南市,北區,仁愛里,869,1016,317,276,593,19,612
公投第１６案,臺南市,北區,仁愛里,870,1053,304,241,545,44,589
公投第１６案,臺南市,北區,中樓里,871,1466,363,307,670,86,756
公投第１６案,臺南市,北區,永祥里,872,1535,448,307,755,94,849
公投第１６案,臺南市,北區,永祥里,873,1544,397,320,717,77,794
公投第１６案,臺南市,北區,北門里,874,1760,512,378,890,87,977
公投第１６案,臺南市,北區,北門里,875,1372,312,271,583,45,628
公投第１６案,臺南市,北區,北門里,876,1002,320,219,539,48,587
公投第１６案,臺南市,北區,北門里,877,1171,353,276,629,50,679
公投第１６案,臺南市,北區,大光里,878,1285,371,205,576,36,612
公投第１６案,臺南市,北區,大光里,879,1036,303,197,500,45,545
公投第１６案,臺南市,北區,大光里,880,1392,412,265,677,71,748
公投第１６案,臺南市,北區,大光里,881,1147,313,247,560,74,634
公投第１６案,臺南市,北區,大興里,882,1526,354,253,607,56,663
公投第１６案,臺南市,北區,大興里,883,1559,415,322,737,50,787
公投第１６案,臺南市,北區,公園里,884,892,247,189,436,78,514
公投第１６案,臺南市,北區,公園里,885,937,239,191,430,49,479
公投第１６案,臺南市,北區,北華里,886,1449,400,326,726,105,831
公投第１６案,臺南市,北區,北華里,887,1160,312,222,534,49,583
公投第１６案,臺南市,北區,北華里,888,1567,273,232,505,89,594
公投第１６案,臺南市,北區,長興里,889,1346,364,281,645,67,712
公投第１６案,臺南市,北區,長興里,890,1451,375,285,660,19,679
公投第１６案,臺南市,北區,小北里,891,1522,399,308,707,44,751
公投第１６案,臺南市,北區,小北里,892,1278,331,258,589,46,635
公投第１６案,臺南市,北區,小北里,893,1164,273,247,520,72,592
公投第１６案,臺南市,北區,正覺里,894,1091,269,208,477,27,504
公投第１６案,臺南市,北區,正覺里,895,993,251,204,455,35,490
公投第１６案,臺南市,北區,正覺里,896,1119,242,203,445,51,496
公投第１６案,臺南市,北區,成功里,897,1685,460,363,823,105,928
公投第１６案,臺南市,北區,成功里,898,1368,371,304,675,31,706
公投第１６案,臺南市,北區,成功里,899,1389,379,290,669,80,749
公投第１６案,臺南市,北區,華德里,900,1469,445,343,788,38,826
公投第１６案,臺南市,北區,華德里,901,1655,520,358,878,71,949
公投第１６案,臺南市,北區,福德里,902,1261,390,289,679,35,714
公投第１６案,臺南市,北區,福德里,903,1490,407,312,719,34,753
公投第１６案,臺南市,北區,福德里,904,1436,459,323,782,48,830
公投第１６案,臺南市,北區,成德里,905,1340,422,278,700,90,790
公投第１６案,臺南市,北區,成德里,906,1464,446,296,742,56,798
公投第１６案,臺南市,北區,成德里,907,1513,457,363,820,44,864
公投第１６案,臺南市,北區,和順里,908,1709,524,385,909,16,925
公投第１６案,臺南市,北區,和順里,909,1517,500,365,865,43,908
公投第１６案,臺南市,北區,和順里,910,1598,406,380,786,43,829
公投第１６案,臺南市,北區,立人里,911,1399,374,307,681,58,739
公投第１６案,臺南市,北區,立人里,912,1214,326,242,568,68,636
公投第１６案,臺南市,北區,雙安里,913,1064,310,250,560,37,597
公投第１６案,臺南市,北區,雙安里,914,1148,378,272,650,52,702
公投第１６案,臺南市,北區,文成里,915,1391,409,303,712,47,759
公投第１６案,臺南市,北區,文成里,916,1584,463,355,818,58,876
公投第１６案,臺南市,北區,元美里,917,1595,503,340,843,49,892
公投第１６案,臺南市,北區,元美里,918,1397,389,302,691,38,729
公投第１６案,臺南市,北區,文元里,919,1662,452,364,816,69,885
公投第１６案,臺南市,北區,文元里,920,1634,475,307,782,38,820
公投第１６案,臺南市,北區,大和里,921,1793,523,394,917,98,1015
公投第１６案,臺南市,北區,大和里,922,1872,540,394,934,69,1003
公投第１６案,臺南市,北區,大港里,923,1874,465,423,888,121,1009
公投第１６案,臺南市,北區,大港里,924,1760,477,330,807,91,898
公投第１６案,臺南市,北區,大港里,925,1753,490,314,804,89,893
公投第１６案,臺南市,北區,大豐里,926,1502,341,279,620,36,656
公投第１６案,臺南市,北區,大豐里,927,1470,403,321,724,60,784
公投第１６案,臺南市,北區,大豐里,928,1319,332,274,606,97,703
公投第１６案,臺南市,北區,賢北里,929,1876,639,336,975,63,1038
公投第１６案,臺南市,北區,賢北里,930,1720,479,368,847,48,895
公投第１６案,臺南市,中西區,赤嵌里,931,1332,341,319,660,75,735
公投第１６案,臺南市,中西區,赤嵌里,932,1246,342,283,625,86,711
公投第１６案,臺南市,中西區,赤嵌里,933,1276,335,266,601,71,672
公投第１６案,臺南市,中西區,郡王里,934,1583,453,374,827,65,892
公投第１６案,臺南市,中西區,郡王里,935,1464,421,358,779,51,830
公投第１６案,臺南市,中西區,法華里,936,1234,326,276,602,32,634
公投第１６案,臺南市,中西區,法華里,937,1368,388,339,727,59,786
公投第１６案,臺南市,中西區,開山里,938,1322,321,245,566,44,610
公投第１６案,臺南市,中西區,開山里,939,1216,278,290,568,76,644
公投第１６案,臺南市,中西區,永華里,940,1289,334,296,630,45,675
公投第１６案,臺南市,中西區,永華里,941,1237,373,270,643,57,700
公投第１６案,臺南市,中西區,藥王里,942,1189,268,232,500,45,545
公投第１６案,臺南市,中西區,藥王里,943,1201,341,261,602,75,677
公投第１６案,臺南市,中西區,藥王里,944,1065,324,247,571,66,637
公投第１６案,臺南市,中西區,光賢里,945,1055,307,231,538,65,603
公投第１６案,臺南市,中西區,光賢里,946,1170,347,299,646,65,711
公投第１６案,臺南市,中西區,光賢里,947,1280,419,293,712,61,773
公投第１６案,臺南市,中西區,大涼里,948,1223,361,277,638,52,690
公投第１６案,臺南市,中西區,大涼里,949,1292,365,305,670,81,751
公投第１６案,臺南市,中西區,西湖里,950,993,296,266,562,21,583
公投第１６案,臺南市,中西區,西湖里,951,1541,408,352,760,77,837
公投第１６案,臺南市,中西區,西湖里,952,1652,499,402,901,86,987
公投第１６案,臺南市,中西區,西湖里,953,1212,371,285,656,34,690
公投第１６案,臺南市,中西區,西賢里,954,1621,458,392,850,74,924
公投第１６案,臺南市,中西區,西賢里,955,1660,449,410,859,56,915
公投第１６案,臺南市,中西區,西賢里,956,1595,420,362,782,88,870
公投第１６案,臺南市,中西區,城隍里,957,1436,394,315,709,58,767
公投第１６案,臺南市,中西區,城隍里,958,1265,339,311,650,71,721
公投第１６案,臺南市,中西區,城隍里,959,856,254,218,472,53,525
公投第１６案,臺南市,中西區,南美里,960,1168,299,266,565,53,618
公投第１６案,臺南市,中西區,南美里,961,1134,312,265,577,88,665
公投第１６案,臺南市,中西區,南美里,962,995,307,245,552,68,620
公投第１６案,臺南市,中西區,南門里,963,1313,436,330,766,43,809
公投第１６案,臺南市,中西區,南門里,964,1265,352,332,684,67,751
公投第１６案,臺南市,中西區,小西門里,965,1215,303,292,595,56,651
公投第１６案,臺南市,中西區,小西門里,966,1248,365,269,634,51,685
公投第１６案,臺南市,中西區,小西門里,967,687,199,139,338,43,381
公投第１６案,臺南市,中西區,五條港里,968,1139,310,231,541,93,634
公投第１６案,臺南市,中西區,五條港里,969,971,293,210,503,64,567
公投第１６案,臺南市,中西區,兌悅里,970,1254,279,197,476,67,543
公投第１６案,臺南市,中西區,兌悅里,971,979,252,240,492,50,542
公投第１６案,臺南市,中西區,兌悅里,972,1745,452,361,813,76,889
公投第１６案,臺南市,中西區,淺草里,973,1074,269,267,536,45,581
公投第１６案,臺南市,中西區,淺草里,974,1436,364,299,663,55,718
公投第１６案,臺南市,中西區,府前里,975,865,234,195,429,67,496
公投第１６案,臺南市,中西區,府前里,976,1164,312,262,574,63,637
公投第１６案,臺南市,中西區,南廠里,977,1285,298,262,560,50,610
公投第１６案,臺南市,中西區,南廠里,978,1078,270,269,539,55,594
公投第１６案,臺南市,中西區,南廠里,979,1704,383,296,679,69,748
公投第１６案,臺南市,中西區,西和里,980,1296,342,306,648,108,756
公投第１６案,臺南市,中西區,西和里,981,1128,315,251,566,56,622
公投第１６案,臺南市,中西區,西和里,982,1245,374,273,647,40,687
公投第１６案,臺南市,安平區,文平里,983,1753,478,382,860,94,954
公投第１６案,臺南市,安平區,文平里,984,1859,523,363,886,64,950
公投第１６案,臺南市,安平區,文平里,985,1382,432,321,753,52,805
公投第１６案,臺南市,安平區,建平里,986,2547,665,502,1167,93,1260
公投第１６案,臺南市,安平區,建平里,987,2407,618,539,1157,87,1244
公投第１６案,臺南市,安平區,怡平里,988,2070,506,377,883,59,942
公投第１６案,臺南市,安平區,怡平里,989,2132,685,338,1023,55,1078
公投第１６案,臺南市,安平區,華平里,990,1450,412,326,738,34,772
公投第１６案,臺南市,安平區,華平里,991,1605,424,331,755,35,790
公投第１６案,臺南市,安平區,華平里,992,1755,472,406,878,68,946
公投第１６案,臺南市,安平區,平通里,993,1728,425,328,753,60,813
公投第１６案,臺南市,安平區,平通里,994,1754,349,313,662,65,727
公投第１６案,臺南市,安平區,平通里,995,1686,449,348,797,75,872
公投第１６案,臺南市,安平區,平通里,996,1843,545,397,942,50,992
公投第１６案,臺南市,安平區,億載里,997,1565,466,355,821,50,871
公投第１６案,臺南市,安平區,億載里,998,1288,368,263,631,38,669
公投第１６案,臺南市,安平區,育平里,999,1653,441,315,756,30,786
公投第１６案,臺南市,安平區,育平里,1000,1697,489,278,767,44,811
公投第１６案,臺南市,安平區,育平里,1001,2154,532,408,940,69,1009
公投第１６案,臺南市,安平區,育平里,1002,2107,537,425,962,65,1027
公投第１６案,臺南市,安平區,國平里,1003,1675,490,350,840,86,926
公投第１６案,臺南市,安平區,國平里,1004,1979,527,428,955,67,1022
公投第１６案,臺南市,安平區,國平里,1005,1602,427,311,738,47,785
公投第１６案,臺南市,安平區,國平里,1006,1586,463,273,736,65,801
公投第１６案,臺南市,安平區,漁光里,1007,438,98,71,169,13,182
公投第１６案,臺南市,安平區,平安里,1008,1780,479,335,814,88,902
公投第１６案,臺南市,安平區,平安里,1009,1623,383,332,715,54,769
公投第１６案,臺南市,安平區,天妃里,1010,2157,555,393,948,111,1059
公投第１６案,臺南市,安平區,天妃里,1011,1286,302,261,563,59,622
公投第１６案,臺南市,安平區,王城里,1012,1492,391,306,697,90,787
公投第１６案,臺南市,安平區,王城里,1013,1325,318,205,523,50,573
公投第１６案,臺南市,安平區,金城里,1014,2001,497,375,872,119,991
公投第１６案,臺南市,南區,大恩里,1015,1221,317,288,605,76,681
公投第１６案,臺南市,南區,大恩里,1016,2171,520,394,914,94,1008
公投第１６案,臺南市,南區,大林里,1017,1150,315,287,602,66,668
公投第１６案,臺南市,南區,大林里,1018,1122,340,228,568,58,626
公投第１６案,臺南市,南區,大忠里,1019,1444,387,243,630,70,700
公投第１６案,臺南市,南區,大忠里,1020,1765,466,312,778,89,867
公投第１６案,臺南市,南區,大忠里,1021,1298,385,296,681,61,742
公投第１６案,臺南市,南區,新生里,1022,1458,448,286,734,68,802
公投第１６案,臺南市,南區,新生里,1023,1940,549,338,887,43,930
公投第１６案,臺南市,南區,竹溪里,1024,1637,426,364,790,73,863
公投第１６案,臺南市,南區,明德里,1025,871,213,160,373,23,396
公投第１６案,臺南市,南區,大成里,1026,589,182,128,310,25,335
公投第１６案,臺南市,南區,大成里,1027,801,242,237,479,45,524
公投第１６案,臺南市,南區,田寮里,1028,990,295,201,496,72,568
公投第１６案,臺南市,南區,田寮里,1029,1222,403,275,678,63,741
公投第１６案,臺南市,南區,田寮里,1030,997,301,215,516,83,599
公投第１６案,臺南市,南區,新興里,1031,1204,299,250,549,45,594
公投第１６案,臺南市,南區,新興里,1032,1570,383,287,670,51,721
公投第１６案,臺南市,南區,再興里,1033,1222,343,274,617,62,679
公投第１６案,臺南市,南區,再興里,1034,1076,281,192,473,35,508
公投第１６案,臺南市,南區,廣州里,1035,1127,280,256,536,46,582
公投第１６案,臺南市,南區,廣州里,1036,1135,317,245,562,61,623
公投第１６案,臺南市,南區,新昌里,1037,1263,316,277,593,77,670
公投第１６案,臺南市,南區,新昌里,1038,1014,265,189,454,49,503
公投第１６案,臺南市,南區,文華里,1039,1491,449,299,748,87,835
公投第１６案,臺南市,南區,文華里,1040,1815,485,364,849,83,932
公投第１６案,臺南市,南區,文南里,1041,1398,361,277,638,45,683
公投第１６案,臺南市,南區,文南里,1042,2107,477,357,834,56,890
公投第１６案,臺南市,南區,文南里,1043,1587,453,394,847,85,932
公投第１６案,臺南市,南區,金華里,1044,1626,498,354,852,97,949
公投第１６案,臺南市,南區,金華里,1045,1761,420,369,789,45,834
公投第１６案,臺南市,南區,金華里,1046,1630,439,342,781,87,868
公投第１６案,臺南市,南區,國宅里,1047,1542,418,329,747,83,830
公投第１６案,臺南市,南區,國宅里,1048,1464,380,290,670,106,776
公投第１６案,臺南市,南區,鹽埕里,1049,1727,441,353,794,116,910
公投第１６案,臺南市,南區,鹽埕里,1050,1085,332,254,586,65,651
公投第１６案,臺南市,南區,鹽埕里,1051,939,223,207,430,31,461
公投第１６案,臺南市,南區,光明里,1052,1419,301,275,576,102,678
公投第１６案,臺南市,南區,光明里,1053,1333,331,260,591,78,669
公投第１６案,臺南市,南區,光明里,1054,1465,363,295,658,73,731
公投第１６案,臺南市,南區,明亮里,1055,1099,314,207,521,40,561
公投第１６案,臺南市,南區,明亮里,1056,1133,303,191,494,42,536
公投第１６案,臺南市,南區,明亮里,1057,1375,335,259,594,118,712
公投第１６案,臺南市,南區,府南里,1058,1781,404,336,740,47,787
公投第１６案,臺南市,南區,府南里,1059,1542,474,339,813,60,873
公投第１６案,臺南市,南區,府南里,1060,1486,359,279,638,75,713
公投第１６案,臺南市,南區,明興里,1061,1640,446,360,806,103,909
公投第１６案,臺南市,南區,明興里,1062,1701,395,307,702,63,765
公投第１６案,臺南市,南區,郡南里,1063,1541,381,280,661,99,760
公投第１６案,臺南市,南區,郡南里,1064,2027,498,391,889,132,1021
公投第１６案,臺南市,南區,建南里,1065,1774,511,414,925,104,1029
公投第１６案,臺南市,南區,建南里,1066,1613,417,320,737,95,832
公投第１６案,臺南市,南區,建南里,1067,1707,428,344,772,42,814
公投第１６案,臺南市,南區,南都里,1068,1657,294,230,524,31,555
公投第１６案,臺南市,南區,南都里,1069,1077,271,248,519,62,581
公投第１６案,臺南市,南區,南華里,1070,1185,332,233,565,64,629
公投第１６案,臺南市,南區,南華里,1071,1249,344,258,602,60,662
公投第１６案,臺南市,南區,開南里,1072,1985,467,351,818,42,860
公投第１６案,臺南市,南區,開南里,1073,2017,440,368,808,100,908
公投第１６案,臺南市,南區,開南里,1074,1717,384,352,736,93,829
公投第１６案,臺南市,南區,彰南里,1075,929,259,200,459,54,513
公投第１６案,臺南市,南區,彰南里,1076,695,185,173,358,36,394
公投第１６案,臺南市,南區,鯤鯓里,1077,997,226,176,402,38,440
公投第１６案,臺南市,南區,鯤鯓里,1078,784,190,120,310,30,340
公投第１６案,臺南市,南區,喜北里,1079,1119,321,229,550,106,656
公投第１６案,臺南市,南區,喜北里,1080,1054,228,171,399,40,439
公投第１６案,臺南市,南區,喜南里,1081,1245,299,214,513,127,640
公投第１６案,臺南市,南區,喜東里,1082,2064,479,376,855,77,932
公投第１６案,臺南市,南區,省躬里,1083,2056,427,330,757,44,801
公投第１６案,臺南市,南區,省躬里,1084,1373,293,248,541,44,585
公投第１６案,臺南市,南區,永寧里,1085,1002,201,159,360,54,414
公投第１６案,臺南市,南區,永寧里,1086,760,215,158,373,63,436
公投第１６案,臺南市,南區,松安里,1087,1031,254,216,470,96,566
公投第１６案,臺南市,南區,松安里,1088,744,194,144,338,71,409
公投第１６案,臺南市,南區,佛壇里,1089,1186,314,240,554,89,643
公投第１６案,臺南市,南區,佛壇里,1090,1358,340,305,645,99,744
公投第１６案,臺南市,南區,同安里,1091,897,195,158,353,41,394
公投第１６案,臺南市,南區,同安里,1092,1265,318,242,560,97,657
公投第１６案,臺南市,南區,興農里,1093,1093,227,199,426,62,488
公投第１６案,臺南市,南區,興農里,1094,1016,297,200,497,49,546
公投第１６案,臺南市,東區,崇信里,1095,2681,572,398,970,75,1045
公投第１６案,臺南市,東區,崇信里,1096,1811,496,373,869,48,917
公投第１６案,臺南市,東區,崇學里,1097,1491,470,371,841,89,930
公投第１６案,臺南市,東區,崇學里,1098,1378,436,272,708,48,756
公投第１６案,臺南市,東區,崇德里,1099,1552,482,331,813,75,888
公投第１６案,臺南市,東區,崇德里,1100,1326,395,339,734,30,764
公投第１６案,臺南市,東區,崇德里,1101,1594,465,359,824,75,899
公投第１６案,臺南市,東區,崇善里,1102,1639,493,400,893,51,944
公投第１６案,臺南市,東區,崇善里,1103,1724,484,370,854,77,931
公投第１６案,臺南市,東區,崇善里,1104,1629,472,341,813,95,908
公投第１６案,臺南市,東區,崇成里,1105,1399,436,290,726,37,763
公投第１６案,臺南市,東區,崇成里,1106,1534,462,319,781,46,827
公投第１６案,臺南市,東區,崇文里,1107,1656,505,364,869,68,937
公投第１６案,臺南市,東區,崇文里,1108,1322,372,304,676,54,730
公投第１６案,臺南市,東區,崇文里,1109,1620,518,322,840,42,882
公投第１６案,臺南市,東區,崇文里,1110,1331,464,308,772,42,814
公投第１６案,臺南市,東區,東智里,1111,1039,325,213,538,49,587
公投第１６案,臺南市,東區,東智里,1112,1257,334,229,563,42,605
公投第１６案,臺南市,東區,大智里,1113,2067,549,377,926,124,1050
公投第１６案,臺南市,東區,大智里,1114,2153,693,408,1101,47,1148
公投第１６案,臺南市,東區,大智里,1115,2363,715,442,1157,73,1230
公投第１６案,臺南市,東區,德高里,1116,1427,405,325,730,58,788
公投第１６案,臺南市,東區,德高里,1117,1555,467,335,802,56,858
公投第１６案,臺南市,東區,仁和里,1118,2115,530,354,884,69,953
公投第１６案,臺南市,東區,仁和里,1119,2340,622,442,1064,92,1156
公投第１６案,臺南市,東區,和平里,1120,2474,716,515,1231,83,1314
公投第１６案,臺南市,東區,和平里,1121,2391,678,485,1163,76,1239
公投第１６案,臺南市,東區,虎尾里,1122,1673,484,369,853,77,930
公投第１６案,臺南市,東區,虎尾里,1123,1594,451,331,782,48,830
公投第１６案,臺南市,東區,虎尾里,1124,1607,498,346,844,77,921
公投第１６案,臺南市,東區,裕聖里,1125,2087,713,441,1154,45,1199
公投第１６案,臺南市,東區,裕聖里,1126,2369,757,548,1305,53,1358
公投第１６案,臺南市,東區,復興里,1127,1696,459,331,790,121,911
公投第１６案,臺南市,東區,復興里,1128,1612,432,382,814,45,859
公投第１６案,臺南市,東區,自強里,1129,1708,420,390,810,75,885
公投第１６案,臺南市,東區,自強里,1130,1560,450,347,797,59,856
公投第１６案,臺南市,東區,自強里,1131,1854,536,392,928,61,989
公投第１６案,臺南市,東區,東聖里,1132,2278,582,458,1040,57,1097
公投第１６案,臺南市,東區,關聖里,1133,2093,587,418,1005,61,1066
公投第１６案,臺南市,東區,關聖里,1134,2242,696,509,1205,74,1279
公投第１６案,臺南市,東區,南聖里,1135,1152,372,247,619,73,692
公投第１６案,臺南市,東區,南聖里,1136,1318,441,328,769,28,797
公投第１６案,臺南市,東區,文聖里,1137,2200,676,463,1139,63,1202
公投第１６案,臺南市,東區,文聖里,1138,1960,653,434,1087,60,1147
公投第１６案,臺南市,東區,後甲里,1139,1489,413,332,745,50,795
公投第１６案,臺南市,東區,後甲里,1140,1443,398,313,711,83,794
公投第１６案,臺南市,東區,東光里,1141,1498,468,394,862,44,906
公投第１６案,臺南市,東區,東光里,1142,1622,496,367,863,28,891
公投第１６案,臺南市,東區,東光里,1143,1738,537,376,913,53,966
公投第１６案,臺南市,東區,東明里,1144,1501,393,322,715,81,796
公投第１６案,臺南市,東區,東明里,1145,1482,442,333,775,57,832
公投第１６案,臺南市,東區,莊敬里,1146,1829,488,358,846,46,892
公投第１６案,臺南市,東區,莊敬里,1147,1764,546,357,903,59,962
公投第１６案,臺南市,東區,小東里,1148,1427,440,322,762,57,819
公投第１６案,臺南市,東區,小東里,1149,1427,390,319,709,60,769
公投第１６案,臺南市,東區,小東里,1150,1388,469,256,725,56,781
公投第１６案,臺南市,東區,大學里,1151,1131,368,283,651,36,687
公投第１６案,臺南市,東區,成大里,1152,1000,278,218,496,43,539
公投第１６案,臺南市,東區,成大里,1153,996,304,212,516,38,554
公投第１６案,臺南市,東區,東門里,1154,935,247,215,462,39,501
公投第１６案,臺南市,東區,東門里,1155,947,249,230,479,66,545
公投第１６案,臺南市,東區,圍下里,1156,1090,310,250,560,24,584
公投第１６案,臺南市,東區,圍下里,1157,896,226,191,417,64,481
公投第１６案,臺南市,東區,中西里,1158,1589,462,340,802,30,832
公投第１６案,臺南市,東區,中西里,1159,1497,426,362,788,52,840
公投第１６案,臺南市,東區,東安里,1160,1386,354,304,658,66,724
公投第１６案,臺南市,東區,新東里,1161,1101,309,260,569,24,593
公投第１６案,臺南市,東區,新東里,1162,1332,380,327,707,66,773
公投第１６案,臺南市,東區,崇誨里,1163,1185,366,249,615,56,671
公投第１６案,臺南市,東區,崇誨里,1164,1262,388,292,680,62,742
公投第１６案,臺南市,東區,衛國里,1165,1517,442,239,681,92,773
公投第１６案,臺南市,東區,裕農里,1166,1287,343,282,625,86,711
公投第１６案,臺南市,東區,裕農里,1167,1657,483,362,845,76,921
公投第１６案,臺南市,東區,富強里,1168,2238,623,477,1100,116,1216
公投第１６案,臺南市,東區,富強里,1169,2246,614,476,1090,64,1154
公投第１６案,臺南市,東區,富裕里,1170,2191,574,489,1063,72,1135
公投第１６案,臺南市,東區,忠孝里,1171,2063,565,415,980,92,1072
公投第１６案,臺南市,東區,忠孝里,1172,2177,683,470,1153,96,1249
公投第１６案,臺南市,東區,崇明里,1173,1863,592,406,998,84,1082
公投第１６案,臺南市,東區,崇明里,1174,2185,691,447,1138,53,1191
公投第１６案,臺南市,東區,大福里,1175,1721,429,314,743,72,815
公投第１６案,臺南市,東區,大德里,1176,1556,413,324,737,126,863
公投第１６案,臺南市,東區,路東里,1177,1602,504,371,875,48,923
公投第１６案,臺南市,東區,大同里,1178,1523,407,312,719,82,801
公投第１６案,臺南市,東區,大同里,1179,1382,409,274,683,59,742
公投第１６案,臺南市,東區,泉南里,1180,1486,417,320,737,52,789
公投第１６案,臺南市,東區,泉南里,1181,1560,428,367,795,77,872
公投第１６案,臺南市,東區,泉南里,1182,1684,416,342,758,75,833
公投第１６案,臺南市,東區,龍山里,1183,1653,494,379,873,44,917
公投第１６案,臺南市,東區,龍山里,1184,1554,453,358,811,33,844
公投第１６案,臺南市,東區,龍山里,1185,1408,420,335,755,40,795
公投第１６案,臺南市,東區,德光里,1186,2084,640,497,1137,59,1196
公投第１６案,臺南市,東區,德光里,1187,1896,545,419,964,69,1033
公投第１６案,臺南市,仁德區,太子里,1188,1318,355,295,650,72,722
公投第１６案,臺南市,仁德區,太子里,1189,1406,396,304,700,70,770
公投第１６案,臺南市,仁德區,太子里,1190,1465,393,283,676,90,766
公投第１６案,臺南市,仁德區,太子里,1191,1192,329,309,638,78,716
公投第１６案,臺南市,仁德區,土庫里,1192,1429,402,350,752,77,829
公投第１６案,臺南市,仁德區,土庫里,1193,1320,335,280,615,107,722
公投第１６案,臺南市,仁德區,一甲里,1194,1373,454,274,728,97,825
公投第１６案,臺南市,仁德區,一甲里,1195,1330,392,304,696,65,761
公投第１６案,臺南市,仁德區,仁德里,1196,1687,513,353,866,56,922
公投第１６案,臺南市,仁德區,仁德里,1197,1491,361,326,687,67,754
公投第１６案,臺南市,仁德區,仁德里,1198,1151,287,199,486,54,540
公投第１６案,臺南市,仁德區,仁德里,1199,1407,414,280,694,34,728
公投第１６案,臺南市,仁德區,仁德里,1200,1465,461,301,762,65,827
公投第１６案,臺南市,仁德區,仁義里,1201,1335,413,286,699,51,750
公投第１６案,臺南市,仁德區,仁義里,1202,1490,399,312,711,75,786
公投第１６案,臺南市,仁德區,仁義里,1203,1453,463,308,771,81,852
公投第１６案,臺南市,仁德區,仁義里,1204,990,266,182,448,33,481
公投第１６案,臺南市,仁德區,仁義里,1205,1573,476,339,815,73,888
公投第１６案,臺南市,仁德區,仁義里,1206,1031,255,229,484,82,566
公投第１６案,臺南市,仁德區,仁義里,1207,1194,333,255,588,38,626
公投第１６案,臺南市,仁德區,新田里,1208,1268,325,251,576,78,654
公投第１６案,臺南市,仁德區,新田里,1209,929,249,210,459,53,512
公投第１６案,臺南市,仁德區,新田里,1210,1145,306,199,505,15,520
公投第１６案,臺南市,仁德區,後壁里,1211,1413,374,273,647,64,711
公投第１６案,臺南市,仁德區,後壁里,1212,1465,396,284,680,108,788
公投第１６案,臺南市,仁德區,後壁里,1213,1390,366,363,729,69,798
公投第１６案,臺南市,仁德區,後壁里,1214,1396,363,313,676,90,766
公投第１６案,臺南市,仁德區,後壁里,1215,1906,561,374,935,62,997
公投第１６案,臺南市,仁德區,後壁里,1216,1546,454,266,720,52,772
公投第１６案,臺南市,仁德區,上崙里,1217,1546,359,277,636,47,683
公投第１６案,臺南市,仁德區,上崙里,1218,1399,424,252,676,69,745
公投第１６案,臺南市,仁德區,上崙里,1219,1748,473,344,817,110,927
公投第１６案,臺南市,仁德區,上崙里,1220,1140,313,271,584,59,643
公投第１６案,臺南市,仁德區,文賢里,1221,1277,343,241,584,32,616
公投第１６案,臺南市,仁德區,文賢里,1222,1019,349,240,589,52,641
公投第１６案,臺南市,仁德區,保安里,1223,1414,349,275,624,48,672
公投第１６案,臺南市,仁德區,保安里,1224,1349,328,243,571,40,611
公投第１６案,臺南市,仁德區,成功里,1225,1471,406,282,688,38,726
公投第１６案,臺南市,仁德區,成功里,1226,1324,362,268,630,32,662
公投第１６案,臺南市,仁德區,成功里,1227,1310,346,214,560,72,632
公投第１６案,臺南市,仁德區,成功里,1228,554,163,120,283,28,311
公投第１６案,臺南市,仁德區,仁和里,1229,1395,444,255,699,50,749
公投第１６案,臺南市,仁德區,仁愛里,1230,1264,366,251,617,20,637
公投第１６案,臺南市,仁德區,二行里,1231,1180,311,217,528,98,626
公投第１６案,臺南市,仁德區,二行里,1232,928,192,178,370,43,413
公投第１６案,臺南市,仁德區,大甲里,1233,965,225,174,399,32,431
公投第１６案,臺南市,仁德區,大甲里,1234,1119,251,206,457,47,504
公投第１６案,臺南市,仁德區,中洲里,1235,1206,343,221,564,86,650
公投第１６案,臺南市,仁德區,中洲里,1236,1466,366,233,599,69,668
公投第１６案,臺南市,歸仁區,南保里,1237,1560,414,308,722,80,802
公投第１６案,臺南市,歸仁區,南保里,1238,1383,435,317,752,84,836
公投第１６案,臺南市,歸仁區,南保里,1239,1491,413,317,730,48,778
公投第１６案,臺南市,歸仁區,南保里,1240,1482,377,280,657,73,730
公投第１６案,臺南市,歸仁區,南興里,1241,1330,361,274,635,40,675
公投第１６案,臺南市,歸仁區,南興里,1242,1399,403,325,728,56,784
公投第１６案,臺南市,歸仁區,南興里,1243,1416,378,267,645,45,690
公投第１６案,臺南市,歸仁區,六甲里,1244,1336,200,322,522,49,571
公投第１６案,臺南市,歸仁區,六甲里,1245,1183,294,220,514,71,585
公投第１６案,臺南市,歸仁區,六甲里,1246,1237,287,256,543,34,577
公投第１６案,臺南市,歸仁區,歸南里,1247,1133,315,250,565,72,637
公投第１６案,臺南市,歸仁區,歸南里,1248,1149,299,224,523,52,575
公投第１６案,臺南市,歸仁區,後市里,1249,1105,293,246,539,13,552
公投第１６案,臺南市,歸仁區,後市里,1250,1099,286,242,528,73,601
公投第１６案,臺南市,歸仁區,後市里,1251,1082,300,238,538,91,629
公投第１６案,臺南市,歸仁區,文化里,1252,1519,413,323,736,64,800
公投第１６案,臺南市,歸仁區,文化里,1253,1467,453,304,757,82,839
公投第１６案,臺南市,歸仁區,辜厝里,1254,1090,293,240,533,46,579
公投第１６案,臺南市,歸仁區,辜厝里,1255,1131,308,212,520,35,555
公投第１６案,臺南市,歸仁區,辜厝里,1256,1080,278,210,488,41,529
公投第１６案,臺南市,歸仁區,新厝里,1257,1121,262,198,460,34,494
公投第１６案,臺南市,歸仁區,新厝里,1258,1336,361,260,621,98,719
公投第１６案,臺南市,歸仁區,許厝里,1259,1128,290,237,527,87,614
公投第１６案,臺南市,歸仁區,許厝里,1260,1055,264,232,496,34,530
公投第１６案,臺南市,歸仁區,許厝里,1261,1102,298,239,537,49,586
公投第１６案,臺南市,歸仁區,看西里,1262,1068,314,211,525,55,580
公投第１６案,臺南市,歸仁區,看西里,1263,1033,300,224,524,69,593
公投第１６案,臺南市,歸仁區,看東里,1264,1772,385,265,650,41,691
公投第１６案,臺南市,歸仁區,崙頂里,1265,1399,408,272,680,88,768
公投第１６案,臺南市,歸仁區,崙頂里,1266,1544,436,323,759,43,802
公投第１６案,臺南市,歸仁區,沙崙里,1267,684,155,118,273,14,287
公投第１６案,臺南市,歸仁區,大潭里,1268,839,242,197,439,51,490
公投第１６案,臺南市,歸仁區,大潭里,1269,1014,294,234,528,63,591
公投第１６案,臺南市,歸仁區,武東里,1270,1906,391,272,663,38,701
公投第１６案,臺南市,歸仁區,歸仁里,1271,1245,353,281,634,76,710
公投第１６案,臺南市,歸仁區,歸仁里,1272,1048,291,207,498,58,556
公投第１６案,臺南市,歸仁區,八甲里,1273,1175,321,228,549,30,579
公投第１６案,臺南市,歸仁區,八甲里,1274,1411,332,261,593,48,641
公投第１６案,臺南市,歸仁區,七甲里,1275,1514,472,326,798,53,851
公投第１６案,臺南市,歸仁區,七甲里,1276,1678,472,355,827,75,902
公投第１６案,臺南市,歸仁區,媽廟里,1277,949,258,213,471,35,506
公投第１６案,臺南市,歸仁區,媽廟里,1278,1009,303,225,528,71,599
公投第１６案,臺南市,歸仁區,西埔里,1279,984,316,256,572,8,580
公投第１６案,臺南市,歸仁區,西埔里,1280,756,221,171,392,55,447
公投第１６案,臺南市,歸仁區,大廟里,1281,1478,476,326,802,75,877
公投第１６案,臺南市,歸仁區,大廟里,1282,1467,579,205,784,80,864
公投第１６案,臺南市,關廟區,關廟里,1283,982,357,108,465,34,499
公投第１６案,臺南市,關廟區,關廟里,1284,1156,367,252,619,48,667
公投第１６案,臺南市,關廟區,山西里,1285,1006,239,199,438,29,467
公投第１６案,臺南市,關廟區,山西里,1286,1043,316,250,566,65,631
公投第１６案,臺南市,關廟區,香洋里,1287,1012,271,216,487,94,581
公投第１６案,臺南市,關廟區,香洋里,1288,1013,245,177,422,20,442
公投第１６案,臺南市,關廟區,香洋里,1289,1294,342,253,595,50,645
公投第１６案,臺南市,關廟區,北勢里,1290,1264,341,230,571,53,624
公投第１６案,臺南市,關廟區,北勢里,1291,1166,327,219,546,47,593
公投第１６案,臺南市,關廟區,新埔里,1292,1018,260,180,440,25,465
公投第１６案,臺南市,關廟區,新光里,1293,733,185,108,293,48,341
公投第１６案,臺南市,關廟區,五甲里,1294,1093,333,240,573,36,609
公投第１６案,臺南市,關廟區,五甲里,1295,1081,333,206,539,28,567
公投第１６案,臺南市,關廟區,五甲里,1296,978,292,232,524,52,576
公投第１６案,臺南市,關廟區,東勢里,1297,1116,286,198,484,27,511
公投第１６案,臺南市,關廟區,東勢里,1298,972,266,188,454,65,519
公投第１６案,臺南市,關廟區,東勢里,1299,1045,280,217,497,106,603
公投第１６案,臺南市,關廟區,松腳里,1300,872,251,165,416,44,460
公投第１６案,臺南市,關廟區,松腳里,1301,1007,278,242,520,54,574
公投第１６案,臺南市,關廟區,花園里,1302,763,229,163,392,65,457
公投第１６案,臺南市,關廟區,花園里,1303,630,168,130,298,36,334
公投第１６案,臺南市,關廟區,花園里,1304,959,264,225,489,63,552
公投第１６案,臺南市,關廟區,花園里,1305,1123,302,215,517,52,569
公投第１６案,臺南市,關廟區,深坑里,1306,804,229,160,389,69,458
公投第１６案,臺南市,關廟區,深坑里,1307,720,175,149,324,20,344
公投第１６案,臺南市,關廟區,布袋里,1308,843,212,128,340,26,366
公投第１６案,臺南市,關廟區,布袋里,1309,358,77,75,152,21,173
公投第１６案,臺南市,關廟區,南雄里,1310,797,221,137,358,68,426
公投第１６案,臺南市,關廟區,南雄里,1311,709,180,100,280,19,299
公投第１６案,臺南市,關廟區,埤頭里,1312,904,204,174,378,26,404
公投第１６案,臺南市,關廟區,埤頭里,1313,963,248,188,436,29,465
公投第１６案,臺南市,關廟區,下湖里,1314,489,125,111,236,6,242
公投第１６案,臺南市,龍崎區,崎頂里,1315,1047,269,189,458,65,523
公投第１６案,臺南市,龍崎區,土崎里,1316,630,154,101,255,22,277
公投第１６案,臺南市,龍崎區,中坑里,1317,141,31,17,48,4,52
公投第１６案,臺南市,龍崎區,楠坑里,1318,367,83,77,160,15,175
公投第１６案,臺南市,龍崎區,牛埔里,1319,337,95,55,150,14,164
公投第１６案,臺南市,龍崎區,大坪里,1320,318,62,56,118,12,130
公投第１６案,臺南市,龍崎區,龍船里,1321,427,112,73,185,29,214
公投第１６案,臺南市,龍崎區,石𥕢里,1322,446,97,70,167,17,184
公投第１６案,桃園市,桃園區,大林里,1,1593,419,327,746,65,811
公投第１６案,桃園市,桃園區,大林里,2,1934,454,355,809,38,847
公投第１６案,桃園市,桃園區,大林里,3,1661,499,337,836,78,914
公投第１６案,桃園市,桃園區,大林里,4,1448,392,246,638,32,670
公投第１６案,桃園市,桃園區,大樹里,5,1974,499,386,885,64,949
公投第１６案,桃園市,桃園區,大樹里,6,1882,468,309,777,90,867
公投第１６案,桃園市,桃園區,大豐里,7,1800,497,336,833,51,884
公投第１６案,桃園市,桃園區,大豐里,8,1598,506,301,807,66,873
公投第１６案,桃園市,桃園區,大豐里,9,1626,492,285,777,94,871
公投第１６案,桃園市,桃園區,建國里,10,1590,420,294,714,64,778
公投第１６案,桃園市,桃園區,建國里,11,1637,446,304,750,81,831
公投第１６案,桃園市,桃園區,建國里,12,1943,510,377,887,66,953
公投第１６案,桃園市,桃園區,雲林里,13,1482,409,307,716,64,780
公投第１６案,桃園市,桃園區,雲林里,14,1423,398,330,728,50,778
公投第１６案,桃園市,桃園區,雲林里,15,1509,514,262,776,56,832
公投第１６案,桃園市,桃園區,雲林里,16,1567,527,284,811,38,849
公投第１６案,桃園市,桃園區,福安里,17,1305,423,241,664,45,709
公投第１６案,桃園市,桃園區,福安里,18,1416,367,268,635,48,683
公投第１６案,桃園市,桃園區,福安里,19,1439,458,300,758,53,811
公投第１６案,桃園市,桃園區,福林里,20,1399,385,333,718,64,782
公投第１６案,桃園市,桃園區,福林里,21,1540,483,320,803,57,860
公投第１６案,桃園市,桃園區,福林里,22,1638,475,274,749,55,804
公投第１６案,桃園市,桃園區,福林里,23,1228,312,305,617,48,665
公投第１６案,桃園市,桃園區,豐林里,24,1649,409,294,703,125,828
公投第１６案,桃園市,桃園區,豐林里,25,1601,476,310,786,50,836
公投第１６案,桃園市,桃園區,豐林里,26,1477,399,251,650,100,750
公投第１６案,桃園市,桃園區,豐林里,27,1503,469,272,741,50,791
公投第１６案,桃園市,桃園區,中和里,28,1375,415,296,711,80,791
公投第１６案,桃園市,桃園區,中興里,29,1743,503,376,879,58,937
公投第１６案,桃園市,桃園區,中興里,30,1862,501,324,825,84,909
公投第１６案,桃園市,桃園區,中興里,31,1728,504,333,837,67,904
公投第１６案,桃園市,桃園區,文化里,32,690,193,149,342,20,362
公投第１６案,桃園市,桃園區,文昌里,33,852,250,226,476,39,515
公投第１６案,桃園市,桃園區,文明里,34,1353,435,282,717,67,784
公投第１６案,桃園市,桃園區,北門里,35,1698,345,256,601,39,640
公投第１６案,桃園市,桃園區,民生里,36,1452,411,271,682,66,748
公投第１６案,桃園市,桃園區,永興里,37,1681,465,329,794,77,871
公投第１６案,桃園市,桃園區,光興里,38,1669,460,326,786,69,855
公投第１６案,桃園市,桃園區,光興里,39,1530,454,341,795,71,866
公投第１６案,桃園市,桃園區,光興里,40,1582,462,323,785,71,856
公投第１６案,桃園市,桃園區,西門里,41,1587,426,293,719,48,767
公投第１６案,桃園市,桃園區,西湖里,42,1451,407,313,720,81,801
公投第１６案,桃園市,桃園區,武陵里,43,1582,381,285,666,54,720
公投第１６案,桃園市,桃園區,長美里,44,1028,316,213,529,54,583
公投第１６案,桃園市,桃園區,南門里,45,1934,535,371,906,65,971
公投第１６案,桃園市,桃園區,南門里,46,1016,290,197,487,65,552
公投第１６案,桃園市,桃園區,南門里,47,1079,312,231,543,42,585
公投第１６案,桃園市,桃園區,南門里,48,1837,517,323,840,48,888
公投第１６案,桃園市,桃園區,南華里,49,1390,369,295,664,61,725
公投第１６案,桃園市,桃園區,中山里,50,1489,439,300,739,52,791
公投第１６案,桃園市,桃園區,中山里,51,1821,605,376,981,32,1013
公投第１６案,桃園市,桃園區,中山里,52,1563,427,281,708,29,737
公投第１６案,桃園市,桃園區,中山里,53,1697,519,350,869,47,916
公投第１６案,桃園市,桃園區,中平里,54,1740,549,338,887,53,940
公投第１６案,桃園市,桃園區,中平里,55,1626,494,300,794,60,854
公投第１６案,桃園市,桃園區,中平里,56,1239,395,245,640,37,677
公投第１６案,桃園市,桃園區,中正里,57,1766,603,316,919,27,946
公投第１６案,桃園市,桃園區,中正里,58,1555,443,318,761,69,830
公投第１６案,桃園市,桃園區,中正里,59,1831,555,355,910,56,966
公投第１６案,桃園市,桃園區,中成里,60,1115,334,278,612,53,665
公投第１６案,桃園市,桃園區,中成里,61,1562,440,362,802,60,862
公投第１６案,桃園市,桃園區,中成里,62,1744,516,332,848,48,896
公投第１６案,桃園市,桃園區,中信里,63,1838,480,327,807,55,862
公投第１６案,桃園市,桃園區,中信里,64,1889,544,381,925,94,1019
公投第１６案,桃園市,桃園區,中信里,65,1985,507,342,849,90,939
公投第１６案,桃園市,桃園區,中原里,66,1524,516,309,825,51,876
公投第１６案,桃園市,桃園區,中原里,67,1425,503,321,824,50,874
公投第１６案,桃園市,桃園區,中原里,68,1606,519,345,864,58,922
公投第１６案,桃園市,桃園區,中泰里,69,2056,688,410,1098,43,1141
公投第１６案,桃園市,桃園區,中泰里,70,2010,694,366,1060,54,1114
公投第１６案,桃園市,桃園區,中聖里,71,2245,657,383,1040,67,1107
公投第１６案,桃園市,桃園區,中聖里,72,1590,453,333,786,60,846
公投第１６案,桃園市,桃園區,中聖里,73,1536,551,329,880,37,917
公投第１６案,桃園市,桃園區,中路里,74,1949,500,377,877,66,943
公投第１６案,桃園市,桃園區,中路里,75,1965,561,348,909,62,971
公投第１６案,桃園市,桃園區,中德里,76,2414,645,375,1020,65,1085
公投第１６案,桃園市,桃園區,中德里,77,1942,565,369,934,64,998
公投第１６案,桃園市,桃園區,中德里,78,2156,642,394,1036,73,1109
公投第１６案,桃園市,桃園區,文中里,79,1404,441,286,727,65,792
公投第１６案,桃園市,桃園區,文中里,80,1194,416,253,669,39,708
公投第１６案,桃園市,桃園區,玉山里,81,1449,414,337,751,82,833
公投第１６案,桃園市,桃園區,玉山里,82,1803,503,289,792,81,873
公投第１６案,桃園市,桃園區,玉山里,83,1692,470,349,819,77,896
公投第１６案,桃園市,桃園區,泰山里,84,1913,563,356,919,75,994
公投第１６案,桃園市,桃園區,泰山里,85,1815,517,350,867,75,942
公投第１６案,桃園市,桃園區,龍山里,86,1173,305,223,528,59,587
公投第１６案,桃園市,桃園區,龍山里,87,1162,314,211,525,38,563
公投第１６案,桃園市,桃園區,龍山里,88,1194,275,187,462,93,555
公投第１６案,桃園市,桃園區,龍安里,89,1695,499,330,829,74,903
公投第１６案,桃園市,桃園區,龍安里,90,1797,527,326,853,51,904
公投第１６案,桃園市,桃園區,龍安里,91,1592,494,282,776,42,818
公投第１６案,桃園市,桃園區,龍岡里,92,1780,519,301,820,77,897
公投第１６案,桃園市,桃園區,龍岡里,93,1904,498,322,820,54,874
公投第１６案,桃園市,桃園區,龍岡里,94,2021,592,343,935,44,979
公投第１６案,桃園市,桃園區,龍祥里,95,1545,447,291,738,58,796
公投第１６案,桃園市,桃園區,龍祥里,96,1617,441,295,736,40,776
公投第１６案,桃園市,桃園區,龍祥里,97,1683,663,150,813,43,856
公投第１６案,桃園市,桃園區,龍壽里,98,1834,574,356,930,69,999
公投第１６案,桃園市,桃園區,龍壽里,99,2055,523,373,896,67,963
公投第１６案,桃園市,桃園區,龍壽里,100,1828,516,334,850,39,889
公投第１６案,桃園市,桃園區,龍鳳里,101,1873,512,360,872,46,918
公投第１６案,桃園市,桃園區,龍鳳里,102,3687,432,284,716,45,761
公投第１６案,桃園市,桃園區,龍鳳里,103,1850,515,367,882,53,935
公投第１６案,桃園市,桃園區,龍鳳里,104,1827,551,308,859,66,925
公投第１６案,桃園市,桃園區,中埔里,105,1149,373,253,626,63,689
公投第１６案,桃園市,桃園區,中埔里,106,1061,332,242,574,43,617
公投第１６案,桃園市,桃園區,中寧里,107,1831,508,309,817,42,859
公投第１６案,桃園市,桃園區,中寧里,108,2168,606,408,1014,68,1082
公投第１６案,桃園市,桃園區,中寧里,109,1874,503,370,873,46,919
公投第１６案,桃園市,桃園區,北埔里,110,1524,420,251,671,35,706
公投第１６案,桃園市,桃園區,北埔里,111,1528,492,288,780,32,812
公投第１６案,桃園市,桃園區,北埔里,112,1489,425,321,746,54,800
公投第１６案,桃園市,桃園區,永安里,113,1308,353,264,617,70,687
公投第１６案,桃園市,桃園區,永安里,114,1583,423,309,732,71,803
公投第１６案,桃園市,桃園區,永安里,115,1618,428,388,816,63,879
公投第１６案,桃園市,桃園區,同安里,116,2127,547,395,942,96,1038
公投第１６案,桃園市,桃園區,同安里,117,2033,636,306,942,41,983
公投第１６案,桃園市,桃園區,同安里,118,2098,632,368,1000,57,1057
公投第１６案,桃園市,桃園區,同安里,119,2126,641,417,1058,84,1142
公投第１６案,桃園市,桃園區,同德里,120,1917,565,328,893,53,946
公投第１６案,桃園市,桃園區,同德里,121,1997,547,378,925,51,976
公投第１６案,桃園市,桃園區,同德里,122,1929,571,363,934,53,987
公投第１６案,桃園市,桃園區,自強里,123,1691,503,320,823,34,857
公投第１６案,桃園市,桃園區,自強里,124,1900,473,347,820,39,859
公投第１６案,桃園市,桃園區,自強里,125,1761,508,341,849,87,936
公投第１６案,桃園市,桃園區,自強里,126,1922,565,342,907,46,953
公投第１６案,桃園市,桃園區,西埔里,127,1995,520,162,682,94,776
公投第１６案,桃園市,桃園區,西埔里,128,1063,304,228,532,51,583
公投第１６案,桃園市,桃園區,明德里,129,1412,430,239,669,63,732
公投第１６案,桃園市,桃園區,明德里,130,1746,433,356,789,45,834
公投第１６案,桃園市,桃園區,東埔里,131,1689,420,329,749,63,812
公投第１６案,桃園市,桃園區,東埔里,132,1542,388,235,623,39,662
公投第１６案,桃園市,桃園區,東埔里,133,1437,389,272,661,63,724
公投第１６案,桃園市,桃園區,長安里,134,1679,448,326,774,59,833
公投第１６案,桃園市,桃園區,長安里,135,1886,464,338,802,76,878
公投第１６案,桃園市,桃園區,長德里,136,1657,472,323,795,92,887
公投第１６案,桃園市,桃園區,長德里,137,1349,393,307,700,30,730
公投第１６案,桃園市,桃園區,長德里,138,1805,551,338,889,53,942
公投第１６案,桃園市,桃園區,信光里,139,1846,410,456,866,64,930
公投第１６案,桃園市,桃園區,信光里,140,1644,540,192,732,50,782
公投第１６案,桃園市,桃園區,信光里,141,1674,446,297,743,62,805
公投第１６案,桃園市,桃園區,信光里,142,1737,491,333,824,59,883
公投第１６案,桃園市,桃園區,南埔里,143,1566,472,297,769,68,837
公投第１６案,桃園市,桃園區,南埔里,144,1517,454,303,757,52,809
公投第１６案,桃園市,桃園區,南埔里,145,1619,434,267,701,48,749
公投第１６案,桃園市,桃園區,莊敬里,146,1774,494,353,847,57,904
公投第１６案,桃園市,桃園區,莊敬里,147,1666,511,314,825,46,871
公投第１６案,桃園市,桃園區,莊敬里,148,1528,447,320,767,31,798
公投第１６案,桃園市,桃園區,莊敬里,149,1709,461,341,802,64,866
公投第１６案,桃園市,桃園區,莊敬里,150,1719,502,336,838,25,863
公投第１６案,桃園市,桃園區,慈文里,151,1569,399,257,656,70,726
公投第１６案,桃園市,桃園區,慈文里,152,1505,436,255,691,51,742
公投第１６案,桃園市,桃園區,慈文里,153,1496,391,311,702,57,759
公投第１６案,桃園市,桃園區,慈文里,154,1505,469,268,737,68,805
公投第１６案,桃園市,桃園區,新埔里,155,1807,537,328,865,57,922
公投第１６案,桃園市,桃園區,新埔里,156,1857,530,364,894,55,949
公投第１６案,桃園市,桃園區,新埔里,157,1589,483,330,813,80,893
公投第１６案,桃園市,桃園區,新埔里,158,2088,580,413,993,56,1049
公投第１６案,桃園市,桃園區,新埔里,159,1893,575,334,909,47,956
公投第１６案,桃園市,桃園區,瑞慶里,160,1303,324,225,549,16,565
公投第１６案,桃園市,桃園區,瑞慶里,161,1416,431,276,707,48,755
公投第１６案,桃園市,桃園區,瑞慶里,162,1351,359,256,615,49,664
公投第１６案,桃園市,桃園區,瑞慶里,163,1659,452,305,757,53,810
公投第１６案,桃園市,桃園區,寶安里,164,2103,624,336,960,59,1019
公投第１６案,桃園市,桃園區,寶安里,165,1943,578,322,900,57,957
公投第１６案,桃園市,桃園區,寶安里,166,1927,589,340,929,49,978
公投第１６案,桃園市,桃園區,寶安里,167,1929,501,312,813,64,877
公投第１６案,桃園市,桃園區,寶慶里,168,2204,702,462,1164,64,1228
公投第１６案,桃園市,桃園區,寶慶里,169,2033,547,337,884,47,931
公投第１６案,桃園市,桃園區,寶慶里,170,1656,499,304,803,39,842
公投第１６案,桃園市,桃園區,三元里,171,1712,428,373,801,55,856
公投第１６案,桃園市,桃園區,三元里,172,1738,469,340,809,65,874
公投第１６案,桃園市,桃園區,三民里,173,1432,496,317,813,36,849
公投第１６案,桃園市,桃園區,三民里,174,1421,299,302,601,47,648
公投第１６案,桃園市,桃園區,三民里,175,1344,391,280,671,28,699
公投第１６案,桃園市,桃園區,大有里,176,1942,520,336,856,48,904
公投第１６案,桃園市,桃園區,大有里,177,2001,591,360,951,50,1001
公投第１６案,桃園市,桃園區,大有里,178,1941,518,320,838,34,872
公投第１６案,桃園市,桃園區,大業里,179,1702,505,356,861,39,900
公投第１６案,桃園市,桃園區,大業里,180,1589,448,310,758,64,822
公投第１６案,桃園市,桃園區,大業里,181,1544,459,269,728,50,778
公投第１６案,桃園市,桃園區,大興里,182,1860,447,283,730,58,788
公投第１６案,桃園市,桃園區,大興里,183,1726,485,317,802,66,868
公投第１６案,桃園市,桃園區,大興里,184,1798,462,347,809,60,869
公投第１６案,桃園市,桃園區,成功里,185,1925,577,344,921,52,973
公投第１６案,桃園市,桃園區,成功里,186,1945,551,344,895,68,963
公投第１６案,桃園市,桃園區,汴洲里,187,1764,429,336,765,63,828
公投第１６案,桃園市,桃園區,汴洲里,188,1899,649,300,949,83,1032
公投第１６案,桃園市,桃園區,汴洲里,189,1415,404,287,691,30,721
公投第１６案,桃園市,桃園區,忠義里,190,1790,501,203,704,50,754
公投第１６案,桃園市,桃園區,忠義里,191,1693,465,306,771,37,808
公投第１６案,桃園市,桃園區,東山里,192,1916,513,353,866,59,925
公投第１６案,桃園市,桃園區,東門里,193,1434,397,234,631,40,671
公投第１６案,桃園市,桃園區,東門里,194,1494,436,360,796,51,847
公投第１６案,桃園市,桃園區,青溪里,195,1311,369,283,652,69,721
公投第１６案,桃園市,桃園區,青溪里,196,1476,421,308,729,44,773
公投第１６案,桃園市,桃園區,青溪里,197,1484,433,332,765,63,828
公投第１６案,桃園市,桃園區,春日里,198,1514,427,285,712,52,764
公投第１６案,桃園市,桃園區,春日里,199,1446,396,274,670,85,755
公投第１６案,桃園市,桃園區,春日里,200,1573,419,297,716,28,744
公投第１６案,桃園市,桃園區,春日里,201,1564,428,255,683,40,723
公投第１６案,桃園市,桃園區,朝陽里,202,1015,309,218,527,46,573
公投第１６案,桃園市,桃園區,朝陽里,203,955,227,219,446,40,486
公投第１６案,桃園市,桃園區,會稽里,204,1796,507,346,853,48,901
公投第１６案,桃園市,桃園區,會稽里,205,1878,520,348,868,39,907
公投第１６案,桃園市,桃園區,會稽里,206,1729,465,326,791,54,845
公投第１６案,桃園市,桃園區,會稽里,207,1843,474,306,780,48,828
公投第１６案,桃園市,桃園區,會稽里,208,1817,466,275,741,44,785
公投第１６案,桃園市,桃園區,萬壽里,209,979,285,222,507,46,553
公投第１６案,桃園市,桃園區,福元里,210,1363,431,266,697,28,725
公投第１６案,桃園市,桃園區,福元里,211,1546,477,263,740,28,768
公投第１６案,桃園市,桃園區,福元里,212,1308,376,244,620,37,657
公投第１６案,桃園市,桃園區,寶山里,213,2164,611,386,997,72,1069
公投第１６案,桃園市,桃園區,寶山里,214,2020,543,371,914,60,974
公投第１６案,桃園市,桃園區,寶山里,215,1924,502,305,807,49,856
公投第１６案,桃園市,桃園區,寶山里,216,2088,539,312,851,50,901
公投第１６案,桃園市,龜山區,精忠里,217,874,304,150,454,28,482
公投第１６案,桃園市,龜山區,精忠里,218,2014,656,333,989,84,1073
公投第１６案,桃園市,龜山區,精忠里,219,2145,548,471,1019,27,1046
公投第１６案,桃園市,龜山區,陸光里,220,1744,583,295,878,73,951
公投第１６案,桃園市,龜山區,陸光里,221,1885,612,340,952,67,1019
公投第１６案,桃園市,龜山區,中興里,222,1546,419,258,677,76,753
公投第１６案,桃園市,龜山區,中興里,223,1684,435,315,750,81,831
公投第１６案,桃園市,龜山區,中興里,224,1477,358,247,605,66,671
公投第１６案,桃園市,龜山區,新興里,225,1528,534,272,806,52,858
公投第１６案,桃園市,龜山區,新興里,226,1428,159,113,272,19,291
公投第１６案,桃園市,龜山區,新路里,227,1525,461,301,762,78,840
公投第１６案,桃園市,龜山區,新路里,228,1041,313,237,550,57,607
公投第１６案,桃園市,龜山區,新路里,229,1404,335,314,649,45,694
公投第１６案,桃園市,龜山區,新路里,230,1478,445,289,734,80,814
公投第１６案,桃園市,龜山區,龜山里,231,2178,621,411,1032,83,1115
公投第１６案,桃園市,龜山區,龜山里,232,1672,475,340,815,80,895
公投第１６案,桃園市,龜山區,龜山里,233,1376,356,271,627,52,679
公投第１６案,桃園市,龜山區,龜山里,234,1480,402,278,680,68,748
公投第１６案,桃園市,龜山區,大同里,235,1258,378,259,637,48,685
公投第１６案,桃園市,龜山區,大同里,236,1464,410,280,690,42,732
公投第１６案,桃園市,龜山區,大同里,237,1844,485,361,846,94,940
公投第１６案,桃園市,龜山區,大同里,238,1169,339,244,583,26,609
公投第１６案,桃園市,龜山區,山頂里,239,1921,420,275,695,52,747
公投第１６案,桃園市,龜山區,山頂里,240,1694,459,305,764,30,794
公投第１６案,桃園市,龜山區,山頂里,241,1771,520,398,918,75,993
公投第１６案,桃園市,龜山區,山德里,242,1665,425,289,714,71,785
公投第１６案,桃園市,龜山區,山德里,243,1439,361,297,658,80,738
公投第１６案,桃園市,龜山區,山德里,244,1728,420,281,701,90,791
公投第１６案,桃園市,龜山區,山福里,245,1788,519,331,850,63,913
公投第１６案,桃園市,龜山區,山福里,246,1465,378,267,645,51,696
公投第１６案,桃園市,龜山區,幸福里,247,1659,349,289,638,51,689
公投第１６案,桃園市,龜山區,幸福里,248,1693,402,270,672,58,730
公投第１６案,桃園市,龜山區,幸福里,249,1818,392,262,654,35,689
公投第１６案,桃園市,龜山區,龍壽里,250,1752,452,350,802,77,879
公投第１６案,桃園市,龜山區,龍華里,251,1818,488,368,856,38,894
公投第１６案,桃園市,龜山區,龍華里,252,1499,375,324,699,34,733
公投第１６案,桃園市,龜山區,迴龍里,253,1916,484,408,892,65,957
公投第１６案,桃園市,龜山區,迴龍里,254,1804,469,368,837,62,899
公投第１６案,桃園市,龜山區,迴龍里,255,2127,533,425,958,44,1002
公投第１６案,桃園市,龜山區,嶺頂里,256,1005,250,211,461,76,537
公投第１６案,桃園市,龜山區,嶺頂里,257,1449,418,297,715,53,768
公投第１６案,桃園市,龜山區,嶺頂里,258,1498,383,258,641,80,721
公投第１６案,桃園市,龜山區,新嶺里,259,2149,480,345,825,93,918
公投第１６案,桃園市,龜山區,新嶺里,260,1771,339,238,577,80,657
公投第１６案,桃園市,龜山區,兔坑里,261,841,231,160,391,37,428
公投第１６案,桃園市,龜山區,兔坑里,262,2284,557,400,957,89,1046
公投第１６案,桃園市,龜山區,兔坑里,263,1228,314,251,565,84,649
公投第１６案,桃園市,龜山區,福源里,264,1979,504,325,829,71,900
公投第１６案,桃園市,龜山區,舊路里,265,1378,348,244,592,43,635
公投第１６案,桃園市,龜山區,舊路里,266,1061,278,200,478,54,532
公投第１６案,桃園市,龜山區,大坑里,267,1917,614,214,828,77,905
公投第１６案,桃園市,龜山區,楓福里,268,1540,531,318,849,52,901
公投第１６案,桃園市,龜山區,楓福里,269,1433,459,270,729,46,775
公投第１６案,桃園市,龜山區,楓樹里,270,1455,396,301,697,37,734
公投第１６案,桃園市,龜山區,楓樹里,271,2280,662,458,1120,98,1218
公投第１６案,桃園市,龜山區,樂善里,272,1668,468,313,781,62,843
公投第１６案,桃園市,龜山區,樂善里,273,1885,477,335,812,64,876
公投第１６案,桃園市,龜山區,長庚里,274,1849,453,404,857,44,901
公投第１６案,桃園市,龜山區,長庚里,275,1704,512,403,915,33,948
公投第１６案,桃園市,龜山區,公西里,276,1156,313,258,571,42,613
公投第１６案,桃園市,龜山區,大崗里,277,2114,448,362,810,82,892
公投第１６案,桃園市,龜山區,大崗里,278,1943,243,344,587,49,636
公投第１６案,桃園市,龜山區,大湖里,279,1800,487,302,789,49,838
公投第１６案,桃園市,龜山區,大湖里,280,2020,546,360,906,65,971
公投第１６案,桃園市,龜山區,大湖里,281,1319,372,305,677,50,727
公投第１６案,桃園市,龜山區,大華里,282,2229,618,494,1112,65,1177
公投第１６案,桃園市,龜山區,大華里,283,1992,537,374,911,31,942
公投第１６案,桃園市,龜山區,大華里,284,2237,575,418,993,64,1057
公投第１６案,桃園市,龜山區,大華里,285,2133,580,402,982,47,1029
公投第１６案,桃園市,龜山區,文化里,286,2187,596,440,1036,71,1107
公投第１６案,桃園市,龜山區,文化里,287,1959,534,354,888,66,954
公投第１６案,桃園市,龜山區,文化里,288,1910,451,384,835,34,869
公投第１６案,桃園市,龜山區,南上里,289,1840,503,361,864,118,982
公投第１６案,桃園市,龜山區,南美里,290,2266,576,471,1047,83,1130
公投第１６案,桃園市,龜山區,文青里,291,2387,598,400,998,60,1058
公投第１６案,桃園市,龜山區,文青里,292,1692,472,290,762,34,796
公投第１６案,桃園市,龜山區,文青里,293,904,265,174,439,25,464
公投第１６案,桃園市,龜山區,文青里,294,1469,453,288,741,41,782
公投第１６案,桃園市,八德區,興仁里,295,1761,417,319,736,86,822
公投第１６案,桃園市,八德區,興仁里,296,1804,418,284,702,27,729
公投第１６案,桃園市,八德區,興仁里,297,1813,266,213,479,33,512
公投第１６案,桃園市,八德區,興仁里,298,1784,479,299,778,46,824
公投第１６案,桃園市,八德區,福興里,299,2257,541,346,887,55,942
公投第１６案,桃園市,八德區,福興里,300,1857,419,284,703,51,754
公投第１６案,桃園市,八德區,福興里,301,2261,578,371,949,58,1007
公投第１６案,桃園市,八德區,福興里,302,1903,585,329,914,74,988
公投第１６案,桃園市,八德區,瑞豐里,303,1955,565,332,897,84,981
公投第１６案,桃園市,八德區,瑞豐里,304,1665,393,303,696,29,725
公投第１６案,桃園市,八德區,瑞興里,305,1431,403,298,701,81,782
公投第１６案,桃園市,八德區,瑞興里,306,1263,350,250,600,48,648
公投第１６案,桃園市,八德區,瑞泰里,307,1583,477,333,810,86,896
公投第１６案,桃園市,八德區,瑞泰里,308,1246,364,273,637,47,684
公投第１６案,桃園市,八德區,瑞泰里,309,1356,395,277,672,52,724
公投第１６案,桃園市,八德區,瑞發里,310,1630,501,310,811,93,904
公投第１６案,桃園市,八德區,瑞發里,311,1586,465,252,717,50,767
公投第１６案,桃園市,八德區,瑞德里,312,1649,460,320,780,86,866
公投第１６案,桃園市,八德區,瑞德里,313,1910,486,303,789,101,890
公投第１６案,桃園市,八德區,瑞祥里,314,1612,465,333,798,101,899
公投第１６案,桃園市,八德區,瑞祥里,315,1640,484,312,796,60,856
公投第１６案,桃園市,八德區,廣德里,316,1303,351,258,609,70,679
公投第１６案,桃園市,八德區,廣德里,317,1413,455,282,737,69,806
公投第１６案,桃園市,八德區,廣興里,318,1711,461,333,794,75,869
公投第１６案,桃園市,八德區,廣興里,319,1562,414,307,721,115,836
公投第１６案,桃園市,八德區,廣隆里,320,1735,510,291,801,79,880
公投第１６案,桃園市,八德區,廣隆里,321,1658,459,339,798,49,847
公投第１６案,桃園市,八德區,廣隆里,322,1022,343,212,555,65,620
公投第１６案,桃園市,八德區,竹園里,323,1673,464,244,708,65,773
公投第１６案,桃園市,八德區,竹園里,324,1741,500,296,796,42,838
公投第１６案,桃園市,八德區,霄裡里,325,2110,549,416,965,88,1053
公投第１６案,桃園市,八德區,龍友里,326,1145,382,184,566,40,606
公投第１６案,桃園市,八德區,龍友里,327,1010,372,179,551,45,596
公投第１６案,桃園市,八德區,茄明里,328,1848,452,319,771,30,801
公投第１６案,桃園市,八德區,茄明里,329,1334,377,286,663,60,723
公投第１６案,桃園市,八德區,茄明里,330,1349,325,225,550,32,582
公投第１６案,桃園市,八德區,茄苳里,331,1341,423,293,716,52,768
公投第１６案,桃園市,八德區,茄苳里,332,1178,367,255,622,63,685
公投第１６案,桃園市,八德區,永豐里,333,1374,424,277,701,48,749
公投第１６案,桃園市,八德區,永豐里,334,1462,371,284,655,74,729
公投第１６案,桃園市,八德區,高明里,335,1943,449,297,746,105,851
公投第１６案,桃園市,八德區,高明里,336,1928,405,262,667,97,764
公投第１６案,桃園市,八德區,高城里,337,1403,368,254,622,50,672
公投第１６案,桃園市,八德區,高城里,338,1672,405,300,705,98,803
公投第１６案,桃園市,八德區,白鷺里,339,1947,499,357,856,45,901
公投第１６案,桃園市,八德區,白鷺里,340,1200,371,234,605,51,656
公投第１６案,桃園市,八德區,大湳里,341,1895,457,343,800,91,891
公投第１６案,桃園市,八德區,大湳里,342,1988,546,315,861,97,958
公投第１６案,桃園市,八德區,大發里,343,2006,563,364,927,115,1042
公投第１６案,桃園市,八德區,大仁里,344,2061,502,379,881,9,890
公投第１６案,桃園市,八德區,大仁里,345,2108,492,392,884,79,963
公投第１６案,桃園市,八德區,大明里,346,1862,491,323,814,76,890
公投第１６案,桃園市,八德區,大明里,347,1681,463,319,782,35,817
公投第１６案,桃園市,八德區,大安里,348,1317,340,268,608,81,689
公投第１６案,桃園市,八德區,大安里,349,2093,651,428,1079,86,1165
公投第１６案,桃園市,八德區,大竹里,350,1499,453,330,783,68,851
公投第１６案,桃園市,八德區,大興里,351,1782,502,331,833,74,907
公投第１６案,桃園市,八德區,大興里,352,1763,537,311,848,54,902
公投第１６案,桃園市,八德區,大愛里,353,1226,339,250,589,76,665
公投第１６案,桃園市,八德區,大愛里,354,1311,406,271,677,44,721
公投第１６案,桃園市,八德區,大華里,355,1170,352,258,610,57,667
公投第１６案,桃園市,八德區,大華里,356,1313,414,260,674,44,718
公投第１６案,桃園市,八德區,大順里,357,1186,362,246,608,40,648
公投第１６案,桃園市,八德區,大順里,358,1481,355,284,639,82,721
公投第１６案,桃園市,八德區,大和里,359,1998,575,384,959,65,1024
公投第１６案,桃園市,八德區,大和里,360,916,255,212,467,44,511
公投第１６案,桃園市,八德區,大和里,361,1943,550,298,848,80,928
公投第１６案,桃園市,八德區,大和里,362,2076,571,364,935,56,991
公投第１６案,桃園市,八德區,大昌里,363,1363,368,272,640,89,729
公投第１６案,桃園市,八德區,大昌里,364,1491,413,293,706,81,787
公投第１６案,桃園市,八德區,大信里,365,1474,374,296,670,89,759
公投第１６案,桃園市,八德區,大信里,366,718,106,52,158,17,175
公投第１６案,桃園市,八德區,大信里,367,1386,378,289,667,65,732
公投第１６案,桃園市,八德區,陸光里,368,1487,432,276,708,79,787
公投第１６案,桃園市,八德區,陸光里,369,1552,468,234,702,106,808
公投第１６案,桃園市,八德區,陸光里,370,1255,325,227,552,65,617
公投第１６案,桃園市,八德區,大同里,371,1505,447,356,803,82,885
公投第１６案,桃園市,八德區,大慶里,372,1436,358,259,617,86,703
公投第１６案,桃園市,八德區,大成里,373,1618,465,331,796,83,879
公投第１６案,桃園市,八德區,大成里,374,1685,468,301,769,89,858
公投第１６案,桃園市,八德區,大義里,375,1835,490,289,779,67,846
公投第１６案,桃園市,八德區,大義里,376,1881,533,332,865,81,946
公投第１６案,桃園市,八德區,大忠里,377,1766,441,350,791,46,837
公投第１６案,桃園市,八德區,大智里,378,1817,482,329,811,111,922
公投第１６案,桃園市,八德區,大智里,379,2198,693,388,1081,46,1127
公投第１６案,桃園市,八德區,大宏里,380,1732,498,341,839,63,902
公投第１６案,桃園市,八德區,大宏里,381,2089,691,367,1058,49,1107
公投第１６案,桃園市,八德區,大正里,382,1257,371,263,634,44,678
公投第１６案,桃園市,八德區,大正里,383,1267,333,256,589,65,654
公投第１６案,桃園市,八德區,大正里,384,1427,450,285,735,30,765
公投第１６案,桃園市,八德區,大福里,385,1685,558,335,893,78,971
公投第１６案,桃園市,八德區,大福里,386,1748,577,297,874,72,946
公投第１６案,桃園市,八德區,大福里,387,1650,729,355,1084,61,1145
公投第１６案,桃園市,八德區,大強里,388,1478,425,301,726,74,800
公投第１６案,桃園市,八德區,大強里,389,1607,484,315,799,69,868
公投第１６案,桃園市,八德區,大勇里,390,1841,577,353,930,89,1019
公投第１６案,桃園市,八德區,大勇里,391,2082,586,376,962,102,1064
公投第１６案,桃園市,八德區,大榮里,392,1959,498,332,830,77,907
公投第１６案,桃園市,八德區,大千里,393,2209,627,425,1052,81,1133
公投第１６案,桃園市,八德區,大漢里,394,1864,573,339,912,66,978
公投第１６案,桃園市,八德區,大漢里,395,2000,536,352,888,72,960
公投第１６案,桃園市,蘆竹區,新興里,396,1358,315,233,548,145,693
公投第１６案,桃園市,蘆竹區,新興里,397,1538,369,307,676,97,773
公投第１６案,桃園市,蘆竹區,中福里,398,2118,466,348,814,97,911
公投第１６案,桃園市,蘆竹區,中福里,399,1673,501,349,850,79,929
公投第１６案,桃園市,蘆竹區,上興里,400,1500,453,290,743,42,785
公投第１６案,桃園市,蘆竹區,上興里,401,1699,493,352,845,61,906
公投第１６案,桃園市,蘆竹區,中興里,402,2250,657,418,1075,70,1145
公投第１６案,桃園市,蘆竹區,中興里,403,2354,595,415,1010,39,1049
公投第１６案,桃園市,蘆竹區,新莊里,404,1446,343,270,613,30,643
公投第１６案,桃園市,蘆竹區,新莊里,405,1623,382,289,671,83,754
公投第１６案,桃園市,蘆竹區,新莊里,406,1747,511,269,780,50,830
公投第１６案,桃園市,蘆竹區,上竹里,407,1988,557,387,944,78,1022
公投第１６案,桃園市,蘆竹區,上竹里,408,1437,394,297,691,63,754
公投第１６案,桃園市,蘆竹區,宏竹里,409,1532,410,344,754,88,842
公投第１６案,桃園市,蘆竹區,宏竹里,410,1447,404,252,656,41,697
公投第１６案,桃園市,蘆竹區,大竹里,411,2189,627,386,1013,72,1085
公投第１６案,桃園市,蘆竹區,大竹里,412,2498,691,405,1096,71,1167
公投第１６案,桃園市,蘆竹區,富竹里,413,1322,371,296,667,40,707
公投第１６案,桃園市,蘆竹區,蘆竹里,414,1991,424,331,755,95,850
公投第１６案,桃園市,蘆竹區,蘆竹里,415,2097,529,352,881,107,988
公投第１６案,桃園市,蘆竹區,南興里,416,1558,447,329,776,73,849
公投第１６案,桃園市,蘆竹區,南興里,417,1891,556,366,922,69,991
公投第１６案,桃園市,蘆竹區,南興里,418,1590,434,284,718,55,773
公投第１６案,桃園市,蘆竹區,福昌里,419,2404,587,408,995,77,1072
公投第１６案,桃園市,蘆竹區,福昌里,420,2522,750,438,1188,57,1245
公投第１６案,桃園市,蘆竹區,福興里,421,1633,373,434,807,37,844
公投第１６案,桃園市,蘆竹區,福興里,422,1715,473,344,817,64,881
公投第１６案,桃園市,蘆竹區,正興里,423,2215,546,421,967,43,1010
公投第１６案,桃園市,蘆竹區,正興里,424,2029,536,393,929,55,984
公投第１６案,桃園市,蘆竹區,順興里,425,1731,462,331,793,49,842
公投第１６案,桃園市,蘆竹區,順興里,426,1820,542,336,878,46,924
公投第１６案,桃園市,蘆竹區,蘆興里,427,1633,493,321,814,64,878
公投第１６案,桃園市,蘆竹區,南榮里,428,1668,423,267,690,36,726
公投第１６案,桃園市,蘆竹區,南榮里,429,1493,464,304,768,41,809
公投第１６案,桃園市,蘆竹區,南崁里,430,1864,536,365,901,66,967
公投第１６案,桃園市,蘆竹區,南崁里,431,1703,419,341,760,39,799
公投第１６案,桃園市,蘆竹區,錦興里,432,1893,482,367,849,63,912
公投第１６案,桃園市,蘆竹區,錦興里,433,1922,571,400,971,86,1057
公投第１６案,桃園市,蘆竹區,興榮里,434,1393,416,285,701,38,739
公投第１６案,桃園市,蘆竹區,興榮里,435,1338,386,296,682,52,734
公投第１６案,桃園市,蘆竹區,錦中里,436,1688,454,341,795,62,857
公投第１６案,桃園市,蘆竹區,錦中里,437,1462,363,307,670,84,754
公投第１６案,桃園市,蘆竹區,長興里,438,1232,313,260,573,44,617
公投第１６案,桃園市,蘆竹區,長興里,439,1356,367,233,600,45,645
公投第１６案,桃園市,蘆竹區,五福里,440,1181,378,277,655,61,716
公投第１６案,桃園市,蘆竹區,五福里,441,1199,365,210,575,33,608
公投第１６案,桃園市,蘆竹區,中山里,442,1710,543,329,872,35,907
公投第１６案,桃園市,蘆竹區,中山里,443,1423,388,264,652,56,708
公投第１６案,桃園市,蘆竹區,福祿里,444,1522,467,302,769,48,817
公投第１６案,桃園市,蘆竹區,福祿里,445,1639,499,336,835,39,874
公投第１６案,桃園市,蘆竹區,羊稠里,446,2055,586,386,972,59,1031
公投第１６案,桃園市,蘆竹區,羊稠里,447,2178,713,427,1140,45,1185
公投第１６案,桃園市,蘆竹區,吉祥里,448,1709,565,309,874,42,916
公投第１６案,桃園市,蘆竹區,長壽里,449,1667,545,320,865,53,918
公投第１６案,桃園市,蘆竹區,長壽里,450,1745,522,361,883,54,937
公投第１６案,桃園市,蘆竹區,長壽里,451,1967,702,300,1002,75,1077
公投第１６案,桃園市,蘆竹區,吉祥里,452,1802,598,359,957,34,991
公投第１６案,桃園市,蘆竹區,營盤里,453,2727,733,524,1257,58,1315
公投第１６案,桃園市,蘆竹區,營盤里,454,1868,484,342,826,47,873
公投第１６案,桃園市,蘆竹區,營福里,455,1537,405,310,715,64,779
公投第１６案,桃園市,蘆竹區,營福里,456,1616,458,337,795,46,841
公投第１６案,桃園市,蘆竹區,瓦窯里,457,1483,473,329,802,53,855
公投第１６案,桃園市,蘆竹區,瓦窯里,458,1689,459,323,782,64,846
公投第１６案,桃園市,蘆竹區,內厝里,459,1318,306,202,508,54,562
公投第１６案,桃園市,蘆竹區,內厝里,460,1203,361,282,643,118,761
公投第１６案,桃園市,蘆竹區,山鼻里,461,1771,449,313,762,42,804
公投第１６案,桃園市,蘆竹區,山腳里,462,1832,396,342,738,119,857
公投第１６案,桃園市,蘆竹區,山腳里,463,1763,420,341,761,129,890
公投第１６案,桃園市,蘆竹區,外社里,464,1497,297,263,560,30,590
公投第１６案,桃園市,蘆竹區,坑子里,465,1671,498,325,823,161,984
公投第１６案,桃園市,蘆竹區,坑口里,466,929,273,171,444,90,534
公投第１６案,桃園市,蘆竹區,坑口里,467,1559,398,348,746,121,867
公投第１６案,桃園市,蘆竹區,海湖里,468,1497,431,263,694,47,741
公投第１６案,桃園市,蘆竹區,海湖里,469,1441,458,360,818,94,912
公投第１６案,桃園市,蘆竹區,濱海里,470,1465,410,247,657,82,739
公投第１６案,桃園市,蘆竹區,濱海里,471,1029,277,200,477,52,529
公投第１６案,桃園市,大園區,大園里,472,1538,370,264,634,71,705
公投第１６案,桃園市,大園區,大園里,473,1616,373,234,607,50,657
公投第１６案,桃園市,大園區,大園里,474,1437,412,329,741,70,811
公投第１６案,桃園市,大園區,大園里,475,1554,446,342,788,51,839
公投第１６案,桃園市,大園區,田心里,476,1237,350,235,585,56,641
公投第１６案,桃園市,大園區,田心里,477,1347,348,268,616,79,695
公投第１６案,桃園市,大園區,田心里,478,1261,330,250,580,38,618
公投第１６案,桃園市,大園區,田心里,479,1256,337,246,583,55,638
公投第１６案,桃園市,大園區,田心里,480,1370,353,229,582,43,625
公投第１６案,桃園市,大園區,溪海里,481,1610,390,300,690,55,745
公投第１６案,桃園市,大園區,溪海里,482,1419,399,265,664,51,715
公投第１６案,桃園市,大園區,溪海里,483,1588,354,231,585,46,631
公投第１６案,桃園市,大園區,和平里,484,1612,466,278,744,66,810
公投第１６案,桃園市,大園區,橫峰里,485,1440,355,299,654,53,707
公投第１６案,桃園市,大園區,橫峰里,486,1326,334,251,585,63,648
公投第１６案,桃園市,大園區,橫峰里,487,1455,472,271,743,73,816
公投第１６案,桃園市,大園區,橫峰里,488,1562,459,308,767,71,838
公投第１６案,桃園市,大園區,橫峰里,489,1284,392,286,678,43,721
公投第１６案,桃園市,大園區,橫峰里,490,1454,391,269,660,33,693
公投第１６案,桃園市,大園區,橫峰里,491,1490,442,288,730,29,759
公投第１６案,桃園市,大園區,五權里,492,1617,392,277,669,54,723
公投第１６案,桃園市,大園區,五權里,493,1594,400,326,726,99,825
公投第１６案,桃園市,大園區,五權里,494,1650,441,330,771,67,838
公投第１６案,桃園市,大園區,埔心里,495,1467,349,298,647,25,672
公投第１６案,桃園市,大園區,埔心里,496,1494,401,303,704,42,746
公投第１６案,桃園市,大園區,埔心里,497,1538,406,300,706,71,777
公投第１６案,桃園市,大園區,埔心里,498,1397,347,292,639,34,673
公投第１６案,桃園市,大園區,大海里,499,1637,406,305,711,43,754
公投第１６案,桃園市,大園區,三石里,500,1452,399,235,634,65,699
公投第１６案,桃園市,大園區,三石里,501,1414,441,296,737,68,805
公投第１６案,桃園市,大園區,菓林里,502,1670,461,314,775,62,837
公投第１６案,桃園市,大園區,菓林里,503,1701,429,296,725,29,754
公投第１６案,桃園市,大園區,菓林里,504,1813,428,264,692,48,740
公投第１６案,桃園市,大園區,菓林里,505,1687,421,295,716,60,776
公投第１６案,桃園市,大園區,竹圍里,506,1650,479,324,803,20,823
公投第１６案,桃園市,大園區,竹圍里,507,1556,498,320,818,59,877
公投第１６案,桃園市,大園區,海口里,508,1844,459,314,773,53,826
公投第１６案,桃園市,大園區,沙崙里,509,1336,362,234,596,57,653
公投第１６案,桃園市,大園區,沙崙里,510,1414,435,292,727,60,787
公投第１６案,桃園市,大園區,後厝里,511,1238,384,276,660,81,741
公投第１６案,桃園市,大園區,後厝里,512,1227,390,300,690,54,744
公投第１６案,桃園市,大園區,圳頭里,513,1199,309,235,544,47,591
公投第１６案,桃園市,大園區,圳頭里,514,1349,343,238,581,28,609
公投第１６案,桃園市,大園區,內海里,515,1120,404,105,509,47,556
公投第１６案,桃園市,大園區,內海里,516,1080,305,206,511,39,550
公投第１６案,桃園市,大園區,北港里,517,1341,336,253,589,70,659
公投第１６案,桃園市,大園區,北港里,518,1345,359,282,641,69,710
公投第１６案,桃園市,大園區,南港里,519,1565,375,262,637,60,697
公投第１６案,桃園市,大園區,南港里,520,1519,367,253,620,37,657
公投第１６案,桃園市,大園區,南港里,521,2130,507,399,906,80,986
公投第１６案,桃園市,大溪區,興和里,522,1477,395,347,742,87,829
公投第１６案,桃園市,大溪區,福仁里,523,1006,288,214,502,52,554
公投第１６案,桃園市,大溪區,田心里,524,1553,418,298,716,103,819
公投第１６案,桃園市,大溪區,田心里,525,1597,459,328,787,86,873
公投第１６案,桃園市,大溪區,田心里,526,1358,370,278,648,80,728
公投第１６案,桃園市,大溪區,一心里,527,1585,384,294,678,76,754
公投第１６案,桃園市,大溪區,一心里,528,1612,458,320,778,59,837
公投第１６案,桃園市,大溪區,一心里,529,1555,415,241,656,53,709
公投第１６案,桃園市,大溪區,一德里,530,1282,377,325,702,70,772
公投第１６案,桃園市,大溪區,一德里,531,1392,383,248,631,102,733
公投第１６案,桃園市,大溪區,一德里,532,1422,390,226,616,102,718
公投第１６案,桃園市,大溪區,一德里,533,1448,390,303,693,93,786
公投第１６案,桃園市,大溪區,月眉里,534,1269,418,276,694,82,776
公投第１６案,桃園市,大溪區,永福里,535,977,273,252,525,68,593
公投第１６案,桃園市,大溪區,康安里,536,1359,382,315,697,61,758
公投第１６案,桃園市,大溪區,義和里,537,1135,345,251,596,93,689
公投第１６案,桃園市,大溪區,義和里,538,660,154,120,274,79,353
公投第１６案,桃園市,大溪區,美華里,539,1056,267,215,482,41,523
公投第１６案,桃園市,大溪區,美華里,540,1263,348,233,581,68,649
公投第１６案,桃園市,大溪區,美華里,541,717,188,156,344,53,397
公投第１６案,桃園市,大溪區,福安里,542,1299,294,228,522,26,548
公投第１６案,桃園市,大溪區,福安里,543,976,304,167,471,71,542
公投第１６案,桃園市,大溪區,復興里,544,938,261,193,454,52,506
公投第１６案,桃園市,大溪區,新峰里,545,832,196,179,375,40,415
公投第１６案,桃園市,大溪區,中新里,546,866,209,148,357,29,386
公投第１６案,桃園市,大溪區,中新里,547,694,156,144,300,35,335
公投第１６案,桃園市,大溪區,瑞興里,548,1410,345,275,620,60,680
公投第１６案,桃園市,大溪區,瑞興里,549,1303,346,215,561,86,647
公投第１６案,桃園市,大溪區,仁善里,550,1125,338,209,547,46,593
公投第１６案,桃園市,大溪區,仁善里,551,1170,354,244,598,43,641
公投第１６案,桃園市,大溪區,仁善里,552,1308,434,265,699,62,761
公投第１６案,桃園市,大溪區,仁美里,553,1094,321,218,539,80,619
公投第１６案,桃園市,大溪區,仁美里,554,2153,654,401,1055,93,1148
公投第１６案,桃園市,大溪區,僑愛里,555,1173,438,192,630,53,683
公投第１６案,桃園市,大溪區,僑愛里,556,1369,409,246,655,53,708
公投第１６案,桃園市,大溪區,仁義里,557,1446,416,255,671,73,744
公投第１６案,桃園市,大溪區,仁義里,558,1406,368,185,553,74,627
公投第１６案,桃園市,大溪區,仁和里,559,1592,498,322,820,41,861
公投第１６案,桃園市,大溪區,仁和里,560,1497,427,343,770,84,854
公投第１６案,桃園市,大溪區,仁和里,561,1559,449,332,781,102,883
公投第１６案,桃園市,大溪區,仁愛里,562,1684,485,320,805,35,840
公投第１６案,桃園市,大溪區,仁愛里,563,1959,554,373,927,150,1077
公投第１６案,桃園市,大溪區,仁愛里,564,1369,420,274,694,79,773
公投第１６案,桃園市,大溪區,仁武里,565,1431,422,300,722,71,793
公投第１６案,桃園市,大溪區,仁武里,566,1657,343,264,607,45,652
公投第１６案,桃園市,大溪區,仁文里,567,1387,344,214,558,38,596
公投第１６案,桃園市,大溪區,仁文里,568,1085,311,204,515,53,568
公投第１６案,桃園市,大溪區,仁文里,569,1403,431,302,733,61,794
公投第１６案,桃園市,大溪區,南興里,570,1511,397,287,684,100,784
公投第１６案,桃園市,大溪區,南興里,571,1719,400,316,716,81,797
公投第１６案,桃園市,大溪區,南興里,572,1717,384,286,670,121,791
公投第１６案,桃園市,大溪區,光明里,573,1207,319,204,523,124,647
公投第１６案,桃園市,大溪區,光明里,574,1188,356,239,595,78,673
公投第１６案,桃園市,大溪區,員林里,575,1514,403,266,669,38,707
公投第１６案,桃園市,大溪區,三元里,576,1529,484,278,762,94,856
公投第１６案,桃園市,大溪區,三元里,577,1260,423,270,693,49,742
公投第１６案,桃園市,大溪區,瑞源里,578,831,266,183,449,24,473
公投第１６案,桃園市,大溪區,瑞源里,579,1407,458,248,706,73,779
公投第１６案,桃園市,大溪區,瑞源里,580,1494,394,245,639,91,730
公投第１６案,桃園市,復興區,三民里,581,1991,508,469,977,125,1102
公投第１６案,桃園市,復興區,澤仁里,582,1392,396,297,693,98,791
公投第１６案,桃園市,復興區,霞雲里,583,564,185,84,269,24,293
公投第１６案,桃園市,復興區,義盛里,584,716,188,140,328,27,355
公投第１６案,桃園市,復興區,羅浮里,585,1016,322,221,543,83,626
公投第１６案,桃園市,復興區,長興里,586,669,141,111,252,15,267
公投第１６案,桃園市,復興區,奎輝里,587,760,198,139,337,18,355
公投第１６案,桃園市,復興區,高義里,588,751,186,163,349,19,368
公投第１６案,桃園市,復興區,三光里,589,683,135,76,211,21,232
公投第１６案,桃園市,復興區,華陵里,590,1224,345,232,577,41,618
公投第１６案,桃園市,中壢區,後寮里,591,1401,445,250,695,47,742
公投第１６案,桃園市,中壢區,後寮里,592,1798,498,340,838,70,908
公投第１６案,桃園市,中壢區,後寮里,593,1642,467,259,726,57,783
公投第１６案,桃園市,中壢區,明德里,594,1670,503,296,799,86,885
公投第１６案,桃園市,中壢區,明德里,595,1456,462,304,766,30,796
公投第１６案,桃園市,中壢區,明德里,596,1531,530,320,850,61,911
公投第１６案,桃園市,中壢區,至善里,597,1623,551,325,876,51,927
公投第１６案,桃園市,中壢區,至善里,598,1953,548,304,852,39,891
公投第１６案,桃園市,中壢區,龍慈里,599,1155,352,263,615,42,657
公投第１６案,桃園市,中壢區,龍慈里,600,1800,494,296,790,51,841
公投第１６案,桃園市,中壢區,龍慈里,601,1757,535,270,805,48,853
公投第１６案,桃園市,中壢區,龍興里,602,1281,445,237,682,70,752
公投第１６案,桃園市,中壢區,龍興里,603,1462,468,305,773,48,821
公投第１６案,桃園市,中壢區,龍興里,604,1560,480,227,707,56,763
公投第１６案,桃園市,中壢區,龍德里,605,1602,555,325,880,41,921
公投第１６案,桃園市,中壢區,龍德里,606,1006,359,243,602,43,645
公投第１６案,桃園市,中壢區,龍德里,607,1474,488,286,774,43,817
公投第１６案,桃園市,中壢區,龍岡里,608,1627,487,282,769,118,887
公投第１６案,桃園市,中壢區,龍岡里,609,1519,484,329,813,46,859
公投第１６案,桃園市,中壢區,龍岡里,610,1526,595,272,867,82,949
公投第１６案,桃園市,中壢區,龍東里,611,1618,536,239,775,98,873
公投第１６案,桃園市,中壢區,龍東里,612,1554,544,277,821,85,906
公投第１６案,桃園市,中壢區,龍東里,613,1706,571,276,847,78,925
公投第１６案,桃園市,中壢區,龍昌里,614,1818,642,322,964,66,1030
公投第１６案,桃園市,中壢區,龍昌里,615,1991,588,340,928,56,984
公投第１６案,桃園市,中壢區,龍昌里,616,1609,568,231,799,48,847
公投第１６案,桃園市,中壢區,龍平里,617,1329,403,213,616,21,637
公投第１６案,桃園市,中壢區,龍平里,618,1587,440,234,674,117,791
公投第１６案,桃園市,中壢區,仁美里,619,1955,598,346,944,42,986
公投第１６案,桃園市,中壢區,仁美里,620,1711,470,331,801,82,883
公投第１６案,桃園市,中壢區,仁美里,621,1712,500,303,803,68,871
公投第１６案,桃園市,中壢區,仁福里,622,1448,506,276,782,50,832
公投第１６案,桃園市,中壢區,仁福里,623,1605,462,297,759,60,819
公投第１６案,桃園市,中壢區,仁福里,624,1633,464,270,734,21,755
公投第１６案,桃園市,中壢區,華愛里,625,1795,556,389,945,74,1019
公投第１６案,桃園市,中壢區,華愛里,626,1689,555,320,875,40,915
公投第１６案,桃園市,中壢區,普仁里,627,1201,359,258,617,53,670
公投第１６案,桃園市,中壢區,普仁里,628,1353,402,265,667,46,713
公投第１６案,桃園市,中壢區,普仁里,629,1587,430,300,730,62,792
公投第１６案,桃園市,中壢區,普忠里,630,1883,616,321,937,63,1000
公投第１６案,桃園市,中壢區,普忠里,631,1448,428,281,709,38,747
公投第１６案,桃園市,中壢區,普強里,632,1810,570,329,899,49,948
公投第１６案,桃園市,中壢區,普強里,633,1916,568,330,898,84,982
公投第１６案,桃園市,中壢區,普慶里,634,1177,398,228,626,48,674
公投第１６案,桃園市,中壢區,普慶里,635,1410,475,299,774,62,836
公投第１６案,桃園市,中壢區,信義里,636,1368,403,271,674,42,716
公投第１６案,桃園市,中壢區,信義里,637,1424,508,283,791,61,852
公投第１６案,桃園市,中壢區,信義里,638,1573,485,335,820,56,876
公投第１６案,桃園市,中壢區,正義里,639,1152,391,228,619,21,640
公投第１６案,桃園市,中壢區,正義里,640,1178,371,250,621,28,649
公投第１６案,桃園市,中壢區,正義里,641,1966,615,359,974,78,1052
公投第１６案,桃園市,中壢區,普義里,642,3474,405,268,673,40,713
公投第１６案,桃園市,中壢區,普義里,643,2099,615,434,1049,78,1127
公投第１６案,桃園市,中壢區,德義里,644,1178,392,203,595,54,649
公投第１６案,桃園市,中壢區,德義里,645,1397,480,312,792,63,855
公投第１６案,桃園市,中壢區,仁義里,646,1669,535,337,872,54,926
公投第１６案,桃園市,中壢區,仁義里,647,2087,566,365,931,92,1023
公投第１６案,桃園市,中壢區,忠義里,648,1900,541,376,917,63,980
公投第１６案,桃園市,中壢區,忠義里,649,1640,400,276,676,36,712
公投第１６案,桃園市,中壢區,龍安里,650,994,363,192,555,40,595
公投第１６案,桃園市,中壢區,龍安里,651,1131,432,236,668,61,729
公投第１６案,桃園市,中壢區,仁愛里,652,1625,564,339,903,48,951
公投第１６案,桃園市,中壢區,仁愛里,653,1384,453,359,812,47,859
公投第１６案,桃園市,中壢區,仁德里,654,1588,501,295,796,55,851
公投第１６案,桃園市,中壢區,仁德里,655,1445,462,274,736,49,785
公投第１６案,桃園市,中壢區,仁和里,656,1743,451,280,731,65,796
公投第１６案,桃園市,中壢區,仁和里,657,1812,483,338,821,36,857
公投第１６案,桃園市,中壢區,仁祥里,658,1546,437,289,726,66,792
公投第１６案,桃園市,中壢區,仁祥里,659,1290,404,231,635,54,689
公投第１６案,桃園市,中壢區,華勛里,660,2145,641,299,940,101,1041
公投第１６案,桃園市,中壢區,華勛里,661,1451,405,267,672,47,719
公投第１６案,桃園市,中壢區,中堅里,662,1489,477,261,738,43,781
公投第１６案,桃園市,中壢區,中堅里,663,827,268,161,429,31,460
公投第１６案,桃園市,中壢區,中堅里,664,1442,407,297,704,46,750
公投第１６案,桃園市,中壢區,興仁里,665,1842,509,306,815,35,850
公投第１６案,桃園市,中壢區,興仁里,666,1520,436,228,664,43,707
公投第１６案,桃園市,中壢區,中正里,667,1764,472,292,764,52,816
公投第１６案,桃園市,中壢區,中正里,668,1488,472,318,790,34,824
公投第１６案,桃園市,中壢區,中正里,669,1593,476,295,771,74,845
公投第１６案,桃園市,中壢區,中山里,670,1505,438,318,756,46,802
公投第１６案,桃園市,中壢區,中山里,671,1661,528,294,822,39,861
公投第１６案,桃園市,中壢區,中山里,672,1492,518,249,767,52,819
公投第１６案,桃園市,中壢區,篤行里,673,1249,322,256,578,39,617
公投第１６案,桃園市,中壢區,篤行里,674,1257,406,247,653,47,700
公投第１６案,桃園市,中壢區,自強里,675,1659,500,280,780,82,862
公投第１６案,桃園市,中壢區,自強里,676,1815,649,299,948,49,997
公投第１６案,桃園市,中壢區,中興里,677,1702,488,317,805,53,858
公投第１６案,桃園市,中壢區,中興里,678,1541,467,311,778,29,807
公投第１６案,桃園市,中壢區,自立里,679,1659,488,268,756,64,820
公投第１６案,桃園市,中壢區,自立里,680,1874,570,288,858,109,967
公投第１６案,桃園市,中壢區,自立里,681,1603,448,299,747,54,801
公投第１６案,桃園市,中壢區,自信里,682,1735,543,292,835,45,880
公投第１６案,桃園市,中壢區,自信里,683,1815,589,310,899,28,927
公投第１６案,桃園市,中壢區,自信里,684,1873,553,329,882,41,923
公投第１６案,桃園市,中壢區,莊敬里,685,1739,598,293,891,79,970
公投第１６案,桃園市,中壢區,莊敬里,686,1709,513,275,788,58,846
公投第１６案,桃園市,中壢區,自治里,687,1655,535,323,858,55,913
公投第１６案,桃園市,中壢區,自治里,688,1664,521,325,846,49,895
公投第１６案,桃園市,中壢區,內壢里,689,1087,305,195,500,33,533
公投第１６案,桃園市,中壢區,內壢里,690,1065,308,223,531,61,592
公投第１６案,桃園市,中壢區,成功里,691,1844,519,379,898,97,995
公投第１６案,桃園市,中壢區,成功里,692,1220,331,188,519,62,581
公投第１６案,桃園市,中壢區,成功里,693,1219,356,249,605,49,654
公投第１６案,桃園市,中壢區,福德里,694,1260,351,288,639,59,698
公投第１６案,桃園市,中壢區,福德里,695,1594,515,336,851,75,926
公投第１６案,桃園市,中壢區,中原里,696,1733,489,369,858,79,937
公投第１６案,桃園市,中壢區,中原里,697,1979,638,329,967,73,1040
公投第１６案,桃園市,中壢區,忠孝里,698,1621,473,334,807,43,850
公投第１６案,桃園市,中壢區,忠孝里,699,1391,429,299,728,52,780
公投第１６案,桃園市,中壢區,忠孝里,700,1531,495,312,807,38,845
公投第１６案,桃園市,中壢區,復興里,701,1943,520,348,868,60,928
公投第１６案,桃園市,中壢區,復興里,702,1363,428,245,673,40,713
公投第１６案,桃園市,中壢區,復興里,703,2172,555,365,920,63,983
公投第１６案,桃園市,中壢區,復興里,704,1798,550,280,830,49,879
公投第１６案,桃園市,中壢區,復興里,705,1671,486,305,791,32,823
公投第１６案,桃園市,中壢區,復華里,706,1969,553,346,899,75,974
公投第１６案,桃園市,中壢區,復華里,707,1563,557,368,925,65,990
公投第１６案,桃園市,中壢區,復華里,708,1762,552,363,915,59,974
公投第１６案,桃園市,中壢區,文化里,709,1923,496,267,763,53,816
公投第１６案,桃園市,中壢區,文化里,710,1572,502,308,810,88,898
公投第１６案,桃園市,中壢區,文化里,711,1850,564,393,957,60,1017
公投第１６案,桃園市,中壢區,文化里,712,1583,449,300,749,71,820
公投第１６案,桃園市,中壢區,文化里,713,1735,490,344,834,56,890
公投第１６案,桃園市,中壢區,和平里,714,1292,368,292,660,23,683
公投第１６案,桃園市,中壢區,和平里,715,1265,398,248,646,27,673
公投第１６案,桃園市,中壢區,內定里,716,1798,534,320,854,58,912
公投第１６案,桃園市,中壢區,內定里,717,1822,579,385,964,76,1040
公投第１６案,桃園市,中壢區,內定里,718,1613,492,322,814,35,849
公投第１６案,桃園市,中壢區,內定里,719,1405,419,293,712,45,757
公投第１６案,桃園市,中壢區,石頭里,720,1730,516,380,896,81,977
公投第１６案,桃園市,中壢區,中央里,721,1384,484,321,805,45,850
公投第１６案,桃園市,中壢區,中央里,722,1122,373,234,607,23,630
公投第１６案,桃園市,中壢區,中央里,723,992,308,240,548,58,606
公投第１６案,桃園市,中壢區,新興里,724,1820,520,354,874,56,930
公投第１６案,桃園市,中壢區,新興里,725,1847,551,302,853,81,934
公投第１６案,桃園市,中壢區,林森里,726,1302,425,271,696,64,760
公投第１６案,桃園市,中壢區,林森里,727,1203,359,250,609,77,686
公投第１６案,桃園市,中壢區,林森里,728,1226,413,308,721,66,787
公投第１６案,桃園市,中壢區,振興里,729,1234,414,260,674,47,721
公投第１６案,桃園市,中壢區,振興里,730,2023,583,303,886,63,949
公投第１６案,桃園市,中壢區,振興里,731,1555,429,281,710,32,742
公投第１６案,桃園市,中壢區,東興里,732,1951,561,348,909,73,982
公投第１６案,桃園市,中壢區,東興里,733,1383,517,209,726,51,777
公投第１６案,桃園市,中壢區,健行里,734,1164,363,276,639,65,704
公投第１６案,桃園市,中壢區,健行里,735,1482,494,271,765,54,819
公投第１６案,桃園市,中壢區,健行里,736,1770,522,361,883,60,943
公投第１６案,桃園市,中壢區,水尾里,737,1703,549,350,899,90,989
公投第１６案,桃園市,中壢區,水尾里,738,1841,589,319,908,62,970
公投第１６案,桃園市,中壢區,金華里,739,1941,659,351,1010,51,1061
公投第１６案,桃園市,中壢區,金華里,740,2029,703,357,1060,52,1112
公投第１６案,桃園市,中壢區,忠福里,741,1636,534,315,849,61,910
公投第１６案,桃園市,中壢區,忠福里,742,1528,496,319,815,56,871
公投第１６案,桃園市,中壢區,忠福里,743,2289,614,386,1000,101,1101
公投第１６案,桃園市,中壢區,忠福里,744,2020,562,371,933,57,990
公投第１６案,桃園市,中壢區,幸福里,745,2027,613,382,995,77,1072
公投第１６案,桃園市,中壢區,幸福里,746,1883,486,308,794,41,835
公投第１６案,桃園市,中壢區,幸福里,747,2080,612,345,957,71,1028
公投第１６案,桃園市,中壢區,永福里,748,646,176,137,313,18,331
公投第１６案,桃園市,中壢區,永福里,749,1780,642,408,1050,72,1122
公投第１６案,桃園市,中壢區,永福里,750,1372,461,282,743,35,778
公投第１６案,桃園市,中壢區,永福里,751,1668,527,373,900,55,955
公投第１６案,桃園市,中壢區,青埔里,752,1987,567,375,942,51,993
公投第１６案,桃園市,中壢區,青埔里,753,1520,443,334,777,33,810
公投第１６案,桃園市,中壢區,新街里,754,852,238,189,427,41,468
公投第１６案,桃園市,中壢區,新街里,755,1209,387,234,621,43,664
公投第１６案,桃園市,中壢區,興南里,756,1481,455,259,714,85,799
公投第１６案,桃園市,中壢區,興南里,757,1564,450,270,720,27,747
公投第１６案,桃園市,中壢區,興國里,758,1957,595,383,978,78,1056
公投第１６案,桃園市,中壢區,興平里,759,1223,376,291,667,75,742
公投第１６案,桃園市,中壢區,興平里,760,1182,342,278,620,57,677
公投第１６案,桃園市,中壢區,興和里,761,1066,303,267,570,53,623
公投第１６案,桃園市,中壢區,興和里,762,1701,525,375,900,64,964
公投第１６案,桃園市,中壢區,永興里,763,943,285,171,456,46,502
公投第１６案,桃園市,中壢區,中壢里,764,731,232,181,413,31,444
公投第１６案,桃園市,中壢區,中榮里,765,851,234,178,412,80,492
公投第１６案,桃園市,中壢區,中建里,766,1011,300,201,501,55,556
公投第１６案,桃園市,中壢區,舊明里,767,1532,473,313,786,57,843
公投第１６案,桃園市,中壢區,新明里,768,1028,300,216,516,43,559
公投第１６案,桃園市,中壢區,新明里,769,1157,351,258,609,58,667
公投第１６案,桃園市,中壢區,新明里,770,1591,453,311,764,73,837
公投第１６案,桃園市,中壢區,光明里,771,2156,639,332,971,57,1028
公投第１６案,桃園市,中壢區,光明里,772,1479,390,267,657,39,696
公投第１６案,桃園市,中壢區,光明里,773,1780,584,305,889,45,934
公投第１６案,桃園市,中壢區,永光里,774,1651,485,343,828,65,893
公投第１６案,桃園市,中壢區,永光里,775,1870,615,335,950,56,1006
公投第１６案,桃園市,中壢區,永光里,776,1913,514,312,826,43,869
公投第１６案,桃園市,中壢區,三民里,777,1609,442,260,702,50,752
公投第１６案,桃園市,中壢區,三民里,778,1539,412,308,720,44,764
公投第１６案,桃園市,中壢區,五權里,779,1426,404,300,704,52,756
公投第１６案,桃園市,中壢區,五權里,780,1618,437,299,736,47,783
公投第１６案,桃園市,中壢區,五權里,781,1441,453,271,724,60,784
公投第１６案,桃園市,中壢區,五權里,782,1528,515,289,804,47,851
公投第１６案,桃園市,中壢區,五福里,783,1683,458,356,814,76,890
公投第１６案,桃園市,中壢區,五福里,784,1945,625,349,974,100,1074
公投第１６案,桃園市,中壢區,芝芭里,785,1534,420,316,736,68,804
公投第１６案,桃園市,中壢區,芝芭里,786,1810,535,301,836,81,917
公投第１６案,桃園市,中壢區,洽溪里,787,1097,312,189,501,61,562
公投第１６案,桃園市,中壢區,洽溪里,788,1917,544,356,900,39,939
公投第１６案,桃園市,中壢區,洽溪里,789,1858,541,342,883,69,952
公投第１６案,桃園市,中壢區,內厝里,790,1576,298,536,834,39,873
公投第１６案,桃園市,中壢區,內厝里,791,1478,450,303,753,64,817
公投第１６案,桃園市,中壢區,內厝里,792,1589,478,314,792,50,842
公投第１６案,桃園市,中壢區,月眉里,793,2037,598,390,988,126,1114
公投第１６案,桃園市,中壢區,月眉里,794,1158,405,236,641,56,697
公投第１６案,桃園市,中壢區,月眉里,795,1967,553,406,959,92,1051
公投第１６案,桃園市,中壢區,山東里,796,1830,508,330,838,86,924
公投第１６案,桃園市,中壢區,山東里,797,1856,480,378,858,56,914
公投第１６案,桃園市,中壢區,過嶺里,798,2068,541,418,959,67,1026
公投第１６案,桃園市,中壢區,過嶺里,799,2152,499,324,823,68,891
公投第１６案,桃園市,中壢區,過嶺里,800,2158,527,400,927,70,997
公投第１６案,桃園市,平鎮區,平鎮里,801,1487,380,272,652,67,719
公投第１６案,桃園市,平鎮區,平鎮里,802,1453,450,261,711,65,776
公投第１６案,桃園市,平鎮區,平鎮里,803,1491,450,295,745,62,807
公投第１６案,桃園市,平鎮區,鎮興里,804,1346,366,270,636,69,705
公投第１６案,桃園市,平鎮區,鎮興里,805,1660,471,328,799,46,845
公投第１６案,桃園市,平鎮區,南勢里,806,1921,501,331,832,57,889
公投第１６案,桃園市,平鎮區,南勢里,807,1974,631,363,994,74,1068
公投第１６案,桃園市,平鎮區,南勢里,808,1867,540,341,881,55,936
公投第１６案,桃園市,平鎮區,金星里,809,1786,554,313,867,53,920
公投第１６案,桃園市,平鎮區,金星里,810,1634,405,240,645,38,683
公投第１６案,桃園市,平鎮區,金星里,811,1080,337,218,555,30,585
公投第１６案,桃園市,平鎮區,金星里,812,1514,471,290,761,35,796
公投第１６案,桃園市,平鎮區,平安里,813,1918,519,280,799,85,884
公投第１６案,桃園市,平鎮區,平安里,814,1182,329,247,576,83,659
公投第１６案,桃園市,平鎮區,平安里,815,1667,469,285,754,49,803
公投第１６案,桃園市,平鎮區,平南里,816,1640,430,290,720,38,758
公投第１６案,桃園市,平鎮區,平南里,817,1603,515,286,801,24,825
公投第１６案,桃園市,平鎮區,平南里,818,1556,519,307,826,27,853
公投第１６案,桃園市,平鎮區,平南里,819,1697,499,275,774,62,836
公投第１６案,桃園市,平鎮區,山峰里,820,1130,307,200,507,23,530
公投第１６案,桃園市,平鎮區,山峰里,821,1196,349,247,596,40,636
公投第１６案,桃園市,平鎮區,福林里,822,1685,496,327,823,56,879
公投第１６案,桃園市,平鎮區,福林里,823,1532,472,331,803,60,863
公投第１６案,桃園市,平鎮區,湧光里,824,1564,448,292,740,53,793
公投第１６案,桃園市,平鎮區,湧光里,825,1824,449,273,722,48,770
公投第１６案,桃園市,平鎮區,湧光里,826,1912,532,338,870,49,919
公投第１６案,桃園市,平鎮區,莊敬里,827,1048,265,197,462,101,563
公投第１６案,桃園市,平鎮區,莊敬里,828,1259,413,235,648,58,706
公投第１６案,桃園市,平鎮區,莊敬里,829,1061,332,190,522,28,550
公投第１６案,桃園市,平鎮區,莊敬里,830,1072,385,214,599,44,643
公投第１６案,桃園市,平鎮區,湧豐里,831,1788,511,333,844,67,911
公投第１６案,桃園市,平鎮區,湧安里,832,1510,462,256,718,53,771
公投第１６案,桃園市,平鎮區,湧安里,833,1403,398,270,668,68,736
公投第１６案,桃園市,平鎮區,湧安里,834,1407,428,275,703,63,766
公投第１６案,桃園市,平鎮區,宋屋里,835,1901,561,379,940,78,1018
公投第１６案,桃園市,平鎮區,宋屋里,836,1994,538,324,862,46,908
公投第１６案,桃園市,平鎮區,平興里,837,1730,534,322,856,40,896
公投第１６案,桃園市,平鎮區,平興里,838,1905,576,364,940,69,1009
公投第１６案,桃園市,平鎮區,平興里,839,1723,561,350,911,33,944
公投第１６案,桃園市,平鎮區,廣興里,840,1307,374,284,658,58,716
公投第１６案,桃園市,平鎮區,廣興里,841,1337,427,263,690,54,744
公投第１６案,桃園市,平鎮區,廣興里,842,980,372,217,589,50,639
公投第１６案,桃園市,平鎮區,廣興里,843,1818,499,342,841,91,932
公投第１６案,桃園市,平鎮區,廣達里,844,1463,454,301,755,48,803
公投第１６案,桃園市,平鎮區,廣達里,845,1213,406,266,672,37,709
公投第１６案,桃園市,平鎮區,廣達里,846,1085,345,238,583,48,631
公投第１６案,桃園市,平鎮區,廣仁里,847,1458,408,264,672,45,717
公投第１６案,桃園市,平鎮區,廣仁里,848,1408,417,283,700,76,776
公投第１６案,桃園市,平鎮區,廣仁里,849,1396,377,279,656,67,723
公投第１６案,桃園市,平鎮區,復旦里,850,1044,389,245,634,37,671
公投第１６案,桃園市,平鎮區,復旦里,851,1124,382,224,606,15,621
公投第１６案,桃園市,平鎮區,復旦里,852,1517,466,316,782,32,814
公投第１６案,桃園市,平鎮區,復旦里,853,1571,490,289,779,37,816
公投第１６案,桃園市,平鎮區,復興里,854,1752,572,345,917,45,962
公投第１６案,桃園市,平鎮區,復興里,855,1434,496,306,802,57,859
公投第１６案,桃園市,平鎮區,復興里,856,1710,580,345,925,56,981
公投第１６案,桃園市,平鎮區,義民里,857,1555,510,303,813,51,864
公投第１６案,桃園市,平鎮區,義民里,858,2051,582,342,924,48,972
公投第１６案,桃園市,平鎮區,義民里,859,1477,452,301,753,35,788
公投第１６案,桃園市,平鎮區,義興里,860,1501,444,320,764,42,806
公投第１６案,桃園市,平鎮區,義興里,861,1405,437,270,707,77,784
公投第１６案,桃園市,平鎮區,義興里,862,1656,522,292,814,69,883
公投第１６案,桃園市,平鎮區,義興里,863,1921,639,199,838,53,891
公投第１６案,桃園市,平鎮區,雙連里,864,1717,470,307,777,44,821
公投第１６案,桃園市,平鎮區,雙連里,865,1319,389,262,651,67,718
公投第１６案,桃園市,平鎮區,雙連里,866,1745,501,305,806,70,876
公投第１６案,桃園市,平鎮區,高雙里,867,1721,531,320,851,89,940
公投第１６案,桃園市,平鎮區,高雙里,868,1206,372,243,615,44,659
公投第１６案,桃園市,平鎮區,高雙里,869,1202,447,296,743,43,786
公投第１６案,桃園市,平鎮區,北勢里,870,1208,409,250,659,47,706
公投第１６案,桃園市,平鎮區,北勢里,871,1267,404,291,695,57,752
公投第１６案,桃園市,平鎮區,北華里,872,1094,333,242,575,36,611
公投第１６案,桃園市,平鎮區,北華里,873,1394,465,285,750,67,817
公投第１６案,桃園市,平鎮區,北華里,874,1215,453,239,692,27,719
公投第１６案,桃園市,平鎮區,新勢里,875,1010,315,220,535,48,583
公投第１６案,桃園市,平鎮區,新勢里,876,1261,392,266,658,35,693
公投第１６案,桃園市,平鎮區,新勢里,877,1314,459,272,731,39,770
公投第１６案,桃園市,平鎮區,北安里,878,722,212,170,382,41,423
公投第１６案,桃園市,平鎮區,北安里,879,839,260,190,450,31,481
公投第１６案,桃園市,平鎮區,新榮里,880,1399,393,311,704,42,746
公投第１６案,桃園市,平鎮區,新榮里,881,1968,579,344,923,67,990
公投第１６案,桃園市,平鎮區,新榮里,882,1672,529,317,846,51,897
公投第１６案,桃園市,平鎮區,新富里,883,2213,365,239,604,45,649
公投第１６案,桃園市,平鎮區,新富里,884,949,318,243,561,27,588
公投第１６案,桃園市,平鎮區,新富里,885,1621,579,326,905,64,969
公投第１６案,桃園市,平鎮區,新富里,886,1643,491,300,791,49,840
公投第１６案,桃園市,平鎮區,新英里,887,1844,611,351,962,52,1014
公投第１６案,桃園市,平鎮區,新英里,888,1752,525,316,841,62,903
公投第１６案,桃園市,平鎮區,新貴里,889,1577,445,301,746,62,808
公投第１６案,桃園市,平鎮區,新貴里,890,1517,458,344,802,42,844
公投第１６案,桃園市,平鎮區,北興里,891,1039,303,264,567,44,611
公投第１６案,桃園市,平鎮區,北興里,892,1318,454,269,723,54,777
公投第１６案,桃園市,平鎮區,北興里,893,1636,546,264,810,51,861
公投第１６案,桃園市,平鎮區,金陵里,894,1316,413,277,690,51,741
公投第１６案,桃園市,平鎮區,金陵里,895,1474,469,326,795,22,817
公投第１６案,桃園市,平鎮區,北貴里,896,1480,393,245,638,68,706
公投第１６案,桃園市,平鎮區,北貴里,897,1330,400,269,669,39,708
公投第１６案,桃園市,平鎮區,北貴里,898,1228,403,240,643,41,684
公投第１６案,桃園市,平鎮區,北富里,899,1377,435,318,753,55,808
公投第１６案,桃園市,平鎮區,北富里,900,1198,429,255,684,41,725
公投第１６案,桃園市,平鎮區,北富里,901,1231,405,277,682,44,726
公投第１６案,桃園市,平鎮區,建安里,902,1243,404,232,636,76,712
公投第１６案,桃園市,平鎮區,建安里,903,1590,486,274,760,79,839
公投第１６案,桃園市,平鎮區,建安里,904,1366,418,260,678,58,736
公投第１６案,桃園市,平鎮區,華安里,905,1332,447,223,670,46,716
公投第１６案,桃園市,平鎮區,華安里,906,1201,333,194,527,34,561
公投第１６案,桃園市,平鎮區,華安里,907,1668,439,290,729,42,771
公投第１６案,桃園市,平鎮區,東安里,908,1351,387,249,636,70,706
公投第１６案,桃園市,平鎮區,東安里,909,1460,398,236,634,38,672
公投第１６案,桃園市,平鎮區,新安里,910,1841,539,343,882,52,934
公投第１６案,桃園市,平鎮區,新安里,911,1475,406,250,656,31,687
公投第１６案,桃園市,平鎮區,新安里,912,1011,300,215,515,44,559
公投第１６案,桃園市,平鎮區,東勢里,913,1052,293,186,479,34,513
公投第１６案,桃園市,平鎮區,東勢里,914,1154,423,221,644,66,710
公投第１６案,桃園市,平鎮區,東勢里,915,1645,476,288,764,38,802
公投第１６案,桃園市,平鎮區,東勢里,916,1539,380,255,635,139,774
公投第１６案,桃園市,平鎮區,龍恩里,917,1385,428,233,661,86,747
公投第１６案,桃園市,平鎮區,龍恩里,918,1395,429,265,694,46,740
公投第１６案,桃園市,平鎮區,東社里,919,1711,485,310,795,59,854
公投第１６案,桃園市,平鎮區,東社里,920,1631,491,288,779,55,834
公投第１６案,桃園市,平鎮區,忠貞里,921,1110,374,205,579,26,605
公投第１６案,桃園市,平鎮區,貿易里,922,1931,671,315,986,55,1041
公投第１６案,桃園市,平鎮區,龍興里,923,1127,344,242,586,33,619
公投第１６案,桃園市,平鎮區,龍興里,924,1414,468,234,702,76,778
公投第１６案,桃園市,平鎮區,中正里,925,1609,523,270,793,52,845
公投第１６案,桃園市,楊梅區,仁美里,926,1269,400,245,645,66,711
公投第１６案,桃園市,楊梅區,仁美里,927,1246,422,283,705,67,772
公投第１６案,桃園市,楊梅區,仁美里,928,1408,491,268,759,62,821
公投第１６案,桃園市,楊梅區,埔心里,929,1434,455,281,736,64,800
公投第１６案,桃園市,楊梅區,光華里,930,1515,463,256,719,60,779
公投第１６案,桃園市,楊梅區,光華里,931,1657,473,257,730,72,802
公投第１６案,桃園市,楊梅區,金龍里,932,1137,397,201,598,56,654
公投第１６案,桃園市,楊梅區,四維里,933,2211,665,385,1050,48,1098
公投第１６案,桃園市,楊梅區,四維里,934,2008,602,358,960,37,997
公投第１６案,桃園市,楊梅區,永平里,935,1911,591,366,957,42,999
公投第１６案,桃園市,楊梅區,瑞塘里,936,1449,433,304,737,75,812
公投第１６案,桃園市,楊梅區,瑞塘里,937,1877,480,313,793,72,865
公投第１６案,桃園市,楊梅區,瑞塘里,938,1988,542,360,902,53,955
公投第１６案,桃園市,楊梅區,瑞坪里,939,1931,598,254,852,49,901
公投第１６案,桃園市,楊梅區,瑞坪里,940,1938,563,321,884,68,952
公投第１６案,桃園市,楊梅區,瑞坪里,941,1677,552,291,843,36,879
公投第１６案,桃園市,楊梅區,梅溪里,942,1848,536,357,893,36,929
公投第１６案,桃園市,楊梅區,梅溪里,943,1882,555,341,896,52,948
公投第１６案,桃園市,楊梅區,瑞溪里,944,1541,331,242,573,30,603
公投第１６案,桃園市,楊梅區,瑞溪里,945,1938,563,320,883,57,940
公投第１６案,桃園市,楊梅區,金溪里,946,1562,422,254,676,23,699
公投第１６案,桃園市,楊梅區,金溪里,947,2125,705,429,1134,50,1184
公投第１６案,桃園市,楊梅區,三民里,948,1516,493,332,825,64,889
公投第１６案,桃園市,楊梅區,三民里,949,1807,528,325,853,39,892
公投第１６案,桃園市,楊梅區,楊明里,950,2101,582,350,932,65,997
公投第１６案,桃園市,楊梅區,楊明里,951,2054,622,372,994,81,1075
公投第１６案,桃園市,楊梅區,楊明里,952,2226,628,361,989,38,1027
公投第１６案,桃園市,楊梅區,裕成里,953,1405,460,267,727,22,749
公投第１６案,桃園市,楊梅區,裕成里,954,1843,515,311,826,47,873
公投第１６案,桃園市,楊梅區,裕新里,955,2324,596,371,967,69,1036
公投第１６案,桃園市,楊梅區,大同里,956,1713,528,316,844,41,885
公投第１６案,桃園市,楊梅區,大同里,957,1587,560,304,864,71,935
公投第１６案,桃園市,楊梅區,中山里,958,1416,454,292,746,48,794
公投第１６案,桃園市,楊梅區,中山里,959,1591,512,310,822,47,869
公投第１６案,桃園市,楊梅區,楊梅里,960,1943,572,358,930,76,1006
公投第１６案,桃園市,楊梅區,楊梅里,961,1762,552,333,885,44,929
公投第１６案,桃園市,楊梅區,楊江里,962,1083,322,205,527,46,573
公投第１６案,桃園市,楊梅區,梅新里,963,2027,622,344,966,80,1046
公投第１６案,桃園市,楊梅區,紅梅里,964,1274,402,266,668,63,731
公投第１６案,桃園市,楊梅區,紅梅里,965,1359,464,243,707,77,784
公投第１６案,桃園市,楊梅區,永寧里,966,2444,510,295,805,62,867
公投第１６案,桃園市,楊梅區,永寧里,967,2298,612,331,943,30,973
公投第１６案,桃園市,楊梅區,永寧里,968,2222,700,333,1033,57,1090
公投第１６案,桃園市,楊梅區,大平里,969,1610,449,318,767,83,850
公投第１６案,桃園市,楊梅區,大平里,970,1627,468,300,768,97,865
公投第１６案,桃園市,楊梅區,秀才里,971,1589,511,302,813,59,872
公投第１６案,桃園市,楊梅區,秀才里,972,1758,511,331,842,92,934
公投第１６案,桃園市,楊梅區,東流里,973,1776,400,295,695,78,773
公投第１６案,桃園市,楊梅區,東流里,974,1000,277,175,452,29,481
公投第１６案,桃園市,楊梅區,豐野里,975,2290,617,328,945,100,1045
公投第１６案,桃園市,楊梅區,豐野里,976,1551,426,314,740,84,824
公投第１６案,桃園市,楊梅區,富岡里,977,1861,522,294,816,100,916
公投第１６案,桃園市,楊梅區,富豐里,978,1141,279,188,467,69,536
公投第１６案,桃園市,楊梅區,富豐里,979,1785,522,283,805,60,865
公投第１６案,桃園市,楊梅區,員本里,980,1498,418,287,705,93,798
公投第１６案,桃園市,楊梅區,員本里,981,1187,310,228,538,85,623
公投第１６案,桃園市,楊梅區,三湖里,982,1270,378,269,647,62,709
公投第１６案,桃園市,楊梅區,三湖里,983,1424,422,273,695,53,748
公投第１６案,桃園市,楊梅區,頭湖里,984,1273,458,85,543,30,573
公投第１６案,桃園市,楊梅區,頭湖里,985,1534,394,253,647,49,696
公投第１６案,桃園市,楊梅區,上湖里,986,1783,415,303,718,88,806
公投第１６案,桃園市,楊梅區,上湖里,987,1709,495,281,776,37,813
公投第１６案,桃園市,楊梅區,上湖里,988,1920,453,337,790,93,883
公投第１６案,桃園市,楊梅區,上田里,989,1194,338,245,583,46,629
公投第１６案,桃園市,楊梅區,上田里,990,1408,455,265,720,27,747
公投第１６案,桃園市,楊梅區,高山里,991,1737,467,256,723,50,773
公投第１６案,桃園市,楊梅區,高山里,992,1920,588,305,893,47,940
公投第１６案,桃園市,楊梅區,高上里,993,1234,354,234,588,52,640
公投第１６案,桃園市,楊梅區,高上里,994,1491,448,294,742,87,829
公投第１６案,桃園市,楊梅區,青山里,995,2020,530,537,1067,59,1126
公投第１６案,桃園市,楊梅區,青山里,996,1863,504,306,810,41,851
公投第１６案,桃園市,楊梅區,高榮里,997,1692,480,349,829,71,900
公投第１６案,桃園市,楊梅區,高榮里,998,1686,508,305,813,39,852
公投第１６案,桃園市,楊梅區,雙榮里,999,1626,477,289,766,117,883
公投第１６案,桃園市,楊梅區,雙榮里,1000,1557,523,282,805,42,847
公投第１６案,桃園市,楊梅區,新榮里,1001,1603,597,268,865,64,929
公投第１６案,桃園市,楊梅區,新榮里,1002,1889,477,300,777,152,929
公投第１６案,桃園市,楊梅區,水美里,1003,1448,467,201,668,44,712
公投第１６案,桃園市,楊梅區,水美里,1004,1351,462,238,700,64,764
公投第１６案,桃園市,楊梅區,水美里,1005,1313,436,270,706,61,767
公投第１６案,桃園市,楊梅區,瑞原里,1006,1689,476,340,816,60,876
公投第１６案,桃園市,楊梅區,瑞原里,1007,2063,533,400,933,40,973
公投第１６案,桃園市,龍潭區,黃唐里,1008,1482,615,92,707,34,741
公投第１６案,桃園市,龍潭區,黃唐里,1009,1528,427,273,700,72,772
公投第１６案,桃園市,龍潭區,黃唐里,1010,1503,448,276,724,50,774
公投第１６案,桃園市,龍潭區,永興里,1011,1568,446,285,731,63,794
公投第１６案,桃園市,龍潭區,永興里,1012,1216,348,218,566,65,631
公投第１６案,桃園市,龍潭區,中山里,1013,2088,533,316,849,100,949
公投第１６案,桃園市,龍潭區,中山里,1014,1987,635,381,1016,88,1104
公投第１６案,桃園市,龍潭區,中山里,1015,1586,569,297,866,47,913
公投第１６案,桃園市,龍潭區,烏樹林里,1016,1221,318,246,564,57,621
公投第１６案,桃園市,龍潭區,烏樹林里,1017,1134,354,232,586,58,644
公投第１６案,桃園市,龍潭區,烏林里,1018,2081,551,346,897,75,972
公投第１６案,桃園市,龍潭區,烏林里,1019,1925,524,304,828,61,889
公投第１６案,桃園市,龍潭區,百年里,1020,2095,748,340,1088,58,1146
公投第１６案,桃園市,龍潭區,百年里,1021,2040,758,337,1095,69,1164
公投第１６案,桃園市,龍潭區,凌雲里,1022,1790,483,317,800,80,880
公投第１６案,桃園市,龍潭區,凌雲里,1023,1872,519,369,888,129,1017
公投第１６案,桃園市,龍潭區,龍祥里,1024,1726,509,351,860,118,978
公投第１６案,桃園市,龍潭區,龍祥里,1025,1792,545,334,879,86,965
公投第１６案,桃園市,龍潭區,八德里,1026,1398,270,416,686,57,743
公投第１６案,桃園市,龍潭區,八德里,1027,1345,355,259,614,47,661
公投第１６案,桃園市,龍潭區,八德里,1028,1409,386,328,714,52,766
公投第１６案,桃園市,龍潭區,聖德里,1029,1362,363,254,617,35,652
公投第１６案,桃園市,龍潭區,聖德里,1030,1650,518,357,875,59,934
公投第１６案,桃園市,龍潭區,上林里,1031,1597,444,317,761,72,833
公投第１６案,桃園市,龍潭區,上林里,1032,1410,413,283,696,42,738
公投第１６案,桃園市,龍潭區,上林里,1033,1275,388,259,647,61,708
公投第１６案,桃園市,龍潭區,龍潭里,1034,1909,585,435,1020,71,1091
公投第１６案,桃園市,龍潭區,龍星里,1035,2024,676,377,1053,45,1098
公投第１６案,桃園市,龍潭區,龍星里,1036,2002,640,385,1025,53,1078
公投第１６案,桃園市,龍潭區,中正里,1037,1786,592,341,933,74,1007
公投第１６案,桃園市,龍潭區,中正里,1038,1756,570,320,890,66,956
公投第１６案,桃園市,龍潭區,中正里,1039,1830,592,364,956,48,1004
公投第１６案,桃園市,龍潭區,上華里,1040,1697,605,344,949,47,996
公投第１６案,桃園市,龍潭區,上華里,1041,1519,519,270,789,55,844
公投第１６案,桃園市,龍潭區,九龍里,1042,1805,567,258,825,61,886
公投第１６案,桃園市,龍潭區,九龍里,1043,1792,680,86,766,47,813
公投第１６案,桃園市,龍潭區,武漢里,1044,1500,494,315,809,68,877
公投第１６案,桃園市,龍潭區,祥和里,1045,1427,415,228,643,47,690
公投第１６案,桃園市,龍潭區,東興里,1046,1444,381,225,606,46,652
公投第１６案,桃園市,龍潭區,東興里,1047,1321,378,215,593,79,672
公投第１６案,桃園市,龍潭區,東興里,1048,1215,412,264,676,51,727
公投第１６案,桃園市,龍潭區,中興里,1049,1297,375,242,617,78,695
公投第１６案,桃園市,龍潭區,中興里,1050,1407,416,241,657,25,682
公投第１６案,桃園市,龍潭區,中興里,1051,1564,413,294,707,69,776
公投第１６案,桃園市,龍潭區,北興里,1052,1317,366,262,628,72,700
公投第１６案,桃園市,龍潭區,北興里,1053,1023,268,184,452,56,508
公投第１６案,桃園市,龍潭區,佳安里,1054,1721,539,314,853,69,922
公投第１６案,桃園市,龍潭區,佳安里,1055,1764,620,283,903,72,975
公投第１６案,桃園市,龍潭區,三坑里,1056,1499,438,285,723,84,807
公投第１６案,桃園市,龍潭區,大平里,1057,2151,623,325,948,59,1007
公投第１６案,桃園市,龍潭區,三林里,1058,1524,526,304,830,27,857
公投第１６案,桃園市,龍潭區,三林里,1059,1456,581,263,844,29,873
公投第１６案,桃園市,龍潭區,建林里,1060,1847,767,300,1067,52,1119
公投第１６案,桃園市,龍潭區,建林里,1061,1899,747,355,1102,33,1135
公投第１６案,桃園市,龍潭區,富林里,1062,1725,583,312,895,42,937
公投第１６案,桃園市,龍潭區,富林里,1063,1665,612,338,950,64,1014
公投第１６案,桃園市,龍潭區,高平里,1064,1649,492,271,763,55,818
公投第１６案,桃園市,龍潭區,高平里,1065,1539,396,252,648,90,738
公投第１６案,桃園市,龍潭區,高原里,1066,1541,515,300,815,68,883
公投第１６案,桃園市,龍潭區,高原里,1067,1375,419,276,695,58,753
公投第１６案,桃園市,龍潭區,高原里,1068,1453,446,294,740,46,786
公投第１６案,桃園市,龍潭區,三和里,1069,1074,326,223,549,61,610
公投第１６案,桃園市,龍潭區,三和里,1070,1299,474,265,739,28,767
公投第１６案,桃園市,龍潭區,三水里,1071,678,139,154,293,26,319
公投第１６案,桃園市,新屋區,新屋里,1072,1306,447,281,728,41,769
公投第１６案,桃園市,新屋區,新屋里,1073,1556,482,334,816,50,866
公投第１６案,桃園市,新屋區,新生里,1074,1849,615,398,1013,113,1126
公投第１６案,桃園市,新屋區,新生里,1075,2096,692,426,1118,100,1218
公投第１６案,桃園市,新屋區,後湖里,1076,1517,326,418,744,55,799
公投第１６案,桃園市,新屋區,清華里,1077,2095,642,441,1083,108,1191
公投第１６案,桃園市,新屋區,清華里,1078,1856,506,296,802,57,859
公投第１６案,桃園市,新屋區,石磊里,1079,1986,601,386,987,92,1079
公投第１６案,桃園市,新屋區,東明里,1080,1425,330,270,600,93,693
公投第１６案,桃園市,新屋區,社子里,1081,1385,359,278,637,52,689
公投第１６案,桃園市,新屋區,埔頂里,1082,1271,435,273,708,73,781
公投第１６案,桃園市,新屋區,埔頂里,1083,1271,379,249,628,53,681
公投第１６案,桃園市,新屋區,九斗里,1084,1234,360,287,647,49,696
公投第１６案,桃園市,新屋區,九斗里,1085,1085,310,252,562,43,605
公投第１６案,桃園市,新屋區,頭洲里,1086,1992,646,376,1022,76,1098
公投第１６案,桃園市,新屋區,頭洲里,1087,2032,641,454,1095,101,1196
公投第１６案,桃園市,新屋區,大坡里,1088,1291,363,258,621,85,706
公投第１６案,桃園市,新屋區,望間里,1089,1401,402,238,640,45,685
公投第１６案,桃園市,新屋區,後庄里,1090,1106,350,236,586,61,647
公投第１６案,桃園市,新屋區,蚵間里,1091,908,243,199,442,28,470
公投第１６案,桃園市,新屋區,深圳里,1092,663,226,136,362,46,408
公投第１６案,桃園市,新屋區,槺榔里,1093,1088,316,198,514,67,581
公投第１６案,桃園市,新屋區,笨港里,1094,1050,377,219,596,71,667
公投第１６案,桃園市,新屋區,永安里,1095,896,279,203,482,30,512
公投第１６案,桃園市,新屋區,永安里,1096,1369,437,280,717,104,821
公投第１６案,桃園市,新屋區,永興里,1097,995,251,191,442,46,488
公投第１６案,桃園市,新屋區,下埔里,1098,741,223,157,380,32,412
公投第１６案,桃園市,新屋區,石牌里,1099,943,292,224,516,66,582
公投第１６案,桃園市,新屋區,下田里,1100,1714,471,309,780,105,885
公投第１６案,桃園市,新屋區,赤欄里,1101,1340,386,315,701,34,735
公投第１６案,桃園市,觀音區,觀音里,1102,1371,354,237,591,44,635
公投第１６案,桃園市,觀音區,觀音里,1103,1362,318,208,526,46,572
公投第１６案,桃園市,觀音區,白玉里,1104,997,270,197,467,64,531
公投第１６案,桃園市,觀音區,廣興里,1105,1407,368,257,625,33,658
公投第１６案,桃園市,觀音區,大潭里,1106,1692,493,329,822,49,871
公投第１６案,桃園市,觀音區,保生里,1107,1279,397,217,614,32,646
公投第１６案,桃園市,觀音區,保生里,1108,791,234,153,387,22,409
公投第１６案,桃園市,觀音區,武威里,1109,892,279,177,456,47,503
公投第１６案,桃園市,觀音區,三和里,1110,886,312,183,495,36,531
公投第１６案,桃園市,觀音區,新興里,1111,712,184,162,346,51,397
公投第１６案,桃園市,觀音區,坑尾里,1112,1609,390,287,677,136,813
公投第１６案,桃園市,觀音區,金湖里,1113,1274,381,255,636,70,706
公投第１６案,桃園市,觀音區,金湖里,1114,1351,333,206,539,40,579
公投第１６案,桃園市,觀音區,藍埔里,1115,1262,391,262,653,75,728
公投第１６案,桃園市,觀音區,藍埔里,1116,1242,377,242,619,87,706
公投第１６案,桃園市,觀音區,大同里,1117,1461,415,291,706,69,775
公投第１６案,桃園市,觀音區,大同里,1118,1613,438,313,751,69,820
公投第１６案,桃園市,觀音區,大堀里,1119,1479,449,286,735,64,799
公投第１６案,桃園市,觀音區,崙坪里,1120,1552,365,304,669,72,741
公投第１６案,桃園市,觀音區,崙坪里,1121,1517,389,308,697,56,753
公投第１６案,桃園市,觀音區,崙坪里,1122,1691,466,306,772,74,846
公投第１６案,桃園市,觀音區,富源里,1123,1157,360,246,606,24,630
公投第１６案,桃園市,觀音區,富源里,1124,1455,407,280,687,55,742
公投第１６案,桃園市,觀音區,富源里,1125,1150,317,226,543,66,609
公投第１６案,桃園市,觀音區,上大里,1126,1112,325,240,565,63,628
公投第１６案,桃園市,觀音區,上大里,1127,1251,374,214,588,23,611
公投第１６案,桃園市,觀音區,新坡里,1128,1446,400,260,660,123,783
公投第１６案,桃園市,觀音區,新坡里,1129,1493,360,287,647,143,790
公投第１６案,桃園市,觀音區,廣福里,1130,1339,333,259,592,113,705
公投第１６案,桃園市,觀音區,廣福里,1131,1137,333,282,615,41,656
公投第１６案,桃園市,觀音區,塔腳里,1132,1043,280,208,488,39,527
公投第１６案,桃園市,觀音區,保障里,1133,993,245,166,411,49,460
公投第１６案,桃園市,觀音區,保障里,1134,975,270,179,449,38,487
公投第１６案,桃園市,觀音區,草漯里,1135,2029,490,326,816,61,877
公投第１６案,桃園市,觀音區,草新里,1136,1765,540,337,877,66,943
公投第１６案,桃園市,觀音區,草新里,1137,1809,524,317,841,64,905
公投第１６案,桃園市,觀音區,草新里,1138,1869,488,370,858,44,902
公投第１６案,桃園市,觀音區,樹林里,1139,1870,465,279,744,62,806
公投第１６案,桃園市,觀音區,樹林里,1140,1932,377,259,636,50,686
公投第１６案,桃園市,觀音區,富林里,1141,899,188,162,350,17,367
公投第１６案,桃園市,觀音區,富林里,1142,985,239,157,396,22,418
